"insee_code","year","n_AEP","n_SOU","n_SUP","n_tot"
"01001",2015,0,43,0,43
"01001",2017,0,115,27,142
"01001",2018,0,117,14,131
"01001",2019,0,41,27,68
"01001",2020,0,0,78,78
"01002",2015,0,0,43,43
"01002",2017,0,53,62,115
"01002",2018,0,117,59,176
"01002",2019,0,231,115,346
"01002",2020,0,104,0,104
"01004",2015,0,0,43,43
"01004",2017,0,53,62,115
"01004",2018,0,117,59,176
"01004",2019,0,231,115,346
"01004",2020,0,104,0,104
"01005",2015,0,43,0,43
"01005",2017,0,115,27,142
"01005",2018,0,117,14,131
"01005",2019,0,41,27,68
"01005",2020,0,0,78,78
"01006",2015,0,0,43,43
"01006",2017,0,0,62,62
"01006",2018,0,0,59,59
"01006",2019,0,0,115,115
"01007",2017,0,53,27,80
"01007",2018,0,117,14,131
"01007",2019,0,231,27,258
"01007",2020,0,104,78,182
"01008",2015,0,0,43,43
"01008",2017,0,53,62,115
"01008",2018,0,117,59,176
"01008",2019,0,231,115,346
"01008",2020,0,104,0,104
"01009",2015,0,0,43,43
"01009",2017,0,0,62,62
"01009",2018,0,0,59,59
"01009",2019,0,0,115,115
"01010",2015,0,0,6,6
"01010",2018,0,0,14,14
"01010",2019,0,0,27,27
"01010",2020,0,0,14,14
"01011",2015,0,0,6,6
"01011",2018,0,0,14,14
"01011",2019,0,0,27,27
"01011",2020,0,0,14,14
"01012",2015,0,0,43,43
"01012",2017,0,0,62,62
"01012",2018,0,0,59,59
"01012",2019,0,0,115,115
"01013",2015,0,0,43,43
"01013",2017,0,0,62,62
"01013",2018,0,0,59,59
"01013",2019,0,0,115,115
"01014",2015,0,0,6,6
"01014",2018,0,0,14,14
"01014",2019,0,0,27,27
"01014",2020,0,0,14,14
"01015",2015,0,0,43,43
"01015",2017,0,0,62,62
"01015",2018,0,0,59,59
"01015",2019,0,0,115,115
"01016",2017,0,0,27,27
"01016",2018,0,0,14,14
"01016",2019,0,0,27,27
"01016",2020,0,0,14,14
"01017",2015,0,0,43,43
"01017",2017,0,0,62,62
"01017",2018,0,0,59,59
"01017",2019,0,0,115,115
"01019",2015,0,0,43,43
"01019",2017,0,0,62,62
"01019",2018,0,0,59,59
"01019",2019,0,0,115,115
"01021",2015,0,43,0,43
"01021",2017,0,115,27,142
"01021",2018,0,117,14,131
"01021",2019,0,41,27,68
"01021",2020,0,0,78,78
"01022",2015,0,0,6,6
"01022",2018,0,0,14,14
"01022",2019,0,0,27,27
"01022",2020,0,0,14,14
"01023",2017,0,0,27,27
"01023",2018,0,0,14,14
"01023",2019,0,0,27,27
"01023",2020,0,0,14,14
"01024",2017,0,0,27,27
"01024",2018,0,0,14,14
"01024",2019,0,0,27,27
"01024",2020,0,0,78,78
"01025",2017,0,0,27,27
"01025",2018,0,0,14,14
"01025",2019,0,0,27,27
"01025",2020,0,0,78,78
"01026",2017,0,0,27,27
"01026",2018,0,0,14,14
"01026",2019,0,0,27,27
"01026",2020,0,0,14,14
"01027",2017,0,53,27,80
"01027",2018,0,117,14,131
"01027",2019,0,231,27,258
"01027",2020,0,104,78,182
"01028",2015,0,43,0,43
"01028",2017,0,115,27,142
"01028",2018,0,117,14,131
"01028",2019,0,41,27,68
"01028",2020,0,0,78,78
"01029",2017,0,0,27,27
"01029",2018,0,0,14,14
"01029",2019,0,0,27,27
"01029",2020,0,0,14,14
"01030",2015,0,43,0,43
"01030",2017,0,115,27,142
"01030",2018,0,117,14,131
"01030",2019,0,41,27,68
"01030",2020,0,0,78,78
"01031",2015,0,0,43,43
"01031",2017,0,0,62,62
"01031",2018,0,0,59,59
"01031",2019,0,0,115,115
"01032",2017,0,53,27,80
"01032",2018,0,117,14,131
"01032",2019,0,231,27,258
"01032",2020,0,104,78,182
"01033",2015,0,43,6,49
"01033",2017,0,53,0,53
"01033",2018,0,117,14,131
"01033",2019,0,231,27,258
"01033",2020,0,0,14,14
"01034",2015,0,0,43,43
"01034",2017,0,0,62,62
"01034",2018,0,0,14,14
"01034",2019,0,0,27,27
"01034",2020,0,0,14,14
"01035",2015,0,0,6,6
"01035",2018,0,0,14,14
"01035",2019,0,0,27,27
"01035",2020,0,0,14,14
"01036",2015,0,0,6,6
"01036",2018,0,0,14,14
"01036",2019,0,0,27,27
"01036",2020,0,0,14,14
"01037",2015,0,0,43,43
"01037",2017,0,0,62,62
"01037",2018,0,0,59,59
"01037",2019,0,0,115,115
"01038",2017,0,0,27,27
"01038",2018,0,0,14,14
"01038",2019,0,0,27,27
"01038",2020,0,0,14,14
"01040",2017,0,0,27,27
"01040",2018,0,0,14,14
"01040",2019,0,0,27,27
"01040",2020,0,0,14,14
"01041",2015,0,0,43,43
"01041",2017,0,53,62,115
"01041",2018,0,117,59,176
"01041",2019,0,231,115,346
"01041",2020,0,104,0,104
"01042",2015,0,43,0,43
"01042",2017,0,115,27,142
"01042",2018,0,117,14,131
"01042",2019,0,41,27,68
"01042",2020,0,0,78,78
"01043",2015,0,43,0,43
"01043",2017,0,115,27,142
"01043",2018,0,117,14,131
"01043",2019,0,41,27,68
"01043",2020,0,0,78,78
"01044",2015,0,0,6,6
"01044",2018,0,0,14,14
"01044",2019,0,0,27,27
"01044",2020,0,0,14,14
"01045",2015,0,43,0,43
"01045",2017,0,115,27,142
"01045",2018,0,117,14,131
"01045",2019,0,41,27,68
"01045",2020,0,0,78,78
"01046",2015,0,43,0,43
"01046",2017,0,115,27,142
"01046",2018,0,117,14,131
"01046",2019,0,41,27,68
"01046",2020,0,0,78,78
"01047",2017,0,53,27,80
"01047",2018,0,117,14,131
"01047",2019,0,231,27,258
"01047",2020,0,104,78,182
"01049",2017,0,53,27,80
"01049",2018,0,117,14,131
"01049",2019,0,41,27,68
"01049",2020,0,0,78,78
"01050",2017,0,0,27,27
"01050",2018,0,0,14,14
"01050",2019,0,0,27,27
"01050",2020,0,0,14,14
"01051",2015,0,0,43,43
"01051",2017,0,0,62,62
"01051",2018,0,0,59,59
"01051",2019,0,0,115,115
"01052",2015,0,43,0,43
"01052",2017,0,115,27,142
"01052",2018,0,117,14,131
"01052",2019,0,41,27,68
"01052",2020,0,0,78,78
"01053",2015,0,43,0,43
"01053",2017,0,115,27,142
"01053",2018,0,117,14,131
"01053",2019,0,41,27,68
"01053",2020,0,0,78,78
"01054",2017,0,53,27,80
"01054",2018,0,117,14,131
"01054",2019,0,41,27,68
"01054",2020,0,0,78,78
"01056",2015,0,0,43,43
"01056",2017,0,53,62,115
"01056",2018,0,117,59,176
"01056",2019,0,231,115,346
"01056",2020,0,104,0,104
"01057",2017,0,0,27,27
"01057",2018,0,0,14,14
"01057",2019,0,0,27,27
"01057",2020,0,0,14,14
"01058",2015,0,0,43,43
"01058",2017,0,0,62,62
"01058",2018,0,0,59,59
"01058",2019,0,0,115,115
"01060",2015,0,0,6,6
"01060",2018,0,0,14,14
"01060",2019,0,0,27,27
"01060",2020,0,0,14,14
"01061",2015,0,0,43,43
"01061",2017,0,0,62,62
"01061",2018,0,0,59,59
"01061",2019,0,0,115,115
"01062",2017,0,53,27,80
"01062",2018,0,117,14,131
"01062",2019,0,41,27,68
"01062",2020,0,0,78,78
"01063",2015,0,0,43,43
"01063",2017,0,0,62,62
"01063",2018,0,0,59,59
"01063",2019,0,0,115,115
"01064",2015,0,0,43,43
"01064",2017,0,0,62,62
"01064",2018,0,0,59,59
"01064",2019,0,0,115,115
"01065",2015,0,43,0,43
"01065",2017,0,115,27,142
"01065",2018,0,117,14,131
"01065",2019,0,41,27,68
"01065",2020,0,0,78,78
"01066",2015,0,0,43,43
"01066",2017,0,0,62,62
"01066",2018,0,0,59,59
"01066",2019,0,0,115,115
"01067",2015,0,0,43,43
"01067",2017,0,0,62,62
"01067",2018,0,0,59,59
"01067",2019,0,0,115,115
"01068",2015,0,0,43,43
"01068",2017,0,0,62,62
"01068",2018,0,0,59,59
"01068",2019,0,0,115,115
"01069",2015,0,43,0,43
"01069",2017,0,115,27,142
"01069",2018,0,117,14,131
"01069",2019,0,41,27,68
"01069",2020,0,0,78,78
"01071",2015,0,43,6,49
"01071",2017,0,53,0,53
"01071",2018,0,117,14,131
"01071",2019,0,231,27,258
"01071",2020,0,0,14,14
"01072",2015,0,43,0,43
"01072",2017,0,115,27,142
"01072",2018,0,117,14,131
"01072",2019,0,41,27,68
"01072",2020,0,0,14,14
"01073",2015,0,0,6,6
"01073",2018,0,0,14,14
"01073",2019,0,0,27,27
"01073",2020,0,0,14,14
"01074",2017,0,53,27,80
"01074",2018,0,117,14,131
"01074",2019,0,41,27,68
"01074",2020,0,0,78,78
"01075",2015,0,43,0,43
"01075",2017,0,115,27,142
"01075",2018,0,117,14,131
"01075",2019,0,41,27,68
"01075",2020,0,0,78,78
"01076",2015,0,0,43,43
"01076",2017,0,0,62,62
"01076",2018,0,0,59,59
"01076",2019,0,0,115,115
"01077",2015,0,0,43,43
"01077",2017,0,0,62,62
"01077",2018,0,0,59,59
"01077",2019,0,0,115,115
"01078",2015,0,43,6,49
"01078",2017,0,53,0,53
"01078",2018,0,117,14,131
"01078",2019,0,231,27,258
"01078",2020,0,0,14,14
"01079",2015,0,0,6,6
"01079",2018,0,0,14,14
"01079",2019,0,0,27,27
"01079",2020,0,0,14,14
"01080",2015,0,0,6,6
"01080",2018,0,0,14,14
"01080",2019,0,0,27,27
"01080",2020,0,0,14,14
"01081",2015,0,0,6,6
"01081",2018,0,0,14,14
"01081",2019,0,0,27,27
"01081",2020,0,0,14,14
"01082",2015,0,0,6,6
"01082",2018,0,0,14,14
"01082",2019,0,0,27,27
"01082",2020,0,0,14,14
"01083",2015,0,43,0,43
"01083",2017,0,115,27,142
"01083",2018,0,117,14,131
"01083",2019,0,41,27,68
"01083",2020,0,0,78,78
"01084",2015,0,43,0,43
"01084",2017,0,115,27,142
"01084",2018,0,117,14,131
"01084",2019,0,41,27,68
"01084",2020,0,0,78,78
"01085",2015,0,43,0,43
"01085",2017,0,115,27,142
"01085",2018,0,117,14,131
"01085",2019,0,41,27,68
"01085",2020,0,0,78,78
"01087",2015,0,0,6,6
"01087",2018,0,0,14,14
"01087",2019,0,0,27,27
"01087",2020,0,0,14,14
"01088",2017,0,53,27,80
"01088",2018,0,117,14,131
"01088",2019,0,231,27,258
"01088",2020,0,104,78,182
"01089",2017,0,53,27,80
"01089",2018,0,117,14,131
"01089",2019,0,231,27,258
"01089",2020,0,104,78,182
"01090",2017,0,53,27,80
"01090",2018,0,117,14,131
"01090",2019,0,41,27,68
"01090",2020,0,0,78,78
"01092",2017,0,53,27,80
"01092",2018,0,117,14,131
"01092",2019,0,41,27,68
"01092",2020,0,0,78,78
"01093",2015,0,43,0,43
"01093",2017,0,115,27,142
"01093",2018,0,117,14,131
"01093",2019,0,41,27,68
"01093",2020,0,0,78,78
"01094",2017,0,0,27,27
"01094",2018,0,0,14,14
"01094",2019,0,0,27,27
"01094",2020,0,0,14,14
"01095",2017,0,0,27,27
"01095",2018,0,0,14,14
"01095",2019,0,0,27,27
"01095",2020,0,0,14,14
"01096",2015,0,43,0,43
"01096",2017,0,115,27,142
"01096",2018,0,117,14,131
"01096",2019,0,41,27,68
"01096",2020,0,0,78,78
"01098",2015,0,0,6,6
"01098",2018,0,0,14,14
"01098",2019,0,0,27,27
"01098",2020,0,0,14,14
"01099",2017,0,53,27,80
"01099",2018,0,117,14,131
"01099",2019,0,231,27,258
"01099",2020,0,104,78,182
"01100",2015,0,0,43,43
"01100",2017,0,0,62,62
"01100",2018,0,0,59,59
"01100",2019,0,0,115,115
"01101",2015,0,0,43,43
"01101",2017,0,0,62,62
"01101",2018,0,0,59,59
"01101",2019,0,0,115,115
"01102",2017,0,0,27,27
"01102",2018,0,0,14,14
"01102",2019,0,0,27,27
"01102",2020,0,0,14,14
"01103",2015,0,43,6,49
"01103",2017,0,53,0,53
"01103",2018,0,117,14,131
"01103",2019,0,231,27,258
"01103",2020,0,0,14,14
"01104",2015,0,43,6,49
"01104",2017,0,53,0,53
"01104",2018,0,117,14,131
"01104",2019,0,231,27,258
"01104",2020,0,0,14,14
"01105",2015,0,43,0,43
"01105",2017,0,115,27,142
"01105",2018,0,117,14,131
"01105",2019,0,41,27,68
"01105",2020,0,0,78,78
"01106",2015,0,0,43,43
"01106",2017,0,0,62,62
"01106",2018,0,0,59,59
"01106",2019,0,0,115,115
"01107",2015,0,0,43,43
"01107",2017,0,0,62,62
"01107",2018,0,0,59,59
"01107",2019,0,0,115,115
"01108",2017,0,0,27,27
"01108",2018,0,0,14,14
"01108",2019,0,0,27,27
"01108",2020,0,0,14,14
"01109",2015,0,43,6,49
"01109",2017,0,53,0,53
"01109",2018,0,117,14,131
"01109",2019,0,231,27,258
"01109",2020,0,0,14,14
"01110",2015,0,0,43,43
"01110",2017,0,0,62,62
"01110",2018,0,0,59,59
"01110",2019,0,0,115,115
"01111",2015,0,0,43,43
"01111",2017,0,0,62,62
"01111",2018,0,0,59,59
"01111",2019,0,0,115,115
"01112",2015,0,0,43,43
"01112",2017,0,0,62,62
"01112",2018,0,0,59,59
"01112",2019,0,0,115,115
"01113",2015,0,43,0,43
"01113",2017,0,115,27,142
"01113",2018,0,117,14,131
"01113",2019,0,41,27,68
"01113",2020,0,0,78,78
"01114",2015,0,43,6,49
"01114",2017,0,53,0,53
"01114",2018,0,117,14,131
"01114",2019,0,231,27,258
"01114",2020,0,0,14,14
"01115",2017,0,0,27,27
"01115",2018,0,0,14,14
"01115",2019,0,0,27,27
"01115",2020,0,0,78,78
"01116",2015,0,0,43,43
"01116",2017,0,0,62,62
"01116",2018,0,0,59,59
"01116",2019,0,0,115,115
"01117",2015,0,0,43,43
"01117",2017,0,0,62,62
"01117",2018,0,0,59,59
"01117",2019,0,0,115,115
"01118",2015,0,0,6,6
"01118",2018,0,0,14,14
"01118",2019,0,0,27,27
"01118",2020,0,0,14,14
"01121",2015,0,0,43,43
"01121",2017,0,0,62,62
"01121",2018,0,0,59,59
"01121",2019,0,0,115,115
"01123",2015,0,43,0,43
"01123",2017,0,115,27,142
"01123",2018,0,117,14,131
"01123",2019,0,41,27,68
"01123",2020,0,0,78,78
"01124",2017,0,0,27,27
"01124",2018,0,0,14,14
"01124",2019,0,0,27,27
"01124",2020,0,0,14,14
"01125",2015,0,0,43,43
"01125",2017,0,0,62,62
"01125",2018,0,0,59,59
"01125",2019,0,0,115,115
"01127",2017,0,0,27,27
"01127",2018,0,0,14,14
"01127",2019,0,0,27,27
"01127",2020,0,0,14,14
"01128",2017,0,0,27,27
"01128",2018,0,0,14,14
"01128",2019,0,0,27,27
"01128",2020,0,0,14,14
"01129",2017,0,53,27,80
"01129",2018,0,117,14,131
"01129",2019,0,41,27,68
"01129",2020,0,0,78,78
"01130",2017,0,0,27,27
"01130",2018,0,0,14,14
"01130",2019,0,0,27,27
"01130",2020,0,0,14,14
"01133",2015,0,0,6,6
"01133",2018,0,0,14,14
"01133",2019,0,0,27,27
"01133",2020,0,0,14,14
"01134",2015,0,43,0,43
"01134",2017,0,115,27,142
"01134",2018,0,117,14,131
"01134",2019,0,41,27,68
"01134",2020,0,0,78,78
"01135",2015,0,43,6,49
"01135",2017,0,53,0,53
"01135",2018,0,117,14,131
"01135",2019,0,231,27,258
"01135",2020,0,0,14,14
"01136",2015,0,43,0,43
"01136",2017,0,115,27,142
"01136",2018,0,117,14,131
"01136",2019,0,41,27,68
"01136",2020,0,0,78,78
"01138",2015,0,0,6,6
"01138",2018,0,0,14,14
"01138",2019,0,0,27,27
"01138",2020,0,0,14,14
"01139",2017,0,0,27,27
"01139",2018,0,0,14,14
"01139",2019,0,0,27,27
"01139",2020,0,0,14,14
"01140",2017,0,0,27,27
"01140",2018,0,0,14,14
"01140",2019,0,0,27,27
"01140",2020,0,0,78,78
"01141",2015,0,0,6,6
"01141",2018,0,0,14,14
"01141",2019,0,0,27,27
"01141",2020,0,0,14,14
"01142",2017,0,53,27,80
"01142",2018,0,117,14,131
"01142",2019,0,41,27,68
"01142",2020,0,0,78,78
"01143",2015,0,43,6,49
"01143",2017,0,53,0,53
"01143",2018,0,117,14,131
"01143",2019,0,231,27,258
"01143",2020,0,0,14,14
"01145",2017,0,53,27,80
"01145",2018,0,117,14,131
"01145",2019,0,41,27,68
"01145",2020,0,0,78,78
"01146",2015,0,43,0,43
"01146",2017,0,115,27,142
"01146",2018,0,117,14,131
"01146",2019,0,41,27,68
"01146",2020,0,0,78,78
"01147",2017,0,0,27,27
"01147",2018,0,0,14,14
"01147",2019,0,0,27,27
"01147",2020,0,0,14,14
"01148",2015,0,0,43,43
"01148",2017,0,0,62,62
"01148",2018,0,0,59,59
"01148",2019,0,0,115,115
"01149",2015,0,0,43,43
"01149",2017,0,53,62,115
"01149",2018,0,117,59,176
"01149",2019,0,231,115,346
"01149",2020,0,104,0,104
"01150",2017,0,0,27,27
"01150",2018,0,0,14,14
"01150",2019,0,0,27,27
"01150",2020,0,0,14,14
"01151",2017,0,53,27,80
"01151",2018,0,117,14,131
"01151",2019,0,41,27,68
"01151",2020,0,0,78,78
"01152",2015,0,0,6,6
"01152",2018,0,0,14,14
"01152",2019,0,0,27,27
"01152",2020,0,0,14,14
"01153",2015,0,43,6,49
"01153",2017,0,53,0,53
"01153",2018,0,117,14,131
"01153",2019,0,231,27,258
"01153",2020,0,0,14,14
"01155",2015,0,0,43,43
"01155",2017,0,0,62,62
"01155",2018,0,0,59,59
"01155",2019,0,0,115,115
"01156",2017,0,53,27,80
"01156",2018,0,117,14,131
"01156",2019,0,41,27,68
"01156",2020,0,0,78,78
"01157",2015,0,43,0,43
"01157",2017,0,115,27,142
"01157",2018,0,117,14,131
"01157",2019,0,41,27,68
"01157",2020,0,0,78,78
"01158",2015,0,43,6,49
"01158",2017,0,53,0,53
"01158",2018,0,117,14,131
"01158",2019,0,231,27,258
"01158",2020,0,0,14,14
"01159",2017,0,0,27,27
"01159",2018,0,0,14,14
"01159",2019,0,0,27,27
"01159",2020,0,0,14,14
"01160",2015,0,43,6,49
"01160",2017,0,53,0,53
"01160",2018,0,117,14,131
"01160",2019,0,231,27,258
"01160",2020,0,0,14,14
"01162",2015,0,0,6,6
"01162",2018,0,0,14,14
"01162",2019,0,0,27,27
"01162",2020,0,0,14,14
"01163",2017,0,0,27,27
"01163",2018,0,0,14,14
"01163",2019,0,0,27,27
"01163",2020,0,0,14,14
"01165",2015,0,43,0,43
"01165",2017,0,115,27,142
"01165",2018,0,117,14,131
"01165",2019,0,41,27,68
"01165",2020,0,0,78,78
"01166",2015,0,43,0,43
"01166",2017,0,115,27,142
"01166",2018,0,117,14,131
"01166",2019,0,41,27,68
"01166",2020,0,0,78,78
"01167",2015,0,43,0,43
"01167",2017,0,115,27,142
"01167",2018,0,117,14,131
"01167",2019,0,41,27,68
"01167",2020,0,0,78,78
"01169",2017,0,0,27,27
"01169",2018,0,0,14,14
"01169",2019,0,0,27,27
"01169",2020,0,0,78,78
"01170",2015,0,0,43,43
"01170",2017,0,0,62,62
"01170",2018,0,0,59,59
"01170",2019,0,0,115,115
"01171",2015,0,0,43,43
"01171",2017,0,0,62,62
"01171",2018,0,0,59,59
"01171",2019,0,0,115,115
"01173",2015,0,43,6,49
"01173",2017,0,53,0,53
"01173",2018,0,117,14,131
"01173",2019,0,231,27,258
"01173",2020,0,0,14,14
"01174",2015,0,0,6,6
"01174",2018,0,0,14,14
"01174",2019,0,0,27,27
"01174",2020,0,0,14,14
"01175",2017,0,0,27,27
"01175",2018,0,0,14,14
"01175",2019,0,0,27,27
"01175",2020,0,0,14,14
"01177",2015,0,0,43,43
"01177",2017,0,0,62,62
"01177",2018,0,0,59,59
"01177",2019,0,0,115,115
"01179",2015,0,43,0,43
"01179",2017,0,115,27,142
"01179",2018,0,117,14,131
"01179",2019,0,41,27,68
"01179",2020,0,0,78,78
"01180",2015,0,43,6,49
"01180",2017,0,53,0,53
"01180",2018,0,117,14,131
"01180",2019,0,231,27,258
"01180",2020,0,0,14,14
"01181",2015,0,0,43,43
"01181",2017,0,0,62,62
"01181",2018,0,0,59,59
"01181",2019,0,0,115,115
"01183",2015,0,43,0,43
"01183",2017,0,115,27,142
"01183",2018,0,117,14,131
"01183",2019,0,41,27,68
"01183",2020,0,0,78,78
"01184",2015,0,0,43,43
"01184",2017,0,0,62,62
"01184",2018,0,0,59,59
"01184",2019,0,0,115,115
"01185",2015,0,0,6,6
"01185",2018,0,0,14,14
"01185",2019,0,0,27,27
"01185",2020,0,0,14,14
"01187",2015,0,0,6,6
"01187",2018,0,0,14,14
"01187",2019,0,0,27,27
"01187",2020,0,0,14,14
"01188",2015,0,43,0,43
"01188",2017,0,115,27,142
"01188",2018,0,117,14,131
"01188",2019,0,41,27,68
"01188",2020,0,0,78,78
"01189",2015,0,0,6,6
"01189",2018,0,0,14,14
"01189",2019,0,0,27,27
"01189",2020,0,0,14,14
"01190",2015,0,0,43,43
"01190",2017,0,0,62,62
"01190",2018,0,0,59,59
"01190",2019,0,0,115,115
"01191",2015,0,0,43,43
"01191",2017,0,0,62,62
"01191",2018,0,0,59,59
"01191",2019,0,0,115,115
"01192",2015,0,0,43,43
"01192",2017,0,0,62,62
"01192",2018,0,0,59,59
"01192",2019,0,0,115,115
"01193",2015,0,0,43,43
"01193",2017,0,0,62,62
"01193",2018,0,0,59,59
"01193",2019,0,0,115,115
"01194",2015,0,43,0,43
"01194",2017,0,115,27,142
"01194",2018,0,117,14,131
"01194",2019,0,41,27,68
"01194",2020,0,0,78,78
"01195",2015,0,43,0,43
"01195",2017,0,115,27,142
"01195",2018,0,117,14,131
"01195",2019,0,41,27,68
"01195",2020,0,0,14,14
"01196",2017,0,0,27,27
"01196",2018,0,0,14,14
"01196",2019,0,0,27,27
"01196",2020,0,0,14,14
"01197",2015,0,43,0,43
"01197",2017,0,115,27,142
"01197",2018,0,117,14,131
"01197",2019,0,41,27,68
"01197",2020,0,0,14,14
"01198",2015,0,43,0,43
"01198",2017,0,115,27,142
"01198",2018,0,117,14,131
"01198",2019,0,41,27,68
"01198",2020,0,0,78,78
"01199",2015,0,0,43,43
"01199",2017,0,53,62,115
"01199",2018,0,117,59,176
"01199",2019,0,231,115,346
"01199",2020,0,104,0,104
"01200",2015,0,0,43,43
"01200",2017,0,0,62,62
"01200",2018,0,0,59,59
"01200",2019,0,0,115,115
"01202",2015,0,0,43,43
"01202",2017,0,53,62,115
"01202",2018,0,117,59,176
"01202",2019,0,231,115,346
"01202",2020,0,104,0,104
"01203",2015,0,43,0,43
"01203",2017,0,115,27,142
"01203",2018,0,117,14,131
"01203",2019,0,41,27,68
"01203",2020,0,0,78,78
"01204",2015,0,0,6,6
"01204",2018,0,0,14,14
"01204",2019,0,0,27,27
"01204",2020,0,0,14,14
"01206",2015,0,0,43,43
"01206",2017,0,0,62,62
"01206",2018,0,0,59,59
"01206",2019,0,0,115,115
"01207",2015,0,43,0,43
"01207",2017,0,115,27,142
"01207",2018,0,117,14,131
"01207",2019,0,41,27,68
"01207",2020,0,0,78,78
"01208",2015,0,0,6,6
"01208",2018,0,0,14,14
"01208",2019,0,0,27,27
"01208",2020,0,0,14,14
"01209",2015,0,43,6,49
"01209",2017,0,53,0,53
"01209",2018,0,117,14,131
"01209",2019,0,231,27,258
"01209",2020,0,0,14,14
"01210",2015,0,43,6,49
"01210",2017,0,53,0,53
"01210",2018,0,117,14,131
"01210",2019,0,231,27,258
"01210",2020,0,0,14,14
"01211",2015,0,43,0,43
"01211",2017,0,115,27,142
"01211",2018,0,117,14,131
"01211",2019,0,41,27,68
"01211",2020,0,0,78,78
"01212",2017,0,0,27,27
"01212",2018,0,0,14,14
"01212",2019,0,0,27,27
"01212",2020,0,0,14,14
"01213",2015,0,0,43,43
"01213",2017,0,53,62,115
"01213",2018,0,117,59,176
"01213",2019,0,231,115,346
"01213",2020,0,104,0,104
"01214",2015,0,0,43,43
"01214",2017,0,0,62,62
"01214",2018,0,0,59,59
"01214",2019,0,0,115,115
"01215",2015,0,0,6,6
"01215",2018,0,0,14,14
"01215",2019,0,0,27,27
"01215",2020,0,0,14,14
"01216",2015,0,0,43,43
"01216",2017,0,0,62,62
"01216",2018,0,0,59,59
"01216",2019,0,0,115,115
"01219",2015,0,0,43,43
"01219",2017,0,0,62,62
"01219",2018,0,0,59,59
"01219",2019,0,0,115,115
"01224",2017,0,53,27,80
"01224",2018,0,117,14,131
"01224",2019,0,231,27,258
"01224",2020,0,104,78,182
"01225",2015,0,43,0,43
"01225",2017,0,115,27,142
"01225",2018,0,117,14,131
"01225",2019,0,41,27,68
"01225",2020,0,0,78,78
"01227",2015,0,0,6,6
"01227",2018,0,0,14,14
"01227",2019,0,0,27,27
"01227",2020,0,0,14,14
"01228",2015,0,0,43,43
"01228",2017,0,0,62,62
"01228",2018,0,0,59,59
"01228",2019,0,0,115,115
"01229",2017,0,0,27,27
"01229",2018,0,0,14,14
"01229",2019,0,0,27,27
"01229",2020,0,0,14,14
"01230",2017,0,0,27,27
"01230",2018,0,0,14,14
"01230",2019,0,0,27,27
"01230",2020,0,0,14,14
"01231",2017,0,0,27,27
"01231",2018,0,0,14,14
"01231",2019,0,0,27,27
"01231",2020,0,0,14,14
"01232",2017,0,0,27,27
"01232",2018,0,0,14,14
"01232",2019,0,0,27,27
"01232",2020,0,0,14,14
"01233",2015,0,0,43,43
"01233",2017,0,0,62,62
"01233",2018,0,0,59,59
"01233",2019,0,0,115,115
"01234",2015,0,0,6,6
"01234",2018,0,0,14,14
"01234",2019,0,0,27,27
"01234",2020,0,0,14,14
"01235",2015,0,43,0,43
"01235",2017,0,115,27,142
"01235",2018,0,117,14,131
"01235",2019,0,41,27,68
"01235",2020,0,0,78,78
"01236",2017,0,0,27,27
"01236",2018,0,0,14,14
"01236",2019,0,0,27,27
"01236",2020,0,0,14,14
"01237",2015,0,0,43,43
"01237",2017,0,0,62,62
"01237",2018,0,0,59,59
"01237",2019,0,0,115,115
"01238",2015,0,43,0,43
"01238",2017,0,115,27,142
"01238",2018,0,117,14,131
"01238",2019,0,41,27,68
"01238",2020,0,0,78,78
"01239",2015,0,0,6,6
"01239",2018,0,0,14,14
"01239",2019,0,0,27,27
"01239",2020,0,0,14,14
"01240",2015,0,0,43,43
"01240",2017,0,0,62,62
"01240",2018,0,0,59,59
"01240",2019,0,0,115,115
"01241",2017,0,0,27,27
"01241",2018,0,0,14,14
"01241",2019,0,0,27,27
"01241",2020,0,0,14,14
"01242",2015,0,0,43,43
"01242",2017,0,53,62,115
"01242",2018,0,117,59,176
"01242",2019,0,231,115,346
"01242",2020,0,104,0,104
"01243",2015,0,43,0,43
"01243",2017,0,115,27,142
"01243",2018,0,117,14,131
"01243",2019,0,41,27,68
"01243",2020,0,0,78,78
"01244",2017,0,53,27,80
"01244",2018,0,117,14,131
"01244",2019,0,41,27,68
"01244",2020,0,0,78,78
"01245",2017,0,53,27,80
"01245",2018,0,117,14,131
"01245",2019,0,41,27,68
"01245",2020,0,0,14,14
"01246",2015,0,43,0,43
"01246",2017,0,115,27,142
"01246",2018,0,117,14,131
"01246",2019,0,41,27,68
"01246",2020,0,0,78,78
"01247",2015,0,43,6,49
"01247",2017,0,53,0,53
"01247",2018,0,117,14,131
"01247",2019,0,231,27,258
"01247",2020,0,0,14,14
"01248",2015,0,43,0,43
"01248",2017,0,115,27,142
"01248",2018,0,117,14,131
"01248",2019,0,41,27,68
"01248",2020,0,0,78,78
"01249",2015,0,43,0,43
"01249",2017,0,115,27,142
"01249",2018,0,117,14,131
"01249",2019,0,41,27,68
"01249",2020,0,0,78,78
"01250",2015,0,43,0,43
"01250",2017,0,115,27,142
"01250",2018,0,117,14,131
"01250",2019,0,41,27,68
"01250",2020,0,0,78,78
"01252",2015,0,43,0,43
"01252",2017,0,115,27,142
"01252",2018,0,117,14,131
"01252",2019,0,41,27,68
"01252",2020,0,0,78,78
"01254",2015,0,43,0,43
"01254",2017,0,115,27,142
"01254",2018,0,117,14,131
"01254",2019,0,41,27,68
"01254",2020,0,0,78,78
"01255",2015,0,0,43,43
"01255",2017,0,0,62,62
"01255",2018,0,0,59,59
"01255",2019,0,0,115,115
"01257",2015,0,0,6,6
"01257",2018,0,0,14,14
"01257",2019,0,0,27,27
"01257",2020,0,0,14,14
"01258",2015,0,43,0,43
"01258",2017,0,115,27,142
"01258",2018,0,117,14,131
"01258",2019,0,41,27,68
"01258",2020,0,0,78,78
"01259",2015,0,43,0,43
"01259",2017,0,115,27,142
"01259",2018,0,117,14,131
"01259",2019,0,41,27,68
"01259",2020,0,0,78,78
"01260",2015,0,43,0,43
"01260",2017,0,115,27,142
"01260",2018,0,117,14,131
"01260",2019,0,41,27,68
"01260",2020,0,0,78,78
"01261",2015,0,43,0,43
"01261",2017,0,115,27,142
"01261",2018,0,117,14,131
"01261",2019,0,41,27,68
"01261",2020,0,0,78,78
"01262",2017,0,53,27,80
"01262",2018,0,117,14,131
"01262",2019,0,41,27,68
"01262",2020,0,0,78,78
"01263",2015,0,43,0,43
"01263",2017,0,115,27,142
"01263",2018,0,117,14,131
"01263",2019,0,41,27,68
"01263",2020,0,0,78,78
"01264",2015,0,43,0,43
"01264",2017,0,115,27,142
"01264",2018,0,117,14,131
"01264",2019,0,41,27,68
"01264",2020,0,0,78,78
"01265",2015,0,0,43,43
"01265",2017,0,0,62,62
"01265",2018,0,0,59,59
"01265",2019,0,0,115,115
"01266",2017,0,0,27,27
"01266",2018,0,0,14,14
"01266",2019,0,0,27,27
"01266",2020,0,0,14,14
"01267",2015,0,0,43,43
"01267",2017,0,0,62,62
"01267",2018,0,0,59,59
"01267",2019,0,0,115,115
"01268",2015,0,0,43,43
"01268",2017,0,0,62,62
"01268",2018,0,0,59,59
"01268",2019,0,0,115,115
"01269",2015,0,0,6,6
"01269",2018,0,0,14,14
"01269",2019,0,0,27,27
"01269",2020,0,0,14,14
"01272",2015,0,43,0,43
"01272",2017,0,115,27,142
"01272",2018,0,117,14,131
"01272",2019,0,41,27,68
"01272",2020,0,0,78,78
"01273",2017,0,53,27,80
"01273",2018,0,117,14,131
"01273",2019,0,41,27,68
"01273",2020,0,0,14,14
"01274",2015,0,0,6,6
"01274",2018,0,0,14,14
"01274",2019,0,0,27,27
"01274",2020,0,0,14,14
"01275",2015,0,43,0,43
"01275",2017,0,115,27,142
"01275",2018,0,117,14,131
"01275",2019,0,41,27,68
"01275",2020,0,0,78,78
"01276",2017,0,53,27,80
"01276",2018,0,117,14,131
"01276",2019,0,41,27,68
"01276",2020,0,0,78,78
"01277",2015,0,0,43,43
"01277",2017,0,0,62,62
"01277",2018,0,0,59,59
"01277",2019,0,0,115,115
"01279",2015,0,0,43,43
"01279",2017,0,0,62,62
"01279",2018,0,0,59,59
"01279",2019,0,0,115,115
"01280",2015,0,0,43,43
"01280",2017,0,0,62,62
"01280",2018,0,0,59,59
"01280",2019,0,0,115,115
"01281",2015,0,43,6,49
"01281",2017,0,53,0,53
"01281",2018,0,117,14,131
"01281",2019,0,231,27,258
"01281",2020,0,0,14,14
"01282",2015,0,0,43,43
"01282",2017,0,0,62,62
"01282",2018,0,0,59,59
"01282",2019,0,0,115,115
"01283",2015,0,0,6,6
"01283",2018,0,0,14,14
"01283",2019,0,0,27,27
"01283",2020,0,0,14,14
"01284",2017,0,0,27,27
"01284",2018,0,0,14,14
"01284",2019,0,0,27,27
"01284",2020,0,0,14,14
"01285",2017,0,115,27,142
"01285",2018,0,117,14,131
"01285",2019,0,41,27,68
"01285",2020,0,0,78,78
"01286",2015,0,0,6,6
"01286",2018,0,0,14,14
"01286",2019,0,0,27,27
"01286",2020,0,0,14,14
"01288",2015,0,43,6,49
"01288",2017,0,53,0,53
"01288",2018,0,117,14,131
"01288",2019,0,231,27,258
"01288",2020,0,0,14,14
"01289",2015,0,43,0,43
"01289",2017,0,115,27,142
"01289",2018,0,117,14,131
"01289",2019,0,41,27,68
"01289",2020,0,0,78,78
"01290",2017,0,53,27,80
"01290",2018,0,117,14,131
"01290",2019,0,41,27,68
"01290",2020,0,0,78,78
"01291",2015,0,43,0,43
"01291",2017,0,115,27,142
"01291",2018,0,117,14,131
"01291",2019,0,41,27,68
"01291",2020,0,0,78,78
"01293",2015,0,0,43,43
"01293",2017,0,0,62,62
"01293",2018,0,0,59,59
"01293",2019,0,0,115,115
"01294",2015,0,0,43,43
"01294",2017,0,0,62,62
"01294",2018,0,0,59,59
"01294",2019,0,0,115,115
"01295",2015,0,43,0,43
"01295",2017,0,115,27,142
"01295",2018,0,117,14,131
"01295",2019,0,41,27,68
"01295",2020,0,0,78,78
"01296",2017,0,0,27,27
"01296",2018,0,0,14,14
"01296",2019,0,0,27,27
"01296",2020,0,0,14,14
"01297",2017,0,53,27,80
"01297",2018,0,117,14,131
"01297",2019,0,41,27,68
"01297",2020,0,0,78,78
"01298",2015,0,0,6,6
"01298",2018,0,0,14,14
"01298",2019,0,0,27,27
"01298",2020,0,0,14,14
"01299",2015,0,43,0,43
"01299",2017,0,115,27,142
"01299",2018,0,117,14,131
"01299",2019,0,41,27,68
"01299",2020,0,0,78,78
"01301",2015,0,43,0,43
"01301",2017,0,115,27,142
"01301",2018,0,117,14,131
"01301",2019,0,41,27,68
"01301",2020,0,0,78,78
"01302",2015,0,0,6,6
"01302",2018,0,0,14,14
"01302",2019,0,0,27,27
"01302",2020,0,0,14,14
"01303",2015,0,0,43,43
"01303",2017,0,53,62,115
"01303",2018,0,117,59,176
"01303",2019,0,231,115,346
"01303",2020,0,104,0,104
"01304",2017,0,53,27,80
"01304",2018,0,117,14,131
"01304",2019,0,41,27,68
"01304",2020,0,0,78,78
"01305",2017,0,0,27,27
"01305",2018,0,0,14,14
"01305",2019,0,0,27,27
"01305",2020,0,0,14,14
"01306",2015,0,43,0,43
"01306",2017,0,115,27,142
"01306",2018,0,117,14,131
"01306",2019,0,41,27,68
"01306",2020,0,0,78,78
"01307",2015,0,0,43,43
"01307",2017,0,0,62,62
"01307",2018,0,0,59,59
"01307",2019,0,0,115,115
"01308",2015,0,43,6,49
"01308",2017,0,53,0,53
"01308",2018,0,117,14,131
"01308",2019,0,231,27,258
"01308",2020,0,0,14,14
"01309",2015,0,0,43,43
"01309",2017,0,0,62,62
"01309",2018,0,0,59,59
"01309",2019,0,0,115,115
"01310",2015,0,0,43,43
"01310",2017,0,0,62,62
"01310",2018,0,0,59,59
"01310",2019,0,0,115,115
"01311",2015,0,0,43,43
"01311",2017,0,0,62,62
"01311",2018,0,0,59,59
"01311",2019,0,0,115,115
"01313",2015,0,43,6,49
"01313",2017,0,53,0,53
"01313",2018,0,117,14,131
"01313",2019,0,231,27,258
"01313",2020,0,0,14,14
"01314",2017,0,53,27,80
"01314",2018,0,117,14,131
"01314",2019,0,231,27,258
"01314",2020,0,104,78,182
"01317",2017,0,0,27,27
"01317",2018,0,0,14,14
"01317",2019,0,0,27,27
"01317",2020,0,0,14,14
"01318",2015,0,43,0,43
"01318",2017,0,115,27,142
"01318",2018,0,117,14,131
"01318",2019,0,41,27,68
"01318",2020,0,0,78,78
"01319",2015,0,43,0,43
"01319",2017,0,115,27,142
"01319",2018,0,117,14,131
"01319",2019,0,41,27,68
"01319",2020,0,0,78,78
"01320",2017,0,0,27,27
"01320",2018,0,0,14,14
"01320",2019,0,0,27,27
"01320",2020,0,0,78,78
"01321",2015,0,43,0,43
"01321",2017,0,115,27,142
"01321",2018,0,117,14,131
"01321",2019,0,41,27,68
"01321",2020,0,0,14,14
"01322",2015,0,43,0,43
"01322",2017,0,115,27,142
"01322",2018,0,117,14,131
"01322",2019,0,41,27,68
"01322",2020,0,0,78,78
"01323",2017,0,0,27,27
"01323",2018,0,0,14,14
"01323",2019,0,0,27,27
"01323",2020,0,0,14,14
"01325",2017,0,53,27,80
"01325",2018,0,117,14,131
"01325",2019,0,41,27,68
"01325",2020,0,0,78,78
"01328",2015,0,43,0,43
"01328",2017,0,115,27,142
"01328",2018,0,117,14,131
"01328",2019,0,41,27,68
"01328",2020,0,0,78,78
"01329",2015,0,0,43,43
"01329",2017,0,0,62,62
"01329",2018,0,0,59,59
"01329",2019,0,0,115,115
"01330",2015,0,0,6,6
"01330",2018,0,0,14,14
"01330",2019,0,0,27,27
"01330",2020,0,0,14,14
"01331",2015,0,0,43,43
"01331",2017,0,0,62,62
"01331",2018,0,0,59,59
"01331",2019,0,0,115,115
"01332",2017,0,0,27,27
"01332",2018,0,0,14,14
"01332",2019,0,0,27,27
"01332",2020,0,0,78,78
"01333",2015,0,43,0,43
"01333",2017,0,115,27,142
"01333",2018,0,117,14,131
"01333",2019,0,41,27,68
"01333",2020,0,0,78,78
"01334",2015,0,43,0,43
"01334",2017,0,115,27,142
"01334",2018,0,117,14,131
"01334",2019,0,41,27,68
"01334",2020,0,0,78,78
"01335",2015,0,43,0,43
"01335",2017,0,115,27,142
"01335",2018,0,117,14,131
"01335",2019,0,41,27,68
"01335",2020,0,0,78,78
"01336",2015,0,43,0,43
"01336",2017,0,115,27,142
"01336",2018,0,117,14,131
"01336",2019,0,41,27,68
"01336",2020,0,0,78,78
"01337",2017,0,0,27,27
"01337",2018,0,0,14,14
"01337",2019,0,0,27,27
"01337",2020,0,0,14,14
"01338",2015,0,0,43,43
"01338",2017,0,0,62,62
"01338",2018,0,0,59,59
"01338",2019,0,0,115,115
"01339",2015,0,43,0,43
"01339",2017,0,115,27,142
"01339",2018,0,117,14,131
"01339",2019,0,41,27,68
"01339",2020,0,0,78,78
"01342",2015,0,43,0,43
"01342",2017,0,115,27,142
"01342",2018,0,117,14,131
"01342",2019,0,41,27,68
"01342",2020,0,0,78,78
"01343",2017,0,0,27,27
"01343",2018,0,0,14,14
"01343",2019,0,0,27,27
"01343",2020,0,0,78,78
"01344",2015,0,43,0,43
"01344",2017,0,115,27,142
"01344",2018,0,117,14,131
"01344",2019,0,41,27,68
"01344",2020,0,0,78,78
"01345",2015,0,0,43,43
"01345",2017,0,53,62,115
"01345",2018,0,117,59,176
"01345",2019,0,231,115,346
"01345",2020,0,104,0,104
"01346",2017,0,0,27,27
"01346",2018,0,0,14,14
"01346",2019,0,0,27,27
"01346",2020,0,0,78,78
"01347",2015,0,43,0,43
"01347",2017,0,115,27,142
"01347",2018,0,117,14,131
"01347",2019,0,41,27,68
"01347",2020,0,0,78,78
"01348",2015,0,43,0,43
"01348",2017,0,115,27,142
"01348",2018,0,117,14,131
"01348",2019,0,41,27,68
"01348",2020,0,0,78,78
"01349",2017,0,53,27,80
"01349",2018,0,117,14,131
"01349",2019,0,41,27,68
"01349",2020,0,0,78,78
"01350",2017,0,0,27,27
"01350",2018,0,0,14,14
"01350",2019,0,0,27,27
"01350",2020,0,0,14,14
"01351",2015,0,43,0,43
"01351",2017,0,115,27,142
"01351",2018,0,117,14,131
"01351",2019,0,41,27,68
"01351",2020,0,0,78,78
"01352",2017,0,0,27,27
"01352",2018,0,0,14,14
"01352",2019,0,0,27,27
"01352",2020,0,0,14,14
"01353",2015,0,43,0,43
"01353",2017,0,115,27,142
"01353",2018,0,117,14,131
"01353",2019,0,41,27,68
"01353",2020,0,0,78,78
"01354",2015,0,43,6,49
"01354",2017,0,53,0,53
"01354",2018,0,117,14,131
"01354",2019,0,231,27,258
"01354",2020,0,0,14,14
"01355",2017,0,0,27,27
"01355",2018,0,0,14,14
"01355",2019,0,0,27,27
"01355",2020,0,0,78,78
"01356",2015,0,43,0,43
"01356",2017,0,115,27,142
"01356",2018,0,117,14,131
"01356",2019,0,41,27,68
"01356",2020,0,0,78,78
"01357",2015,0,0,6,6
"01357",2018,0,0,14,14
"01357",2019,0,0,27,27
"01357",2020,0,0,14,14
"01358",2015,0,0,43,43
"01358",2017,0,0,62,62
"01358",2018,0,0,59,59
"01358",2019,0,0,115,115
"01359",2015,0,43,0,43
"01359",2017,0,115,27,142
"01359",2018,0,117,14,131
"01359",2019,0,41,27,68
"01359",2020,0,0,78,78
"01360",2015,0,43,6,49
"01360",2017,0,53,0,53
"01360",2018,0,117,14,131
"01360",2019,0,231,27,258
"01360",2020,0,0,14,14
"01361",2017,0,53,27,80
"01361",2018,0,117,14,131
"01361",2019,0,231,27,258
"01361",2020,0,104,78,182
"01362",2015,0,43,0,43
"01362",2017,0,115,27,142
"01362",2018,0,117,14,131
"01362",2019,0,41,27,68
"01362",2020,0,0,78,78
"01363",2015,0,0,43,43
"01363",2017,0,53,62,115
"01363",2018,0,117,59,176
"01363",2019,0,231,115,346
"01363",2020,0,104,0,104
"01364",2017,0,0,27,27
"01364",2018,0,0,14,14
"01364",2019,0,0,27,27
"01364",2020,0,0,14,14
"01365",2015,0,43,0,43
"01365",2017,0,115,27,142
"01365",2018,0,117,14,131
"01365",2019,0,41,27,68
"01365",2020,0,0,78,78
"01366",2015,0,0,43,43
"01366",2017,0,53,62,115
"01366",2018,0,117,59,176
"01366",2019,0,231,115,346
"01366",2020,0,104,0,104
"01367",2017,0,0,27,27
"01367",2018,0,0,14,14
"01367",2019,0,0,27,27
"01367",2020,0,0,14,14
"01368",2015,0,43,0,43
"01368",2017,0,115,27,142
"01368",2018,0,117,14,131
"01368",2019,0,41,27,68
"01368",2020,0,0,78,78
"01369",2015,0,43,0,43
"01369",2017,0,115,27,142
"01369",2018,0,117,14,131
"01369",2019,0,41,27,68
"01369",2020,0,0,14,14
"01370",2017,0,0,27,27
"01370",2018,0,0,14,14
"01370",2019,0,0,27,27
"01370",2020,0,0,78,78
"01371",2015,0,43,0,43
"01371",2017,0,115,27,142
"01371",2018,0,117,14,131
"01371",2019,0,41,27,68
"01371",2020,0,0,78,78
"01372",2015,0,0,6,6
"01372",2018,0,0,14,14
"01372",2019,0,0,27,27
"01372",2020,0,0,14,14
"01373",2015,0,0,43,43
"01373",2017,0,0,62,62
"01373",2018,0,0,59,59
"01373",2019,0,0,115,115
"01374",2017,0,53,27,80
"01374",2018,0,117,14,131
"01374",2019,0,41,27,68
"01374",2020,0,0,14,14
"01375",2017,0,0,27,27
"01375",2018,0,0,14,14
"01375",2019,0,0,27,27
"01375",2020,0,0,78,78
"01376",2015,0,43,0,43
"01376",2017,0,115,27,142
"01376",2018,0,117,14,131
"01376",2019,0,41,27,68
"01376",2020,0,0,78,78
"01378",2017,0,53,27,80
"01378",2018,0,117,14,131
"01378",2019,0,231,27,258
"01378",2020,0,104,78,182
"01379",2017,0,53,27,80
"01379",2018,0,117,14,131
"01379",2019,0,231,27,258
"01379",2020,0,104,78,182
"01380",2017,0,0,27,27
"01380",2018,0,0,14,14
"01380",2019,0,0,27,27
"01380",2020,0,0,14,14
"01381",2015,0,43,0,43
"01381",2017,0,115,27,142
"01381",2018,0,117,14,131
"01381",2019,0,41,27,68
"01381",2020,0,0,78,78
"01382",2015,0,43,0,43
"01382",2017,0,115,27,142
"01382",2018,0,117,14,131
"01382",2019,0,41,27,68
"01382",2020,0,0,78,78
"01383",2015,0,43,0,43
"01383",2017,0,115,27,142
"01383",2018,0,117,14,131
"01383",2019,0,41,27,68
"01383",2020,0,0,78,78
"01384",2015,0,0,43,43
"01384",2017,0,53,62,115
"01384",2018,0,117,59,176
"01384",2019,0,231,115,346
"01384",2020,0,104,0,104
"01385",2015,0,43,0,43
"01385",2017,0,115,27,142
"01385",2018,0,117,14,131
"01385",2019,0,41,27,68
"01385",2020,0,0,78,78
"01386",2015,0,0,43,43
"01386",2017,0,53,62,115
"01386",2018,0,117,59,176
"01386",2019,0,231,115,346
"01386",2020,0,104,0,104
"01387",2017,0,0,27,27
"01387",2018,0,0,14,14
"01387",2019,0,0,27,27
"01387",2020,0,0,14,14
"01388",2017,0,0,27,27
"01388",2018,0,0,14,14
"01388",2019,0,0,27,27
"01388",2020,0,0,14,14
"01389",2015,0,43,0,43
"01389",2017,0,115,27,142
"01389",2018,0,117,14,131
"01389",2019,0,41,27,68
"01389",2020,0,0,78,78
"01390",2017,0,53,27,80
"01390",2018,0,117,14,131
"01390",2019,0,231,27,258
"01390",2020,0,104,78,182
"01391",2017,0,0,27,27
"01391",2018,0,0,14,14
"01391",2019,0,0,27,27
"01391",2020,0,0,14,14
"01392",2015,0,0,43,43
"01392",2017,0,0,62,62
"01392",2018,0,0,59,59
"01392",2019,0,0,115,115
"01393",2015,0,43,0,43
"01393",2017,0,115,27,142
"01393",2018,0,117,14,131
"01393",2019,0,41,27,68
"01393",2020,0,0,78,78
"01396",2015,0,0,43,43
"01396",2017,0,0,62,62
"01396",2018,0,0,59,59
"01396",2019,0,0,115,115
"01397",2015,0,43,6,49
"01397",2017,0,53,0,53
"01397",2018,0,117,14,131
"01397",2019,0,231,27,258
"01397",2020,0,0,14,14
"01398",2015,0,43,0,43
"01398",2017,0,115,27,142
"01398",2018,0,117,14,131
"01398",2019,0,41,27,68
"01398",2020,0,0,78,78
"01399",2015,0,43,6,49
"01399",2017,0,53,0,53
"01399",2018,0,117,14,131
"01399",2019,0,231,27,258
"01399",2020,0,0,14,14
"01400",2015,0,0,43,43
"01400",2017,0,0,62,62
"01400",2018,0,0,59,59
"01400",2019,0,0,115,115
"01401",2015,0,43,6,49
"01401",2017,0,53,0,53
"01401",2018,0,117,14,131
"01401",2019,0,231,27,258
"01401",2020,0,0,14,14
"01402",2017,0,0,27,27
"01402",2018,0,0,14,14
"01402",2019,0,0,27,27
"01402",2020,0,0,14,14
"01403",2015,0,0,43,43
"01403",2017,0,0,62,62
"01403",2018,0,0,59,59
"01403",2019,0,0,115,115
"01404",2015,0,0,43,43
"01404",2017,0,0,62,62
"01404",2018,0,0,59,59
"01404",2019,0,0,115,115
"01405",2015,0,43,0,43
"01405",2017,0,115,27,142
"01405",2018,0,117,14,131
"01405",2019,0,41,27,68
"01405",2020,0,0,78,78
"01406",2017,0,0,27,27
"01406",2018,0,0,14,14
"01406",2019,0,0,27,27
"01406",2020,0,0,14,14
"01407",2015,0,0,6,6
"01407",2018,0,0,14,14
"01407",2019,0,0,27,27
"01407",2020,0,0,14,14
"01408",2017,0,0,27,27
"01408",2018,0,0,14,14
"01408",2019,0,0,27,27
"01408",2020,0,0,14,14
"01410",2015,0,0,43,43
"01410",2017,0,0,62,62
"01410",2018,0,0,59,59
"01410",2019,0,0,115,115
"01411",2015,0,0,43,43
"01411",2017,0,0,62,62
"01411",2018,0,0,59,59
"01411",2019,0,0,115,115
"01412",2015,0,43,0,43
"01412",2017,0,115,27,142
"01412",2018,0,117,14,131
"01412",2019,0,41,27,68
"01412",2020,0,0,78,78
"01415",2015,0,0,6,6
"01415",2018,0,0,14,14
"01415",2019,0,0,27,27
"01415",2020,0,0,14,14
"01416",2015,0,0,43,43
"01416",2017,0,0,62,62
"01416",2018,0,0,59,59
"01416",2019,0,0,115,115
"01418",2017,0,53,27,80
"01418",2018,0,117,14,131
"01418",2019,0,41,27,68
"01418",2020,0,0,78,78
"01419",2015,0,43,6,49
"01419",2017,0,53,0,53
"01419",2018,0,117,14,131
"01419",2019,0,231,27,258
"01419",2020,0,0,14,14
"01420",2017,0,0,27,27
"01420",2018,0,0,14,14
"01420",2019,0,0,27,27
"01420",2020,0,0,78,78
"01421",2015,0,0,43,43
"01421",2017,0,53,62,115
"01421",2018,0,117,59,176
"01421",2019,0,231,115,346
"01421",2020,0,104,0,104
"01422",2015,0,43,0,43
"01422",2017,0,115,27,142
"01422",2018,0,117,14,131
"01422",2019,0,41,27,68
"01422",2020,0,0,14,14
"01423",2015,0,43,0,43
"01423",2017,0,115,27,142
"01423",2018,0,117,14,131
"01423",2019,0,41,27,68
"01423",2020,0,0,78,78
"01424",2015,0,43,0,43
"01424",2017,0,115,27,142
"01424",2018,0,117,14,131
"01424",2019,0,41,27,68
"01424",2020,0,0,78,78
"01425",2015,0,43,0,43
"01425",2017,0,115,27,142
"01425",2018,0,117,14,131
"01425",2019,0,41,27,68
"01425",2020,0,0,78,78
"01426",2017,0,0,27,27
"01426",2018,0,0,14,14
"01426",2019,0,0,27,27
"01426",2020,0,0,14,14
"01427",2015,0,43,0,43
"01427",2017,0,115,27,142
"01427",2018,0,117,14,131
"01427",2019,0,41,27,68
"01427",2020,0,0,78,78
"01428",2015,0,43,0,43
"01428",2017,0,115,27,142
"01428",2018,0,117,14,131
"01428",2019,0,41,27,68
"01428",2020,0,0,78,78
"01429",2015,0,43,0,43
"01429",2017,0,115,27,142
"01429",2018,0,117,14,131
"01429",2019,0,41,27,68
"01429",2020,0,0,78,78
"01430",2017,0,53,27,80
"01430",2018,0,117,14,131
"01430",2019,0,41,27,68
"01430",2020,0,0,78,78
"01431",2015,0,0,43,43
"01431",2017,0,53,62,115
"01431",2018,0,117,59,176
"01431",2019,0,231,115,346
"01431",2020,0,104,0,104
"01432",2017,0,0,27,27
"01432",2018,0,0,14,14
"01432",2019,0,0,27,27
"01432",2020,0,0,14,14
"01433",2017,0,0,27,27
"01433",2018,0,0,14,14
"01433",2019,0,0,27,27
"01433",2020,0,0,14,14
"01434",2015,0,43,0,43
"01434",2017,0,115,27,142
"01434",2018,0,117,14,131
"01434",2019,0,41,27,68
"01434",2020,0,0,78,78
"01435",2015,0,43,6,49
"01435",2017,0,53,0,53
"01435",2018,0,117,14,131
"01435",2019,0,231,27,258
"01435",2020,0,0,14,14
"01436",2015,0,43,6,49
"01436",2017,0,53,0,53
"01436",2018,0,117,14,131
"01436",2019,0,231,27,258
"01436",2020,0,0,14,14
"01437",2017,0,0,27,27
"01437",2018,0,0,14,14
"01437",2019,0,0,27,27
"01437",2020,0,0,14,14
"01439",2017,0,0,27,27
"01439",2018,0,0,14,14
"01439",2019,0,0,27,27
"01439",2020,0,0,14,14
"01441",2015,0,0,43,43
"01441",2017,0,0,62,62
"01441",2018,0,0,59,59
"01441",2019,0,0,115,115
"01443",2015,0,43,0,43
"01443",2017,0,115,27,142
"01443",2018,0,117,14,131
"01443",2019,0,41,27,68
"01443",2020,0,0,78,78
"01444",2015,0,0,43,43
"01444",2017,0,0,62,62
"01444",2018,0,0,59,59
"01444",2019,0,0,115,115
"01445",2017,0,0,27,27
"01445",2018,0,0,14,14
"01445",2019,0,0,27,27
"01445",2020,0,0,14,14
"01446",2015,0,43,0,43
"01446",2017,0,115,27,142
"01446",2018,0,117,14,131
"01446",2019,0,41,27,68
"01446",2020,0,0,78,78
"01447",2015,0,0,43,43
"01447",2017,0,0,62,62
"01447",2018,0,0,59,59
"01447",2019,0,0,115,115
"01448",2015,0,0,6,6
"01448",2018,0,0,14,14
"01448",2019,0,0,27,27
"01448",2020,0,0,14,14
"01449",2017,0,53,27,80
"01449",2018,0,117,14,131
"01449",2019,0,41,27,68
"01449",2020,0,0,78,78
"01450",2017,0,53,27,80
"01450",2018,0,117,14,131
"01450",2019,0,41,27,68
"01450",2020,0,0,78,78
"01451",2015,0,43,0,43
"01451",2017,0,115,27,142
"01451",2018,0,117,14,131
"01451",2019,0,41,27,68
"01451",2020,0,0,78,78
"01452",2015,0,0,6,6
"01452",2018,0,0,14,14
"01452",2019,0,0,27,27
"01452",2020,0,0,14,14
"01453",2015,0,0,6,6
"01453",2018,0,0,14,14
"01453",2019,0,0,27,27
"01453",2020,0,0,14,14
"01454",2015,0,0,6,6
"01454",2018,0,0,14,14
"01454",2019,0,0,27,27
"01454",2020,0,0,14,14
"01456",2015,0,0,6,6
"01456",2018,0,0,14,14
"01456",2019,0,0,27,27
"01456",2020,0,0,14,14
"01457",2015,0,43,0,43
"01457",2017,0,115,27,142
"01457",2018,0,117,14,131
"01457",2019,0,41,27,68
"01457",2020,0,0,78,78
"02002",2020,0,0,37,37
"02003",2019,0,0,36,36
"02003",2020,0,0,37,37
"02004",2020,0,0,37,37
"02005",2019,0,0,36,36
"02005",2020,0,0,37,37
"02007",2019,0,0,36,36
"02007",2020,0,0,37,37
"02008",2019,0,0,36,36
"02008",2020,0,0,37,37
"02010",2019,0,0,36,36
"02010",2020,0,0,37,37
"02011",2019,0,0,36,36
"02011",2020,0,0,37,37
"02012",2019,0,0,36,36
"02012",2020,0,0,37,37
"02013",2019,0,0,36,36
"02013",2020,0,0,37,37
"02015",2018,0,0,158,158
"02015",2020,0,0,31,31
"02016",2020,0,0,37,37
"02017",2020,0,0,37,37
"02021",2020,0,0,37,37
"02022",2018,0,0,158,158
"02022",2020,0,0,31,31
"02023",2018,0,0,158,158
"02023",2020,0,0,31,31
"02024",2019,0,0,36,36
"02024",2020,0,0,37,37
"02027",2020,0,0,37,37
"02028",2020,0,0,37,37
"02031",2020,0,0,37,37
"02033",2019,0,0,36,36
"02033",2020,0,0,37,37
"02034",2019,0,0,36,36
"02034",2020,0,0,37,37
"02035",2020,0,0,37,37
"02036",2019,0,0,36,36
"02036",2020,0,0,37,37
"02037",2020,0,0,37,37
"02038",2020,0,0,37,37
"02039",2020,0,0,37,37
"02042",2017,0,0,167,167
"02043",2019,0,0,36,36
"02043",2020,0,0,37,37
"02044",2020,0,0,37,37
"02046",2020,0,0,37,37
"02047",2020,0,0,37,37
"02048",2020,0,0,37,37
"02051",2017,0,0,167,167
"02053",2017,0,0,167,167
"02054",2019,0,0,36,36
"02054",2020,0,0,37,37
"02055",2020,0,0,37,37
"02058",2019,0,0,36,36
"02058",2020,0,0,37,37
"02062",2018,0,0,158,158
"02062",2020,0,0,31,31
"02064",2019,0,0,36,36
"02064",2020,0,0,37,37
"02068",2020,0,0,37,37
"02069",2019,0,0,36,36
"02069",2020,0,0,37,37
"02071",2019,0,0,36,36
"02071",2020,0,0,37,37
"02072",2019,0,0,36,36
"02072",2020,0,0,37,37
"02073",2019,0,0,36,36
"02073",2020,0,0,37,37
"02074",2020,0,0,37,37
"02076",2019,0,0,36,36
"02076",2020,0,0,37,37
"02079",2020,0,0,37,37
"02080",2020,0,0,37,37
"02082",2018,0,0,158,158
"02082",2020,0,0,31,31
"02083",2017,0,0,167,167
"02083",2018,0,0,158,158
"02083",2020,0,0,31,31
"02084",2017,0,0,167,167
"02084",2018,0,0,158,158
"02084",2020,0,0,31,31
"02085",2017,0,0,167,167
"02085",2018,0,0,158,158
"02085",2020,0,0,31,31
"02087",2019,0,0,36,36
"02087",2020,0,0,37,37
"02089",2019,0,0,36,36
"02089",2020,0,0,37,37
"02090",2018,0,0,158,158
"02090",2020,0,0,31,31
"02091",2019,0,0,36,36
"02091",2020,0,0,37,37
"02093",2019,0,0,36,36
"02093",2020,0,0,37,37
"02094",2017,0,0,167,167
"02096",2020,0,0,37,37
"02097",2020,0,0,37,37
"02098",2017,0,0,167,167
"02099",2018,0,0,158,158
"02099",2020,0,0,31,31
"02101",2020,0,0,37,37
"02102",2019,0,0,36,36
"02102",2020,0,0,37,37
"02104",2019,0,0,36,36
"02104",2020,0,0,37,37
"02105",2017,0,0,167,167
"02105",2018,0,0,158,158
"02105",2020,0,0,31,31
"02106",2019,0,0,36,36
"02106",2020,0,0,37,37
"02109",2020,0,0,37,37
"02110",2019,0,0,36,36
"02110",2020,0,0,37,37
"02114",2017,0,0,167,167
"02115",2019,0,0,36,36
"02115",2020,0,0,37,37
"02116",2020,0,0,37,37
"02118",2019,0,0,36,36
"02118",2020,0,0,37,37
"02119",2018,0,0,158,158
"02119",2020,0,0,31,31
"02120",2019,0,0,36,36
"02120",2020,0,0,37,37
"02121",2018,0,0,158,158
"02121",2020,0,0,31,31
"02122",2020,0,0,37,37
"02123",2020,0,0,37,37
"02124",2020,0,0,37,37
"02125",2018,0,0,158,158
"02125",2020,0,0,31,31
"02126",2020,0,0,37,37
"02127",2018,0,0,158,158
"02127",2020,0,0,31,31
"02128",2020,0,0,37,37
"02129",2019,0,0,36,36
"02129",2020,0,0,37,37
"02130",2020,0,0,37,37
"02131",2019,0,0,36,36
"02131",2020,0,0,37,37
"02132",2020,0,0,37,37
"02133",2020,0,0,37,37
"02136",2020,0,0,37,37
"02137",2018,0,0,158,158
"02137",2020,0,0,31,31
"02138",2019,0,0,36,36
"02138",2020,0,0,37,37
"02146",2017,0,0,167,167
"02148",2019,0,0,36,36
"02148",2020,0,0,37,37
"02150",2019,0,0,36,36
"02150",2020,0,0,37,37
"02151",2020,0,0,37,37
"02152",2019,0,0,36,36
"02152",2020,0,0,37,37
"02154",2019,0,0,36,36
"02154",2020,0,0,37,37
"02156",2020,0,0,37,37
"02157",2020,0,0,37,37
"02160",2020,0,0,37,37
"02162",2017,0,0,167,167
"02163",2017,0,0,167,167
"02164",2017,0,0,167,167
"02164",2018,0,0,158,158
"02164",2020,0,0,31,31
"02165",2020,0,0,37,37
"02166",2017,0,0,167,167
"02166",2018,0,0,158,158
"02166",2020,0,0,31,31
"02167",2019,0,0,36,36
"02167",2020,0,0,37,37
"02168",2017,0,0,167,167
"02168",2018,0,0,158,158
"02168",2020,0,0,31,31
"02169",2020,0,0,37,37
"02171",2019,0,0,36,36
"02171",2020,0,0,37,37
"02172",2018,0,0,158,158
"02172",2020,0,0,31,31
"02174",2019,0,0,36,36
"02174",2020,0,0,37,37
"02175",2019,0,0,36,36
"02175",2020,0,0,37,37
"02176",2019,0,0,36,36
"02176",2020,0,0,37,37
"02178",2019,0,0,36,36
"02178",2020,0,0,37,37
"02179",2019,0,0,36,36
"02179",2020,0,0,37,37
"02180",2020,0,0,37,37
"02181",2020,0,0,37,37
"02182",2020,0,0,37,37
"02183",2019,0,0,36,36
"02183",2020,0,0,37,37
"02184",2020,0,0,37,37
"02185",2018,0,0,158,158
"02185",2020,0,0,31,31
"02186",2017,0,0,167,167
"02187",2017,0,0,167,167
"02189",2020,0,0,37,37
"02190",2019,0,0,36,36
"02190",2020,0,0,37,37
"02191",2020,0,0,37,37
"02192",2018,0,0,158,158
"02192",2020,0,0,31,31
"02193",2017,0,0,167,167
"02193",2018,0,0,158,158
"02193",2020,0,0,31,31
"02194",2020,0,0,37,37
"02195",2019,0,0,36,36
"02195",2020,0,0,37,37
"02196",2020,0,0,37,37
"02198",2019,0,0,36,36
"02198",2020,0,0,37,37
"02200",2020,0,0,37,37
"02201",2019,0,0,36,36
"02201",2020,0,0,37,37
"02203",2018,0,0,158,158
"02203",2020,0,0,31,31
"02204",2020,0,0,37,37
"02205",2019,0,0,36,36
"02205",2020,0,0,37,37
"02206",2020,0,0,37,37
"02208",2019,0,0,36,36
"02208",2020,0,0,37,37
"02209",2017,0,0,167,167
"02210",2019,0,0,36,36
"02210",2020,0,0,37,37
"02211",2019,0,0,36,36
"02211",2020,0,0,37,37
"02213",2017,0,0,167,167
"02215",2019,0,0,36,36
"02215",2020,0,0,37,37
"02216",2018,0,0,158,158
"02216",2020,0,0,31,31
"02218",2020,0,0,37,37
"02220",2017,0,0,167,167
"02220",2018,0,0,158,158
"02220",2020,0,0,31,31
"02221",2017,0,0,167,167
"02221",2018,0,0,158,158
"02221",2020,0,0,31,31
"02222",2020,0,0,37,37
"02223",2017,0,0,167,167
"02224",2019,0,0,36,36
"02224",2020,0,0,37,37
"02225",2018,0,0,158,158
"02225",2020,0,0,31,31
"02226",2019,0,0,36,36
"02226",2020,0,0,37,37
"02227",2017,0,0,167,167
"02227",2018,0,0,158,158
"02227",2020,0,0,31,31
"02228",2017,0,0,167,167
"02229",2019,0,0,36,36
"02229",2020,0,0,37,37
"02230",2019,0,0,36,36
"02230",2020,0,0,37,37
"02231",2020,0,0,37,37
"02232",2018,0,0,158,158
"02232",2020,0,0,32,32
"02233",2018,0,0,158,158
"02233",2020,0,0,31,31
"02234",2019,0,0,36,36
"02234",2020,0,0,37,37
"02235",2019,0,0,36,36
"02235",2020,0,0,37,37
"02236",2019,0,0,36,36
"02236",2020,0,0,37,37
"02237",2020,0,0,37,37
"02238",2020,0,0,37,37
"02239",2017,0,0,167,167
"02241",2018,0,0,158,158
"02241",2020,0,0,31,31
"02242",2017,0,0,167,167
"02243",2019,0,0,36,36
"02243",2020,0,0,37,37
"02245",2019,0,0,36,36
"02245",2020,0,0,37,37
"02248",2020,0,0,37,37
"02249",2019,0,0,36,36
"02249",2020,0,0,37,37
"02250",2019,0,0,36,36
"02250",2020,0,0,37,37
"02251",2020,0,0,37,37
"02252",2019,0,0,36,36
"02252",2020,0,0,37,37
"02253",2019,0,0,36,36
"02253",2020,0,0,37,37
"02254",2019,0,0,36,36
"02254",2020,0,0,37,37
"02255",2019,0,0,36,36
"02255",2020,0,0,37,37
"02256",2020,0,0,37,37
"02258",2018,0,0,158,158
"02258",2020,0,0,31,31
"02259",2018,0,0,158,158
"02259",2020,0,0,32,32
"02260",2020,0,0,37,37
"02261",2020,0,0,37,37
"02262",2020,0,0,37,37
"02263",2019,0,0,36,36
"02263",2020,0,0,37,37
"02264",2019,0,0,36,36
"02264",2020,0,0,37,37
"02265",2020,0,0,37,37
"02266",2020,0,0,37,37
"02267",2018,0,0,158,158
"02267",2020,0,0,31,31
"02268",2017,0,0,167,167
"02271",2019,0,0,36,36
"02271",2020,0,0,37,37
"02272",2019,0,0,36,36
"02272",2020,0,0,37,37
"02274",2020,0,0,37,37
"02277",2019,0,0,36,36
"02277",2020,0,0,37,37
"02279",2017,0,0,167,167
"02279",2018,0,0,158,158
"02279",2020,0,0,31,31
"02280",2017,0,0,167,167
"02280",2018,0,0,158,158
"02280",2020,0,0,31,31
"02281",2017,0,0,167,167
"02282",2020,0,0,37,37
"02283",2020,0,0,37,37
"02289",2017,0,0,167,167
"02290",2017,0,0,167,167
"02290",2018,0,0,158,158
"02290",2020,0,0,31,31
"02292",2017,0,0,167,167
"02295",2020,0,0,37,37
"02297",2017,0,0,167,167
"02297",2018,0,0,158,158
"02297",2020,0,0,31,31
"02299",2019,0,0,36,36
"02299",2020,0,0,37,37
"02302",2018,0,0,158,158
"02302",2020,0,0,31,31
"02305",2017,0,0,167,167
"02305",2018,0,0,158,158
"02305",2020,0,0,31,31
"02306",2020,0,0,37,37
"02307",2018,0,0,158,158
"02307",2020,0,0,32,32
"02309",2020,0,0,37,37
"02311",2019,0,0,36,36
"02311",2020,0,0,37,37
"02313",2020,0,0,37,37
"02316",2018,0,0,158,158
"02316",2020,0,0,32,32
"02321",2020,0,0,37,37
"02326",2019,0,0,36,36
"02326",2020,0,0,37,37
"02328",2017,0,0,167,167
"02329",2020,0,0,37,37
"02331",2020,0,0,37,37
"02332",2017,0,0,167,167
"02332",2018,0,0,158,158
"02332",2020,0,0,31,31
"02335",2020,0,0,37,37
"02338",2020,0,0,37,37
"02339",2018,0,0,158,158
"02339",2020,0,0,31,31
"02341",2020,0,0,37,37
"02346",2020,0,0,37,37
"02347",2017,0,0,167,167
"02349",2019,0,0,36,36
"02349",2020,0,0,37,37
"02350",2020,0,0,37,37
"02351",2017,0,0,167,167
"02351",2019,0,0,36,36
"02351",2020,0,0,37,37
"02353",2020,0,0,37,37
"02354",2020,0,0,37,37
"02356",2018,0,0,158,158
"02356",2020,0,0,31,31
"02357",2020,0,0,37,37
"02360",2019,0,0,36,36
"02360",2020,0,0,37,37
"02363",2019,0,0,36,36
"02363",2020,0,0,37,37
"02364",2019,0,0,36,36
"02364",2020,0,0,37,37
"02368",2018,0,0,158,158
"02368",2020,0,0,32,32
"02369",2020,0,0,37,37
"02372",2018,0,0,158,158
"02372",2020,0,0,31,31
"02373",2020,0,0,37,37
"02375",2018,0,0,158,158
"02375",2020,0,0,31,31
"02377",2020,0,0,37,37
"02379",2020,0,0,37,37
"02384",2020,0,0,37,37
"02385",2020,0,0,37,37
"02388",2020,0,0,37,37
"02389",2017,0,0,167,167
"02391",2020,0,0,37,37
"02393",2019,0,0,36,36
"02393",2020,0,0,37,37
"02396",2019,0,0,36,36
"02396",2020,0,0,37,37
"02398",2019,0,0,36,36
"02398",2020,0,0,37,37
"02399",2019,0,0,36,36
"02399",2020,0,0,37,37
"02400",2019,0,0,36,36
"02400",2020,0,0,37,37
"02401",2020,0,0,37,37
"02403",2020,0,0,37,37
"02404",2020,0,0,37,37
"02405",2020,0,0,37,37
"02408",2020,0,0,37,37
"02409",2019,0,0,36,36
"02409",2020,0,0,37,37
"02410",2018,0,0,158,158
"02410",2020,0,0,32,32
"02411",2018,0,0,158,158
"02411",2020,0,0,31,31
"02412",2018,0,0,158,158
"02412",2020,0,0,31,31
"02415",2019,0,0,36,36
"02415",2020,0,0,37,37
"02416",2020,0,0,37,37
"02421",2019,0,0,36,36
"02421",2020,0,0,37,37
"02423",2019,0,0,36,36
"02423",2020,0,0,37,37
"02424",2019,0,0,36,36
"02424",2020,0,0,37,37
"02427",2019,0,0,36,36
"02427",2020,0,0,37,37
"02428",2018,0,0,158,158
"02428",2020,0,0,31,31
"02430",2020,0,0,37,37
"02432",2019,0,0,36,36
"02432",2020,0,0,37,37
"02433",2020,0,0,37,37
"02438",2018,0,0,158,158
"02438",2020,0,0,31,31
"02439",2019,0,0,36,36
"02439",2020,0,0,37,37
"02440",2019,0,0,36,36
"02440",2020,0,0,37,37
"02441",2018,0,0,158,158
"02441",2020,0,0,31,31
"02442",2018,0,0,158,158
"02442",2020,0,0,31,31
"02443",2017,0,0,167,167
"02443",2018,0,0,158,158
"02443",2020,0,0,31,31
"02444",2020,0,0,37,37
"02447",2019,0,0,36,36
"02447",2020,0,0,37,37
"02448",2020,0,0,37,37
"02449",2018,0,0,158,158
"02449",2020,0,0,31,31
"02450",2020,0,0,37,37
"02453",2019,0,0,36,36
"02453",2020,0,0,37,37
"02454",2019,0,0,36,36
"02454",2020,0,0,37,37
"02457",2020,0,0,37,37
"02458",2017,0,0,167,167
"02460",2020,0,0,37,37
"02462",2018,0,0,158,158
"02462",2020,0,0,31,31
"02463",2020,0,0,37,37
"02464",2019,0,0,36,36
"02464",2020,0,0,37,37
"02465",2017,0,0,167,167
"02465",2018,0,0,158,158
"02465",2020,0,0,31,31
"02466",2018,0,0,158,158
"02466",2020,0,0,31,31
"02467",2018,0,0,158,158
"02467",2020,0,0,31,31
"02468",2020,0,0,37,37
"02472",2020,0,0,37,37
"02473",2020,0,0,37,37
"02477",2019,0,0,36,36
"02477",2020,0,0,37,37
"02480",2020,0,0,37,37
"02482",2019,0,0,36,36
"02482",2020,0,0,37,37
"02484",2017,0,0,167,167
"02485",2018,0,0,158,158
"02485",2020,0,0,31,31
"02486",2020,0,0,37,37
"02487",2019,0,0,36,36
"02487",2020,0,0,37,37
"02489",2020,0,0,37,37
"02491",2020,0,0,37,37
"02492",2020,0,0,37,37
"02493",2020,0,0,37,37
"02496",2018,0,0,158,158
"02496",2020,0,0,31,31
"02498",2020,0,0,37,37
"02501",2020,0,0,37,37
"02502",2020,0,0,37,37
"02505",2017,0,0,167,167
"02506",2018,0,0,158,158
"02506",2020,0,0,31,31
"02507",2018,0,0,158,158
"02507",2020,0,0,31,31
"02509",2018,0,0,158,158
"02509",2020,0,0,31,31
"02510",2017,0,0,167,167
"02512",2018,0,0,158,158
"02512",2020,0,0,31,31
"02513",2020,0,0,37,37
"02514",2019,0,0,36,36
"02514",2020,0,0,37,37
"02515",2017,0,0,167,167
"02516",2020,0,0,37,37
"02517",2020,0,0,37,37
"02518",2017,0,0,167,167
"02519",2019,0,0,36,36
"02519",2020,0,0,37,37
"02520",2019,0,0,36,36
"02520",2020,0,0,37,37
"02521",2017,0,0,167,167
"02521",2018,0,0,158,158
"02521",2020,0,0,31,31
"02522",2020,0,0,37,37
"02523",2019,0,0,36,36
"02523",2020,0,0,37,37
"02524",2017,0,0,167,167
"02524",2018,0,0,158,158
"02524",2020,0,0,31,31
"02526",2020,0,0,37,37
"02527",2019,0,0,36,36
"02527",2020,0,0,37,37
"02528",2019,0,0,36,36
"02528",2020,0,0,37,37
"02529",2020,0,0,37,37
"02530",2019,0,0,36,36
"02530",2020,0,0,37,37
"02531",2019,0,0,36,36
"02531",2020,0,0,37,37
"02533",2019,0,0,36,36
"02533",2020,0,0,37,37
"02534",2019,0,0,36,36
"02534",2020,0,0,37,37
"02535",2020,0,0,37,37
"02536",2019,0,0,36,36
"02536",2020,0,0,37,37
"02537",2019,0,0,36,36
"02537",2020,0,0,37,37
"02538",2018,0,0,158,158
"02538",2020,0,0,31,31
"02540",2017,0,0,167,167
"02541",2019,0,0,36,36
"02541",2020,0,0,37,37
"02543",2018,0,0,158,158
"02543",2020,0,0,31,31
"02545",2020,0,0,37,37
"02547",2020,0,0,37,37
"02551",2019,0,0,36,36
"02551",2020,0,0,37,37
"02553",2019,0,0,36,36
"02553",2020,0,0,37,37
"02554",2017,0,0,167,167
"02555",2017,0,0,167,167
"02556",2019,0,0,36,36
"02556",2020,0,0,37,37
"02557",2018,0,0,158,158
"02557",2020,0,0,31,31
"02559",2020,0,0,37,37
"02560",2020,0,0,37,37
"02562",2019,0,0,36,36
"02562",2020,0,0,37,37
"02564",2018,0,0,158,158
"02564",2020,0,0,31,31
"02565",2019,0,0,36,36
"02565",2020,0,0,37,37
"02568",2018,0,0,158,158
"02568",2020,0,0,32,32
"02572",2019,0,0,36,36
"02572",2020,0,0,37,37
"02574",2020,0,0,37,37
"02575",2020,0,0,37,37
"02576",2019,0,0,36,36
"02576",2020,0,0,37,37
"02577",2019,0,0,36,36
"02577",2020,0,0,37,37
"02578",2019,0,0,36,36
"02578",2020,0,0,37,37
"02579",2018,0,0,158,158
"02579",2020,0,0,31,31
"02580",2018,0,0,158,158
"02580",2020,0,0,31,31
"02581",2019,0,0,36,36
"02581",2020,0,0,37,37
"02582",2019,0,0,36,36
"02582",2020,0,0,37,37
"02583",2019,0,0,36,36
"02583",2020,0,0,37,37
"02585",2018,0,0,158,158
"02585",2020,0,0,31,31
"02586",2020,0,0,37,37
"02587",2020,0,0,37,37
"02588",2019,0,0,36,36
"02588",2020,0,0,37,37
"02589",2019,0,0,36,36
"02589",2020,0,0,37,37
"02590",2017,0,0,167,167
"02591",2020,0,0,37,37
"02592",2020,0,0,37,37
"02593",2019,0,0,36,36
"02593",2020,0,0,37,37
"02594",2018,0,0,158,158
"02594",2020,0,0,31,31
"02595",2017,0,0,167,167
"02596",2017,0,0,167,167
"02598",2019,0,0,36,36
"02598",2020,0,0,37,37
"02600",2020,0,0,37,37
"02601",2019,0,0,36,36
"02601",2020,0,0,37,37
"02605",2020,0,0,37,37
"02606",2018,0,0,158,158
"02606",2020,0,0,31,31
"02607",2018,0,0,158,158
"02607",2020,0,0,31,31
"02608",2020,0,0,37,37
"02610",2019,0,0,36,36
"02610",2020,0,0,37,37
"02612",2019,0,0,36,36
"02612",2020,0,0,37,37
"02613",2019,0,0,36,36
"02613",2020,0,0,37,37
"02616",2019,0,0,36,36
"02616",2020,0,0,37,37
"02617",2020,0,0,37,37
"02620",2019,0,0,36,36
"02620",2020,0,0,37,37
"02621",2020,0,0,37,37
"02622",2018,0,0,158,158
"02622",2020,0,0,31,31
"02623",2020,0,0,37,37
"02626",2019,0,0,36,36
"02626",2020,0,0,37,37
"02627",2019,0,0,36,36
"02627",2020,0,0,37,37
"02628",2018,0,0,158,158
"02628",2020,0,0,32,32
"02629",2020,0,0,37,37
"02633",2019,0,0,36,36
"02633",2020,0,0,37,37
"02634",2020,0,0,37,37
"02638",2020,0,0,37,37
"02640",2020,0,0,37,37
"02641",2020,0,0,37,37
"02642",2020,0,0,37,37
"02643",2019,0,0,36,36
"02643",2020,0,0,37,37
"02644",2018,0,0,158,158
"02644",2020,0,0,32,32
"02645",2017,0,0,167,167
"02648",2020,0,0,37,37
"02649",2018,0,0,158,158
"02649",2020,0,0,31,31
"02651",2020,0,0,37,37
"02652",2020,0,0,37,37
"02653",2017,0,0,167,167
"02655",2017,0,0,167,167
"02655",2018,0,0,158,158
"02655",2020,0,0,31,31
"02656",2019,0,0,36,36
"02656",2020,0,0,37,37
"02657",2020,0,0,37,37
"02660",2020,0,0,37,37
"02662",2018,0,0,158,158
"02662",2020,0,0,31,31
"02663",2019,0,0,36,36
"02663",2020,0,0,37,37
"02664",2017,0,0,167,167
"02665",2018,0,0,158,158
"02665",2020,0,0,31,31
"02666",2020,0,0,37,37
"02667",2019,0,0,36,36
"02667",2020,0,0,37,37
"02668",2020,0,0,37,37
"02672",2019,0,0,36,36
"02672",2020,0,0,37,37
"02673",2019,0,0,36,36
"02673",2020,0,0,37,37
"02674",2020,0,0,37,37
"02675",2019,0,0,36,36
"02675",2020,0,0,37,37
"02676",2019,0,0,36,36
"02676",2020,0,0,37,37
"02677",2017,0,0,167,167
"02678",2020,0,0,37,37
"02679",2018,0,0,158,158
"02679",2020,0,0,31,31
"02680",2020,0,0,37,37
"02681",2020,0,0,37,37
"02682",2019,0,0,36,36
"02682",2020,0,0,37,37
"02685",2020,0,0,37,37
"02687",2018,0,0,158,158
"02687",2020,0,0,31,31
"02688",2020,0,0,37,37
"02689",2020,0,0,37,37
"02690",2020,0,0,37,37
"02693",2018,0,0,158,158
"02693",2020,0,0,31,31
"02696",2019,0,0,36,36
"02696",2020,0,0,37,37
"02697",2020,0,0,37,37
"02698",2019,0,0,36,36
"02698",2020,0,0,37,37
"02699",2018,0,0,158,158
"02699",2020,0,0,31,31
"02701",2017,0,0,167,167
"02704",2019,0,0,36,36
"02704",2020,0,0,37,37
"02705",2019,0,0,36,36
"02705",2020,0,0,37,37
"02706",2019,0,0,36,36
"02706",2020,0,0,37,37
"02711",2019,0,0,36,36
"02711",2020,0,0,37,37
"02712",2018,0,0,158,158
"02712",2020,0,0,31,31
"02713",2018,0,0,158,158
"02713",2020,0,0,31,31
"02714",2019,0,0,36,36
"02714",2020,0,0,37,37
"02715",2019,0,0,36,36
"02715",2020,0,0,37,37
"02717",2020,0,0,37,37
"02718",2018,0,0,158,158
"02718",2020,0,0,31,31
"02720",2019,0,0,36,36
"02720",2020,0,0,37,37
"02722",2019,0,0,36,36
"02722",2020,0,0,37,37
"02723",2020,0,0,37,37
"02724",2018,0,0,158,158
"02724",2020,0,0,31,31
"02727",2020,0,0,37,37
"02728",2020,0,0,37,37
"02729",2019,0,0,36,36
"02729",2020,0,0,37,37
"02730",2019,0,0,36,36
"02730",2020,0,0,37,37
"02731",2020,0,0,37,37
"02732",2020,0,0,37,37
"02734",2018,0,0,158,158
"02734",2020,0,0,32,32
"02735",2019,0,0,36,36
"02735",2020,0,0,37,37
"02736",2019,0,0,36,36
"02736",2020,0,0,37,37
"02737",2020,0,0,37,37
"02739",2019,0,0,36,36
"02739",2020,0,0,37,37
"02740",2020,0,0,37,37
"02742",2020,0,0,37,37
"02743",2019,0,0,36,36
"02743",2020,0,0,37,37
"02744",2018,0,0,158,158
"02744",2020,0,0,31,31
"02745",2020,0,0,37,37
"02748",2017,0,0,167,167
"02749",2018,0,0,158,158
"02749",2020,0,0,31,31
"02750",2019,0,0,36,36
"02750",2020,0,0,37,37
"02758",2019,0,0,36,36
"02758",2020,0,0,37,37
"02759",2020,0,0,37,37
"02761",2019,0,0,36,36
"02761",2020,0,0,37,37
"02762",2019,0,0,36,36
"02762",2020,0,0,37,37
"02763",2019,0,0,36,36
"02763",2020,0,0,37,37
"02764",2019,0,0,36,36
"02764",2020,0,0,37,37
"02766",2019,0,0,36,36
"02766",2020,0,0,37,37
"02767",2019,0,0,36,36
"02767",2020,0,0,37,37
"02768",2019,0,0,36,36
"02768",2020,0,0,37,37
"02770",2019,0,0,36,36
"02770",2020,0,0,37,37
"02773",2019,0,0,36,36
"02773",2020,0,0,37,37
"02777",2017,0,0,167,167
"02778",2019,0,0,36,36
"02778",2020,0,0,37,37
"02780",2019,0,0,36,36
"02780",2020,0,0,37,37
"02781",2017,0,0,167,167
"02781",2018,0,0,158,158
"02781",2020,0,0,31,31
"02787",2020,0,0,37,37
"02788",2020,0,0,37,37
"02789",2020,0,0,37,37
"02790",2020,0,0,37,37
"02791",2020,0,0,37,37
"02792",2018,0,0,158,158
"02792",2020,0,0,31,31
"02793",2019,0,0,36,36
"02793",2020,0,0,37,37
"02794",2017,0,0,167,167
"02794",2019,0,0,36,36
"02794",2020,0,0,37,37
"02795",2019,0,0,36,36
"02795",2020,0,0,37,37
"02796",2018,0,0,158,158
"02796",2020,0,0,31,31
"02797",2019,0,0,36,36
"02797",2020,0,0,37,37
"02798",2017,0,0,167,167
"02799",2018,0,0,158,158
"02799",2020,0,0,31,31
"02800",2017,0,0,167,167
"02801",2020,0,0,37,37
"02802",2020,0,0,37,37
"02803",2019,0,0,36,36
"02803",2020,0,0,37,37
"02804",2018,0,0,158,158
"02804",2020,0,0,31,31
"02805",2019,0,0,36,36
"02805",2020,0,0,37,37
"02806",2018,0,0,158,158
"02806",2020,0,0,31,31
"02809",2017,0,0,167,167
"02809",2019,0,0,36,36
"02809",2020,0,0,37,37
"02810",2018,0,0,158,158
"02810",2020,0,0,32,32
"02812",2018,0,0,158,158
"02812",2020,0,0,31,31
"02813",2020,0,0,37,37
"02816",2018,0,0,158,158
"02816",2020,0,0,31,31
"02817",2019,0,0,36,36
"02817",2020,0,0,37,37
"02818",2017,0,0,167,167
"02819",2020,0,0,37,37
"02821",2020,0,0,37,37
"02822",2018,0,0,158,158
"02822",2020,0,0,32,32
"02823",2020,0,0,37,37
"02824",2020,0,0,37,37
"02826",2020,0,0,37,37
"02827",2020,0,0,37,37
"02828",2019,0,0,36,36
"02828",2020,0,0,37,37
"02829",2019,0,0,36,36
"02829",2020,0,0,37,37
"02832",2020,0,0,37,37
"03001",2015,0,0,45,45
"03001",2016,0,0,77,77
"03001",2017,0,0,22,22
"03001",2018,0,0,42,42
"03001",2019,0,0,17,17
"03001",2020,0,0,62,62
"03002",2015,0,0,45,45
"03002",2016,0,0,77,77
"03002",2017,0,0,22,22
"03002",2018,0,0,85,85
"03002",2019,0,0,110,110
"03002",2020,0,0,89,89
"03003",2015,0,0,45,45
"03003",2017,0,0,22,22
"03003",2018,0,0,42,42
"03003",2019,0,0,17,17
"03003",2020,0,0,26,26
"03004",2015,0,0,45,45
"03004",2016,0,0,77,77
"03004",2017,0,0,22,22
"03004",2018,0,0,58,58
"03004",2019,0,0,17,17
"03004",2020,0,0,26,26
"03005",2015,0,0,45,45
"03005",2017,0,0,22,22
"03005",2018,0,0,42,42
"03005",2019,0,0,17,17
"03005",2020,0,0,26,26
"03006",2015,0,0,45,45
"03006",2016,0,0,77,77
"03006",2017,0,0,22,22
"03006",2018,0,0,58,58
"03006",2019,0,0,17,17
"03006",2020,0,0,26,26
"03007",2015,0,0,45,45
"03007",2017,0,0,22,22
"03007",2018,0,0,42,42
"03007",2019,0,0,17,17
"03007",2020,0,0,26,26
"03008",2015,0,0,45,45
"03008",2016,0,0,77,77
"03008",2017,0,0,22,22
"03008",2018,0,0,42,42
"03008",2019,0,0,17,17
"03008",2020,0,0,62,62
"03009",2015,0,0,45,45
"03009",2016,0,0,77,77
"03009",2017,0,0,22,22
"03009",2018,0,0,85,85
"03009",2019,0,0,110,110
"03009",2020,0,0,89,89
"03010",2015,0,0,45,45
"03010",2017,0,0,22,22
"03010",2018,0,0,42,42
"03010",2019,0,0,17,17
"03010",2020,0,0,26,26
"03011",2015,0,0,45,45
"03011",2016,0,0,77,77
"03011",2017,0,0,22,22
"03011",2018,0,0,85,85
"03011",2019,0,0,110,110
"03011",2020,0,0,89,89
"03012",2015,0,0,45,45
"03012",2016,0,0,77,77
"03012",2017,0,0,22,22
"03012",2018,0,0,85,85
"03012",2019,0,0,110,110
"03012",2020,0,0,89,89
"03013",2015,0,0,45,45
"03013",2016,0,0,77,77
"03013",2017,0,0,22,22
"03013",2018,0,0,85,85
"03013",2019,0,0,110,110
"03013",2020,0,0,89,89
"03014",2015,0,0,45,45
"03014",2016,0,0,77,77
"03014",2017,0,0,22,22
"03014",2018,0,0,85,85
"03014",2019,0,0,110,110
"03014",2020,0,0,89,89
"03015",2015,0,0,45,45
"03015",2016,0,0,77,77
"03015",2017,0,0,22,22
"03015",2018,0,0,85,85
"03015",2019,0,0,110,110
"03015",2020,0,0,89,89
"03016",2015,0,0,45,45
"03016",2016,0,0,77,77
"03016",2017,0,0,22,22
"03016",2018,0,0,42,42
"03016",2019,0,0,17,17
"03016",2020,0,0,18,18
"03017",2015,0,0,45,45
"03017",2016,0,0,77,77
"03017",2017,0,0,22,22
"03017",2018,0,0,58,58
"03017",2019,0,0,17,17
"03017",2020,0,0,26,26
"03018",2015,0,0,39,39
"03018",2018,0,0,4,4
"03018",2019,0,0,17,17
"03019",2015,0,0,45,45
"03019",2016,0,0,77,77
"03019",2017,0,0,22,22
"03019",2018,0,0,85,85
"03019",2019,0,0,110,110
"03019",2020,0,0,89,89
"03020",2015,0,0,39,39
"03020",2018,0,0,4,4
"03020",2019,0,0,17,17
"03021",2015,0,0,45,45
"03021",2016,0,0,77,77
"03021",2017,0,0,22,22
"03021",2018,0,0,42,42
"03021",2019,0,0,17,17
"03021",2020,0,0,18,18
"03022",2015,0,0,39,39
"03022",2018,0,0,4,4
"03022",2019,0,0,17,17
"03023",2015,0,0,45,45
"03023",2016,0,0,77,77
"03023",2017,0,0,22,22
"03023",2018,0,0,85,85
"03023",2019,0,0,110,110
"03023",2020,0,0,89,89
"03024",2015,0,0,45,45
"03024",2016,0,0,77,77
"03024",2017,0,0,22,22
"03024",2018,0,0,58,58
"03024",2019,0,0,17,17
"03024",2020,0,0,26,26
"03025",2015,0,0,45,45
"03025",2016,0,0,77,77
"03025",2017,0,0,22,22
"03025",2018,0,0,85,85
"03025",2019,0,0,110,110
"03025",2020,0,0,89,89
"03026",2015,0,0,45,45
"03026",2016,0,0,77,77
"03026",2017,0,0,22,22
"03026",2018,0,0,85,85
"03026",2019,0,0,110,110
"03026",2020,0,0,89,89
"03027",2015,0,0,39,39
"03027",2016,0,0,21,21
"03027",2018,0,0,4,4
"03027",2019,0,0,17,17
"03028",2015,0,0,45,45
"03028",2016,0,0,77,77
"03028",2017,0,0,22,22
"03028",2018,0,0,58,58
"03028",2019,0,0,17,17
"03028",2020,0,0,26,26
"03029",2015,0,0,45,45
"03029",2016,0,0,77,77
"03029",2017,0,0,22,22
"03029",2018,0,0,85,85
"03029",2019,0,0,110,110
"03029",2020,0,0,89,89
"03030",2015,0,0,45,45
"03030",2016,0,0,77,77
"03030",2017,0,0,22,22
"03030",2018,0,0,85,85
"03030",2019,0,0,17,17
"03030",2020,0,0,18,18
"03031",2015,0,0,39,39
"03031",2018,0,0,4,4
"03031",2019,0,0,17,17
"03032",2015,0,0,39,39
"03032",2018,0,0,4,4
"03032",2019,0,0,17,17
"03033",2015,0,0,45,45
"03033",2016,0,0,77,77
"03033",2017,0,0,22,22
"03033",2018,0,0,42,42
"03033",2019,0,0,17,17
"03033",2020,0,0,62,62
"03034",2015,0,0,45,45
"03034",2016,0,0,77,77
"03034",2017,0,0,22,22
"03034",2018,0,0,58,58
"03034",2019,0,0,17,17
"03034",2020,0,0,26,26
"03035",2015,0,0,45,45
"03035",2016,0,0,77,77
"03035",2017,0,0,22,22
"03035",2018,0,0,85,85
"03035",2019,0,0,110,110
"03035",2020,0,0,89,89
"03036",2015,0,0,39,39
"03036",2016,0,0,21,21
"03036",2018,0,0,4,4
"03036",2019,0,0,17,17
"03037",2015,0,0,45,45
"03037",2017,0,0,22,22
"03037",2018,0,0,42,42
"03037",2019,0,0,17,17
"03037",2020,0,0,26,26
"03038",2015,0,0,39,39
"03038",2018,0,0,4,4
"03038",2019,0,0,17,17
"03039",2015,0,0,45,45
"03039",2016,0,0,77,77
"03039",2017,0,0,22,22
"03039",2018,0,0,42,42
"03039",2019,0,0,52,52
"03039",2020,0,0,89,89
"03040",2015,0,0,45,45
"03040",2016,0,0,77,77
"03040",2017,0,0,22,22
"03040",2018,0,0,85,85
"03040",2019,0,0,110,110
"03040",2020,0,0,89,89
"03041",2015,0,0,39,39
"03041",2018,0,0,4,4
"03041",2019,0,0,17,17
"03042",2015,0,0,45,45
"03042",2016,0,0,77,77
"03042",2017,0,0,22,22
"03042",2018,0,0,58,58
"03042",2019,0,0,17,17
"03042",2020,0,0,26,26
"03043",2015,0,0,45,45
"03043",2016,0,0,77,77
"03043",2017,0,0,22,22
"03043",2018,0,0,42,42
"03043",2019,0,0,17,17
"03043",2020,0,0,18,18
"03044",2015,0,0,45,45
"03044",2016,0,0,77,77
"03044",2017,0,0,22,22
"03044",2018,0,0,85,85
"03044",2019,0,0,17,17
"03044",2020,0,0,18,18
"03045",2015,0,0,45,45
"03045",2016,0,0,77,77
"03045",2017,0,0,22,22
"03045",2018,0,0,42,42
"03045",2019,0,0,17,17
"03045",2020,0,0,62,62
"03046",2015,0,0,39,39
"03046",2016,0,0,21,21
"03046",2018,0,0,4,4
"03046",2019,0,0,17,17
"03047",2015,0,0,39,39
"03047",2018,0,0,4,4
"03047",2019,0,0,17,17
"03048",2015,0,0,39,39
"03048",2018,0,0,4,4
"03048",2019,0,0,17,17
"03049",2015,0,0,39,39
"03049",2018,0,0,4,4
"03049",2019,0,0,17,17
"03050",2015,0,0,45,45
"03050",2016,0,0,77,77
"03050",2017,0,0,22,22
"03050",2018,0,0,42,42
"03050",2019,0,0,17,17
"03050",2020,0,0,26,26
"03051",2015,0,0,45,45
"03051",2017,0,0,22,22
"03051",2018,0,0,42,42
"03051",2019,0,0,17,17
"03051",2020,0,0,26,26
"03052",2015,0,0,39,39
"03052",2018,0,0,4,4
"03052",2019,0,0,17,17
"03053",2015,0,0,39,39
"03053",2018,0,0,4,4
"03053",2019,0,0,17,17
"03054",2015,0,0,45,45
"03054",2016,0,0,77,77
"03054",2017,0,0,22,22
"03054",2018,0,0,58,58
"03054",2019,0,0,17,17
"03054",2020,0,0,26,26
"03055",2015,0,0,45,45
"03055",2017,0,0,22,22
"03055",2018,0,0,42,42
"03055",2019,0,0,17,17
"03055",2020,0,0,26,26
"03056",2015,0,0,45,45
"03056",2016,0,0,77,77
"03056",2017,0,0,22,22
"03056",2018,0,0,42,42
"03056",2019,0,0,17,17
"03056",2020,0,0,62,62
"03057",2015,0,0,45,45
"03057",2016,0,0,77,77
"03057",2017,0,0,22,22
"03057",2018,0,0,85,85
"03057",2019,0,0,110,110
"03057",2020,0,0,89,89
"03058",2015,0,0,39,39
"03058",2018,0,0,4,4
"03058",2019,0,0,17,17
"03059",2015,0,0,39,39
"03059",2018,0,0,4,4
"03059",2019,0,0,17,17
"03060",2015,0,0,45,45
"03060",2016,0,0,77,77
"03060",2017,0,0,22,22
"03060",2018,0,0,85,85
"03060",2019,0,0,110,110
"03060",2020,0,0,89,89
"03061",2015,0,0,45,45
"03061",2016,0,0,77,77
"03061",2017,0,0,22,22
"03061",2018,0,0,85,85
"03061",2019,0,0,17,17
"03061",2020,0,0,18,18
"03062",2015,0,0,39,39
"03062",2018,0,0,4,4
"03062",2019,0,0,17,17
"03063",2015,0,0,45,45
"03063",2016,0,0,77,77
"03063",2017,0,0,22,22
"03063",2018,0,0,85,85
"03063",2019,0,0,110,110
"03063",2020,0,0,89,89
"03064",2015,0,0,45,45
"03064",2016,0,0,77,77
"03064",2017,0,0,22,22
"03064",2018,0,0,85,85
"03064",2019,0,0,110,110
"03064",2020,0,0,89,89
"03065",2015,0,0,45,45
"03065",2016,0,0,77,77
"03065",2017,0,0,22,22
"03065",2018,0,0,85,85
"03065",2019,0,0,110,110
"03065",2020,0,0,89,89
"03066",2015,0,0,45,45
"03066",2016,0,0,77,77
"03066",2017,0,0,22,22
"03066",2018,0,0,42,42
"03066",2019,0,0,17,17
"03066",2020,0,0,26,26
"03067",2015,0,0,45,45
"03067",2016,0,0,77,77
"03067",2017,0,0,22,22
"03067",2018,0,0,58,58
"03067",2019,0,0,17,17
"03067",2020,0,0,26,26
"03068",2015,0,0,45,45
"03068",2016,0,0,77,77
"03068",2017,0,0,22,22
"03068",2018,0,0,58,58
"03068",2019,0,0,17,17
"03068",2020,0,0,26,26
"03069",2015,0,0,39,39
"03069",2018,0,0,4,4
"03069",2019,0,0,17,17
"03070",2015,0,0,39,39
"03070",2016,0,0,21,21
"03070",2018,0,0,4,4
"03070",2019,0,0,17,17
"03071",2015,0,0,45,45
"03071",2016,0,0,77,77
"03071",2017,0,0,22,22
"03071",2018,0,0,58,58
"03071",2019,0,0,17,17
"03071",2020,0,0,26,26
"03072",2015,0,0,45,45
"03072",2017,0,0,22,22
"03072",2018,0,0,42,42
"03072",2019,0,0,17,17
"03072",2020,0,0,26,26
"03073",2015,0,0,45,45
"03073",2016,0,0,77,77
"03073",2017,0,0,22,22
"03073",2018,0,0,85,85
"03073",2019,0,0,110,110
"03073",2020,0,0,89,89
"03074",2015,0,0,45,45
"03074",2016,0,0,77,77
"03074",2017,0,0,22,22
"03074",2018,0,0,85,85
"03074",2019,0,0,110,110
"03074",2020,0,0,89,89
"03075",2015,0,0,39,39
"03075",2018,0,0,4,4
"03075",2019,0,0,17,17
"03076",2015,0,0,45,45
"03076",2016,0,0,77,77
"03076",2017,0,0,22,22
"03076",2018,0,0,85,85
"03076",2019,0,0,110,110
"03076",2020,0,0,89,89
"03077",2015,0,0,39,39
"03077",2018,0,0,4,4
"03077",2019,0,0,17,17
"03078",2015,0,0,45,45
"03078",2016,0,0,77,77
"03078",2017,0,0,22,22
"03078",2018,0,0,42,42
"03078",2019,0,0,52,52
"03078",2020,0,0,89,89
"03079",2015,0,0,45,45
"03079",2016,0,0,77,77
"03079",2017,0,0,22,22
"03079",2018,0,0,58,58
"03079",2019,0,0,17,17
"03079",2020,0,0,26,26
"03080",2015,0,0,45,45
"03080",2016,0,0,77,77
"03080",2017,0,0,22,22
"03080",2018,0,0,85,85
"03080",2019,0,0,17,17
"03080",2020,0,0,18,18
"03081",2015,0,0,39,39
"03081",2016,0,0,21,21
"03081",2018,0,0,4,4
"03081",2019,0,0,17,17
"03082",2015,0,0,39,39
"03082",2018,0,0,4,4
"03082",2019,0,0,17,17
"03083",2015,0,0,45,45
"03083",2016,0,0,77,77
"03083",2017,0,0,22,22
"03083",2018,0,0,42,42
"03083",2019,0,0,52,52
"03083",2020,0,0,89,89
"03084",2015,0,0,39,39
"03084",2016,0,0,21,21
"03084",2018,0,0,4,4
"03084",2019,0,0,17,17
"03085",2015,0,0,45,45
"03085",2016,0,0,77,77
"03085",2017,0,0,22,22
"03085",2018,0,0,85,85
"03085",2019,0,0,110,110
"03085",2020,0,0,89,89
"03086",2015,0,0,45,45
"03086",2016,0,0,77,77
"03086",2017,0,0,22,22
"03086",2018,0,0,85,85
"03086",2019,0,0,110,110
"03086",2020,0,0,89,89
"03087",2015,0,0,45,45
"03087",2017,0,0,22,22
"03087",2018,0,0,42,42
"03087",2019,0,0,17,17
"03087",2020,0,0,26,26
"03088",2015,0,0,45,45
"03088",2017,0,0,22,22
"03088",2018,0,0,42,42
"03088",2019,0,0,17,17
"03088",2020,0,0,26,26
"03089",2015,0,0,39,39
"03089",2018,0,0,4,4
"03089",2019,0,0,17,17
"03090",2015,0,0,45,45
"03090",2016,0,0,77,77
"03090",2017,0,0,22,22
"03090",2018,0,0,85,85
"03090",2019,0,0,110,110
"03090",2020,0,0,89,89
"03091",2015,0,0,45,45
"03091",2016,0,0,77,77
"03091",2017,0,0,22,22
"03091",2018,0,0,85,85
"03091",2019,0,0,110,110
"03091",2020,0,0,89,89
"03092",2015,0,0,39,39
"03092",2018,0,0,4,4
"03092",2019,0,0,17,17
"03093",2015,0,0,45,45
"03093",2016,0,0,77,77
"03093",2017,0,0,22,22
"03093",2018,0,0,42,42
"03093",2019,0,0,17,17
"03093",2020,0,0,62,62
"03094",2015,0,0,45,45
"03094",2016,0,0,77,77
"03094",2017,0,0,22,22
"03094",2018,0,0,42,42
"03094",2019,0,0,17,17
"03094",2020,0,0,62,62
"03095",2015,0,0,45,45
"03095",2016,0,0,77,77
"03095",2017,0,0,22,22
"03095",2018,0,0,42,42
"03095",2019,0,0,17,17
"03095",2020,0,0,62,62
"03096",2015,0,0,39,39
"03096",2018,0,0,4,4
"03096",2019,0,0,17,17
"03097",2015,0,0,39,39
"03097",2018,0,0,4,4
"03097",2019,0,0,17,17
"03098",2015,0,0,45,45
"03098",2017,0,0,22,22
"03098",2018,0,0,42,42
"03098",2019,0,0,17,17
"03098",2020,0,0,26,26
"03099",2015,0,0,39,39
"03099",2018,0,0,4,4
"03099",2019,0,0,17,17
"03100",2015,0,0,45,45
"03100",2016,0,0,77,77
"03100",2017,0,0,22,22
"03100",2018,0,0,58,58
"03100",2019,0,0,17,17
"03100",2020,0,0,26,26
"03101",2015,0,0,45,45
"03101",2017,0,0,22,22
"03101",2018,0,0,42,42
"03101",2019,0,0,17,17
"03101",2020,0,0,26,26
"03102",2015,0,0,45,45
"03102",2016,0,0,77,77
"03102",2017,0,0,22,22
"03102",2018,0,0,58,58
"03102",2019,0,0,17,17
"03102",2020,0,0,26,26
"03103",2015,0,0,45,45
"03103",2016,0,0,77,77
"03103",2017,0,0,22,22
"03103",2018,0,0,58,58
"03103",2019,0,0,17,17
"03103",2020,0,0,26,26
"03104",2015,0,0,39,39
"03104",2018,0,0,4,4
"03104",2019,0,0,17,17
"03105",2015,0,0,45,45
"03105",2016,0,0,77,77
"03105",2017,0,0,22,22
"03105",2018,0,0,58,58
"03105",2019,0,0,17,17
"03105",2020,0,0,26,26
"03106",2015,0,0,39,39
"03106",2018,0,0,4,4
"03106",2019,0,0,17,17
"03107",2015,0,0,45,45
"03107",2016,0,0,77,77
"03107",2017,0,0,22,22
"03107",2018,0,0,42,42
"03107",2019,0,0,17,17
"03107",2020,0,0,18,18
"03108",2015,0,0,39,39
"03108",2018,0,0,4,4
"03108",2019,0,0,17,17
"03109",2015,0,0,45,45
"03109",2016,0,0,77,77
"03109",2017,0,0,22,22
"03109",2018,0,0,85,85
"03109",2019,0,0,17,17
"03109",2020,0,0,18,18
"03110",2015,0,0,45,45
"03110",2016,0,0,77,77
"03110",2017,0,0,22,22
"03110",2018,0,0,85,85
"03110",2019,0,0,17,17
"03110",2020,0,0,18,18
"03111",2015,0,0,45,45
"03111",2017,0,0,22,22
"03111",2018,0,0,42,42
"03111",2019,0,0,17,17
"03111",2020,0,0,26,26
"03112",2015,0,0,39,39
"03112",2018,0,0,4,4
"03112",2019,0,0,17,17
"03113",2015,0,0,45,45
"03113",2016,0,0,77,77
"03113",2017,0,0,22,22
"03113",2018,0,0,42,42
"03113",2019,0,0,17,17
"03113",2020,0,0,26,26
"03114",2015,0,0,45,45
"03114",2016,0,0,77,77
"03114",2017,0,0,22,22
"03114",2018,0,0,42,42
"03114",2019,0,0,52,52
"03114",2020,0,0,89,89
"03115",2015,0,0,39,39
"03115",2018,0,0,4,4
"03115",2019,0,0,17,17
"03116",2015,0,0,39,39
"03116",2018,0,0,4,4
"03116",2019,0,0,17,17
"03117",2015,0,0,45,45
"03117",2016,0,0,77,77
"03117",2017,0,0,22,22
"03117",2018,0,0,85,85
"03117",2019,0,0,110,110
"03117",2020,0,0,89,89
"03118",2015,0,0,45,45
"03118",2016,0,0,77,77
"03118",2017,0,0,22,22
"03118",2018,0,0,42,42
"03118",2019,0,0,17,17
"03118",2020,0,0,18,18
"03119",2015,0,0,45,45
"03119",2016,0,0,77,77
"03119",2017,0,0,22,22
"03119",2018,0,0,85,85
"03119",2019,0,0,110,110
"03119",2020,0,0,89,89
"03120",2015,0,0,45,45
"03120",2016,0,0,77,77
"03120",2017,0,0,22,22
"03120",2018,0,0,85,85
"03120",2019,0,0,110,110
"03120",2020,0,0,89,89
"03121",2015,0,0,45,45
"03121",2016,0,0,77,77
"03121",2017,0,0,22,22
"03121",2018,0,0,85,85
"03121",2019,0,0,110,110
"03121",2020,0,0,89,89
"03122",2015,0,0,39,39
"03122",2016,0,0,21,21
"03122",2018,0,0,4,4
"03122",2019,0,0,17,17
"03124",2015,0,0,45,45
"03124",2016,0,0,77,77
"03124",2017,0,0,22,22
"03124",2018,0,0,85,85
"03124",2019,0,0,110,110
"03124",2020,0,0,89,89
"03125",2015,0,0,45,45
"03125",2016,0,0,77,77
"03125",2017,0,0,22,22
"03125",2018,0,0,42,42
"03125",2019,0,0,17,17
"03125",2020,0,0,62,62
"03126",2015,0,0,45,45
"03126",2016,0,0,77,77
"03126",2017,0,0,22,22
"03126",2018,0,0,85,85
"03126",2019,0,0,110,110
"03126",2020,0,0,89,89
"03127",2015,0,0,39,39
"03127",2018,0,0,4,4
"03127",2019,0,0,17,17
"03128",2015,0,0,45,45
"03128",2017,0,0,22,22
"03128",2018,0,0,42,42
"03128",2019,0,0,17,17
"03128",2020,0,0,26,26
"03129",2015,0,0,39,39
"03129",2016,0,0,21,21
"03129",2018,0,0,4,4
"03129",2019,0,0,17,17
"03130",2015,0,0,45,45
"03130",2017,0,0,22,22
"03130",2018,0,0,42,42
"03130",2019,0,0,17,17
"03130",2020,0,0,26,26
"03131",2015,0,0,45,45
"03131",2016,0,0,77,77
"03131",2017,0,0,22,22
"03131",2018,0,0,42,42
"03131",2019,0,0,17,17
"03131",2020,0,0,26,26
"03132",2015,0,0,45,45
"03132",2016,0,0,77,77
"03132",2017,0,0,22,22
"03132",2018,0,0,58,58
"03132",2019,0,0,17,17
"03132",2020,0,0,26,26
"03133",2015,0,0,45,45
"03133",2016,0,0,77,77
"03133",2017,0,0,22,22
"03133",2018,0,0,42,42
"03133",2019,0,0,17,17
"03133",2020,0,0,18,18
"03134",2015,0,0,39,39
"03134",2018,0,0,4,4
"03134",2019,0,0,17,17
"03135",2015,0,0,39,39
"03135",2018,0,0,4,4
"03135",2019,0,0,17,17
"03136",2015,0,0,45,45
"03136",2017,0,0,22,22
"03136",2018,0,0,42,42
"03136",2019,0,0,17,17
"03136",2020,0,0,26,26
"03137",2015,0,0,45,45
"03137",2016,0,0,77,77
"03137",2017,0,0,22,22
"03137",2018,0,0,85,85
"03137",2019,0,0,110,110
"03137",2020,0,0,89,89
"03138",2015,0,0,45,45
"03138",2016,0,0,77,77
"03138",2017,0,0,22,22
"03138",2018,0,0,58,58
"03138",2019,0,0,17,17
"03138",2020,0,0,26,26
"03139",2015,0,0,45,45
"03139",2016,0,0,77,77
"03139",2017,0,0,22,22
"03139",2018,0,0,42,42
"03139",2019,0,0,17,17
"03139",2020,0,0,26,26
"03140",2015,0,0,45,45
"03140",2017,0,0,22,22
"03140",2018,0,0,42,42
"03140",2019,0,0,17,17
"03140",2020,0,0,26,26
"03141",2015,0,0,45,45
"03141",2016,0,0,77,77
"03141",2017,0,0,22,22
"03141",2018,0,0,42,42
"03141",2019,0,0,17,17
"03141",2020,0,0,26,26
"03142",2015,0,0,45,45
"03142",2016,0,0,77,77
"03142",2017,0,0,22,22
"03142",2018,0,0,85,85
"03142",2019,0,0,110,110
"03142",2020,0,0,89,89
"03143",2015,0,0,45,45
"03143",2017,0,0,22,22
"03143",2018,0,0,42,42
"03143",2019,0,0,17,17
"03143",2020,0,0,26,26
"03144",2015,0,0,45,45
"03144",2016,0,0,77,77
"03144",2017,0,0,22,22
"03144",2018,0,0,85,85
"03144",2019,0,0,110,110
"03144",2020,0,0,89,89
"03145",2015,0,0,45,45
"03145",2017,0,0,22,22
"03145",2018,0,0,42,42
"03145",2019,0,0,17,17
"03145",2020,0,0,26,26
"03146",2015,0,0,45,45
"03146",2016,0,0,77,77
"03146",2017,0,0,22,22
"03146",2018,0,0,85,85
"03146",2019,0,0,110,110
"03146",2020,0,0,89,89
"03147",2015,0,0,45,45
"03147",2016,0,0,77,77
"03147",2017,0,0,22,22
"03147",2018,0,0,58,58
"03147",2019,0,0,17,17
"03147",2020,0,0,26,26
"03148",2015,0,0,45,45
"03148",2016,0,0,77,77
"03148",2017,0,0,22,22
"03148",2018,0,0,42,42
"03148",2019,0,0,17,17
"03148",2020,0,0,18,18
"03149",2015,0,0,39,39
"03149",2018,0,0,4,4
"03149",2019,0,0,17,17
"03150",2015,0,0,39,39
"03150",2016,0,0,21,21
"03150",2018,0,0,4,4
"03150",2019,0,0,17,17
"03151",2015,0,0,39,39
"03151",2016,0,0,21,21
"03151",2018,0,0,4,4
"03151",2019,0,0,17,17
"03152",2015,0,0,39,39
"03152",2018,0,0,4,4
"03152",2019,0,0,17,17
"03154",2015,0,0,45,45
"03154",2016,0,0,77,77
"03154",2017,0,0,22,22
"03154",2018,0,0,85,85
"03154",2019,0,0,110,110
"03154",2020,0,0,89,89
"03155",2015,0,0,45,45
"03155",2017,0,0,22,22
"03155",2018,0,0,42,42
"03155",2019,0,0,17,17
"03155",2020,0,0,26,26
"03156",2015,0,0,45,45
"03156",2016,0,0,77,77
"03156",2017,0,0,22,22
"03156",2018,0,0,85,85
"03156",2019,0,0,110,110
"03156",2020,0,0,89,89
"03157",2015,0,0,45,45
"03157",2016,0,0,77,77
"03157",2017,0,0,22,22
"03157",2018,0,0,85,85
"03157",2019,0,0,110,110
"03157",2020,0,0,89,89
"03158",2015,0,0,39,39
"03158",2018,0,0,4,4
"03158",2019,0,0,17,17
"03159",2015,0,0,39,39
"03159",2018,0,0,4,4
"03159",2019,0,0,17,17
"03160",2015,0,0,45,45
"03160",2016,0,0,77,77
"03160",2017,0,0,22,22
"03160",2018,0,0,85,85
"03160",2019,0,0,17,17
"03160",2020,0,0,18,18
"03161",2015,0,0,45,45
"03161",2017,0,0,22,22
"03161",2018,0,0,42,42
"03161",2019,0,0,17,17
"03161",2020,0,0,26,26
"03162",2015,0,0,45,45
"03162",2016,0,0,77,77
"03162",2017,0,0,22,22
"03162",2018,0,0,85,85
"03162",2019,0,0,110,110
"03162",2020,0,0,89,89
"03163",2015,0,0,45,45
"03163",2016,0,0,77,77
"03163",2017,0,0,22,22
"03163",2018,0,0,85,85
"03163",2019,0,0,110,110
"03163",2020,0,0,89,89
"03164",2015,0,0,45,45
"03164",2016,0,0,77,77
"03164",2017,0,0,22,22
"03164",2018,0,0,42,42
"03164",2019,0,0,17,17
"03164",2020,0,0,18,18
"03165",2015,0,0,45,45
"03165",2016,0,0,77,77
"03165",2017,0,0,22,22
"03165",2018,0,0,42,42
"03165",2019,0,0,17,17
"03165",2020,0,0,26,26
"03166",2015,0,0,45,45
"03166",2016,0,0,77,77
"03166",2017,0,0,22,22
"03166",2018,0,0,42,42
"03166",2019,0,0,17,17
"03166",2020,0,0,18,18
"03167",2015,0,0,45,45
"03167",2017,0,0,22,22
"03167",2018,0,0,42,42
"03167",2019,0,0,17,17
"03167",2020,0,0,26,26
"03168",2015,0,0,39,39
"03168",2018,0,0,4,4
"03168",2019,0,0,17,17
"03169",2015,0,0,45,45
"03169",2016,0,0,77,77
"03169",2017,0,0,22,22
"03169",2018,0,0,42,42
"03169",2019,0,0,52,52
"03169",2020,0,0,89,89
"03170",2015,0,0,45,45
"03170",2016,0,0,77,77
"03170",2017,0,0,22,22
"03170",2018,0,0,85,85
"03170",2019,0,0,110,110
"03170",2020,0,0,89,89
"03171",2015,0,0,45,45
"03171",2016,0,0,77,77
"03171",2017,0,0,22,22
"03171",2018,0,0,58,58
"03171",2019,0,0,17,17
"03171",2020,0,0,26,26
"03172",2015,0,0,45,45
"03172",2017,0,0,22,22
"03172",2018,0,0,42,42
"03172",2019,0,0,17,17
"03172",2020,0,0,26,26
"03173",2015,0,0,45,45
"03173",2016,0,0,77,77
"03173",2017,0,0,22,22
"03173",2018,0,0,85,85
"03173",2019,0,0,110,110
"03173",2020,0,0,89,89
"03174",2015,0,0,45,45
"03174",2016,0,0,77,77
"03174",2017,0,0,22,22
"03174",2018,0,0,42,42
"03174",2019,0,0,17,17
"03174",2020,0,0,62,62
"03175",2015,0,0,39,39
"03175",2018,0,0,4,4
"03175",2019,0,0,17,17
"03176",2015,0,0,45,45
"03176",2016,0,0,77,77
"03176",2017,0,0,22,22
"03176",2018,0,0,42,42
"03176",2019,0,0,52,52
"03176",2020,0,0,89,89
"03177",2015,0,0,45,45
"03177",2016,0,0,77,77
"03177",2017,0,0,22,22
"03177",2018,0,0,85,85
"03177",2019,0,0,110,110
"03177",2020,0,0,89,89
"03178",2015,0,0,45,45
"03178",2016,0,0,77,77
"03178",2017,0,0,22,22
"03178",2018,0,0,58,58
"03178",2019,0,0,17,17
"03178",2020,0,0,26,26
"03179",2015,0,0,45,45
"03179",2016,0,0,77,77
"03179",2017,0,0,22,22
"03179",2018,0,0,58,58
"03179",2019,0,0,17,17
"03179",2020,0,0,26,26
"03180",2015,0,0,45,45
"03180",2016,0,0,77,77
"03180",2017,0,0,22,22
"03180",2018,0,0,85,85
"03180",2019,0,0,110,110
"03180",2020,0,0,89,89
"03181",2015,0,0,45,45
"03181",2016,0,0,77,77
"03181",2017,0,0,22,22
"03181",2018,0,0,58,58
"03181",2019,0,0,17,17
"03181",2020,0,0,26,26
"03182",2015,0,0,45,45
"03182",2016,0,0,77,77
"03182",2017,0,0,22,22
"03182",2018,0,0,85,85
"03182",2019,0,0,17,17
"03182",2020,0,0,18,18
"03183",2015,0,0,39,39
"03183",2018,0,0,4,4
"03183",2019,0,0,17,17
"03184",2015,0,0,45,45
"03184",2016,0,0,77,77
"03184",2017,0,0,22,22
"03184",2018,0,0,85,85
"03184",2019,0,0,110,110
"03184",2020,0,0,89,89
"03185",2015,0,0,45,45
"03185",2017,0,0,22,22
"03185",2018,0,0,42,42
"03185",2019,0,0,17,17
"03185",2020,0,0,26,26
"03186",2015,0,0,39,39
"03186",2018,0,0,4,4
"03186",2019,0,0,17,17
"03187",2015,0,0,45,45
"03187",2016,0,0,77,77
"03187",2017,0,0,22,22
"03187",2018,0,0,85,85
"03187",2019,0,0,110,110
"03187",2020,0,0,89,89
"03188",2015,0,0,39,39
"03188",2018,0,0,4,4
"03188",2019,0,0,17,17
"03189",2015,0,0,39,39
"03189",2016,0,0,21,21
"03189",2018,0,0,4,4
"03189",2019,0,0,17,17
"03190",2015,0,0,45,45
"03190",2016,0,0,77,77
"03190",2017,0,0,22,22
"03190",2018,0,0,85,85
"03190",2019,0,0,110,110
"03190",2020,0,0,89,89
"03191",2015,0,0,39,39
"03191",2016,0,0,21,21
"03191",2018,0,0,4,4
"03191",2019,0,0,17,17
"03192",2015,0,0,45,45
"03192",2016,0,0,77,77
"03192",2017,0,0,22,22
"03192",2018,0,0,42,42
"03192",2019,0,0,52,52
"03192",2020,0,0,89,89
"03193",2015,0,0,39,39
"03193",2018,0,0,4,4
"03193",2019,0,0,17,17
"03194",2015,0,0,39,39
"03194",2018,0,0,4,4
"03194",2019,0,0,17,17
"03195",2015,0,0,39,39
"03195",2018,0,0,4,4
"03195",2019,0,0,17,17
"03196",2015,0,0,45,45
"03196",2016,0,0,77,77
"03196",2017,0,0,22,22
"03196",2018,0,0,85,85
"03196",2019,0,0,110,110
"03196",2020,0,0,89,89
"03197",2015,0,0,45,45
"03197",2016,0,0,77,77
"03197",2017,0,0,22,22
"03197",2018,0,0,85,85
"03197",2019,0,0,110,110
"03197",2020,0,0,89,89
"03198",2015,0,0,45,45
"03198",2016,0,0,77,77
"03198",2017,0,0,22,22
"03198",2018,0,0,85,85
"03198",2019,0,0,110,110
"03198",2020,0,0,89,89
"03200",2015,0,0,45,45
"03200",2016,0,0,77,77
"03200",2017,0,0,22,22
"03200",2018,0,0,85,85
"03200",2019,0,0,110,110
"03200",2020,0,0,89,89
"03201",2015,0,0,45,45
"03201",2016,0,0,77,77
"03201",2017,0,0,22,22
"03201",2018,0,0,42,42
"03201",2019,0,0,17,17
"03201",2020,0,0,26,26
"03202",2015,0,0,39,39
"03202",2018,0,0,4,4
"03202",2019,0,0,17,17
"03203",2015,0,0,45,45
"03203",2016,0,0,77,77
"03203",2017,0,0,22,22
"03203",2018,0,0,85,85
"03203",2019,0,0,110,110
"03203",2020,0,0,89,89
"03204",2015,0,0,45,45
"03204",2016,0,0,77,77
"03204",2017,0,0,22,22
"03204",2018,0,0,42,42
"03204",2019,0,0,17,17
"03204",2020,0,0,18,18
"03205",2015,0,0,45,45
"03205",2016,0,0,77,77
"03205",2017,0,0,22,22
"03205",2018,0,0,58,58
"03205",2019,0,0,17,17
"03205",2020,0,0,26,26
"03206",2015,0,0,45,45
"03206",2017,0,0,22,22
"03206",2018,0,0,42,42
"03206",2019,0,0,17,17
"03206",2020,0,0,26,26
"03207",2015,0,0,45,45
"03207",2016,0,0,77,77
"03207",2017,0,0,22,22
"03207",2018,0,0,85,85
"03207",2019,0,0,110,110
"03207",2020,0,0,89,89
"03208",2015,0,0,45,45
"03208",2016,0,0,77,77
"03208",2017,0,0,22,22
"03208",2018,0,0,85,85
"03208",2019,0,0,110,110
"03208",2020,0,0,89,89
"03209",2015,0,0,45,45
"03209",2016,0,0,77,77
"03209",2017,0,0,22,22
"03209",2018,0,0,85,85
"03209",2019,0,0,17,17
"03209",2020,0,0,18,18
"03210",2015,0,0,45,45
"03210",2016,0,0,77,77
"03210",2017,0,0,22,22
"03210",2018,0,0,85,85
"03210",2019,0,0,110,110
"03210",2020,0,0,89,89
"03211",2015,0,0,45,45
"03211",2017,0,0,22,22
"03211",2018,0,0,42,42
"03211",2019,0,0,17,17
"03211",2020,0,0,26,26
"03212",2015,0,0,45,45
"03212",2017,0,0,22,22
"03212",2018,0,0,42,42
"03212",2019,0,0,17,17
"03212",2020,0,0,26,26
"03213",2015,0,0,39,39
"03213",2018,0,0,4,4
"03213",2019,0,0,17,17
"03214",2015,0,0,39,39
"03214",2018,0,0,4,4
"03214",2019,0,0,17,17
"03215",2015,0,0,45,45
"03215",2016,0,0,77,77
"03215",2017,0,0,22,22
"03215",2018,0,0,85,85
"03215",2019,0,0,110,110
"03215",2020,0,0,89,89
"03216",2015,0,0,39,39
"03216",2018,0,0,4,4
"03216",2019,0,0,17,17
"03217",2015,0,0,39,39
"03217",2018,0,0,4,4
"03217",2019,0,0,17,17
"03218",2015,0,0,39,39
"03218",2016,0,0,21,21
"03218",2018,0,0,4,4
"03218",2019,0,0,17,17
"03219",2015,0,0,39,39
"03219",2018,0,0,4,4
"03219",2019,0,0,17,17
"03220",2015,0,0,39,39
"03220",2018,0,0,4,4
"03220",2019,0,0,17,17
"03221",2015,0,0,39,39
"03221",2018,0,0,4,4
"03221",2019,0,0,17,17
"03222",2015,0,0,39,39
"03222",2016,0,0,21,21
"03222",2018,0,0,4,4
"03222",2019,0,0,17,17
"03223",2015,0,0,45,45
"03223",2016,0,0,77,77
"03223",2017,0,0,22,22
"03223",2018,0,0,42,42
"03223",2019,0,0,17,17
"03223",2020,0,0,26,26
"03224",2015,0,0,45,45
"03224",2016,0,0,77,77
"03224",2017,0,0,22,22
"03224",2018,0,0,42,42
"03224",2019,0,0,17,17
"03224",2020,0,0,26,26
"03225",2015,0,0,45,45
"03225",2017,0,0,22,22
"03225",2018,0,0,42,42
"03225",2019,0,0,17,17
"03225",2020,0,0,26,26
"03226",2015,0,0,45,45
"03226",2016,0,0,77,77
"03226",2017,0,0,22,22
"03226",2018,0,0,85,85
"03226",2019,0,0,110,110
"03226",2020,0,0,89,89
"03227",2015,0,0,45,45
"03227",2016,0,0,77,77
"03227",2017,0,0,22,22
"03227",2018,0,0,42,42
"03227",2019,0,0,17,17
"03227",2020,0,0,18,18
"03228",2015,0,0,45,45
"03228",2017,0,0,22,22
"03228",2018,0,0,42,42
"03228",2019,0,0,17,17
"03228",2020,0,0,26,26
"03229",2015,0,0,45,45
"03229",2016,0,0,77,77
"03229",2017,0,0,22,22
"03229",2018,0,0,85,85
"03229",2019,0,0,110,110
"03229",2020,0,0,89,89
"03230",2015,0,0,45,45
"03230",2016,0,0,77,77
"03230",2017,0,0,22,22
"03230",2018,0,0,42,42
"03230",2019,0,0,17,17
"03230",2020,0,0,62,62
"03231",2015,0,0,45,45
"03231",2017,0,0,22,22
"03231",2018,0,0,42,42
"03231",2019,0,0,17,17
"03231",2020,0,0,26,26
"03232",2015,0,0,45,45
"03232",2016,0,0,77,77
"03232",2017,0,0,22,22
"03232",2018,0,0,85,85
"03232",2019,0,0,110,110
"03232",2020,0,0,89,89
"03233",2015,0,0,45,45
"03233",2017,0,0,22,22
"03233",2018,0,0,42,42
"03233",2019,0,0,17,17
"03233",2020,0,0,26,26
"03234",2015,0,0,45,45
"03234",2016,0,0,77,77
"03234",2017,0,0,22,22
"03234",2018,0,0,85,85
"03234",2019,0,0,110,110
"03234",2020,0,0,89,89
"03235",2015,0,0,45,45
"03235",2016,0,0,77,77
"03235",2017,0,0,22,22
"03235",2018,0,0,58,58
"03235",2019,0,0,17,17
"03235",2020,0,0,26,26
"03236",2015,0,0,45,45
"03236",2016,0,0,77,77
"03236",2017,0,0,22,22
"03236",2018,0,0,85,85
"03236",2019,0,0,110,110
"03236",2020,0,0,89,89
"03237",2015,0,0,39,39
"03237",2018,0,0,4,4
"03237",2019,0,0,17,17
"03238",2015,0,0,39,39
"03238",2016,0,0,21,21
"03238",2018,0,0,4,4
"03238",2019,0,0,17,17
"03239",2015,0,0,45,45
"03239",2016,0,0,77,77
"03239",2017,0,0,22,22
"03239",2018,0,0,85,85
"03239",2019,0,0,110,110
"03239",2020,0,0,89,89
"03240",2015,0,0,45,45
"03240",2016,0,0,77,77
"03240",2017,0,0,22,22
"03240",2018,0,0,58,58
"03240",2019,0,0,17,17
"03240",2020,0,0,26,26
"03241",2015,0,0,45,45
"03241",2016,0,0,77,77
"03241",2017,0,0,22,22
"03241",2018,0,0,85,85
"03241",2019,0,0,110,110
"03241",2020,0,0,89,89
"03242",2015,0,0,45,45
"03242",2016,0,0,77,77
"03242",2017,0,0,22,22
"03242",2018,0,0,42,42
"03242",2019,0,0,52,52
"03242",2020,0,0,89,89
"03243",2015,0,0,39,39
"03243",2018,0,0,4,4
"03243",2019,0,0,17,17
"03244",2015,0,0,45,45
"03244",2017,0,0,22,22
"03244",2018,0,0,42,42
"03244",2019,0,0,17,17
"03244",2020,0,0,26,26
"03245",2015,0,0,45,45
"03245",2016,0,0,77,77
"03245",2017,0,0,22,22
"03245",2018,0,0,85,85
"03245",2019,0,0,110,110
"03245",2020,0,0,89,89
"03246",2015,0,0,45,45
"03246",2017,0,0,22,22
"03246",2018,0,0,42,42
"03246",2019,0,0,17,17
"03246",2020,0,0,26,26
"03247",2015,0,0,45,45
"03247",2016,0,0,77,77
"03247",2017,0,0,22,22
"03247",2018,0,0,85,85
"03247",2019,0,0,110,110
"03247",2020,0,0,89,89
"03248",2015,0,0,45,45
"03248",2016,0,0,77,77
"03248",2017,0,0,22,22
"03248",2018,0,0,58,58
"03248",2019,0,0,17,17
"03248",2020,0,0,26,26
"03249",2015,0,0,45,45
"03249",2017,0,0,22,22
"03249",2018,0,0,42,42
"03249",2019,0,0,17,17
"03249",2020,0,0,26,26
"03250",2015,0,0,45,45
"03250",2016,0,0,77,77
"03250",2017,0,0,22,22
"03250",2018,0,0,58,58
"03250",2019,0,0,17,17
"03250",2020,0,0,26,26
"03251",2015,0,0,45,45
"03251",2016,0,0,77,77
"03251",2017,0,0,22,22
"03251",2018,0,0,85,85
"03251",2019,0,0,110,110
"03251",2020,0,0,89,89
"03252",2015,0,0,45,45
"03252",2016,0,0,77,77
"03252",2017,0,0,22,22
"03252",2018,0,0,85,85
"03252",2019,0,0,17,17
"03252",2020,0,0,18,18
"03253",2015,0,0,45,45
"03253",2016,0,0,77,77
"03253",2017,0,0,22,22
"03253",2018,0,0,58,58
"03253",2019,0,0,17,17
"03253",2020,0,0,26,26
"03254",2015,0,0,45,45
"03254",2016,0,0,77,77
"03254",2017,0,0,22,22
"03254",2018,0,0,42,42
"03254",2019,0,0,17,17
"03254",2020,0,0,18,18
"03255",2015,0,0,45,45
"03255",2016,0,0,77,77
"03255",2017,0,0,22,22
"03255",2018,0,0,85,85
"03255",2019,0,0,17,17
"03255",2020,0,0,18,18
"03256",2015,0,0,39,39
"03256",2016,0,0,21,21
"03256",2018,0,0,4,4
"03256",2019,0,0,17,17
"03257",2015,0,0,45,45
"03257",2016,0,0,77,77
"03257",2017,0,0,22,22
"03257",2018,0,0,58,58
"03257",2019,0,0,17,17
"03257",2020,0,0,26,26
"03258",2015,0,0,45,45
"03258",2016,0,0,77,77
"03258",2017,0,0,22,22
"03258",2018,0,0,85,85
"03258",2019,0,0,17,17
"03258",2020,0,0,18,18
"03259",2015,0,0,45,45
"03259",2017,0,0,22,22
"03259",2018,0,0,42,42
"03259",2019,0,0,17,17
"03259",2020,0,0,26,26
"03260",2015,0,0,39,39
"03260",2018,0,0,4,4
"03260",2019,0,0,17,17
"03261",2015,0,0,45,45
"03261",2017,0,0,22,22
"03261",2018,0,0,42,42
"03261",2019,0,0,17,17
"03261",2020,0,0,26,26
"03262",2015,0,0,45,45
"03262",2017,0,0,22,22
"03262",2018,0,0,42,42
"03262",2019,0,0,17,17
"03262",2020,0,0,26,26
"03263",2015,0,0,45,45
"03263",2016,0,0,77,77
"03263",2017,0,0,22,22
"03263",2018,0,0,58,58
"03263",2019,0,0,17,17
"03263",2020,0,0,26,26
"03264",2015,0,0,45,45
"03264",2016,0,0,77,77
"03264",2017,0,0,22,22
"03264",2018,0,0,85,85
"03264",2019,0,0,110,110
"03264",2020,0,0,89,89
"03265",2015,0,0,45,45
"03265",2016,0,0,77,77
"03265",2017,0,0,22,22
"03265",2018,0,0,58,58
"03265",2019,0,0,17,17
"03265",2020,0,0,26,26
"03266",2015,0,0,45,45
"03266",2016,0,0,77,77
"03266",2017,0,0,22,22
"03266",2018,0,0,85,85
"03266",2019,0,0,110,110
"03266",2020,0,0,89,89
"03267",2015,0,0,45,45
"03267",2016,0,0,77,77
"03267",2017,0,0,22,22
"03267",2018,0,0,42,42
"03267",2019,0,0,52,52
"03267",2020,0,0,89,89
"03268",2015,0,0,45,45
"03268",2016,0,0,77,77
"03268",2017,0,0,22,22
"03268",2018,0,0,42,42
"03268",2019,0,0,17,17
"03268",2020,0,0,18,18
"03269",2015,0,0,39,39
"03269",2016,0,0,21,21
"03269",2018,0,0,4,4
"03269",2019,0,0,17,17
"03270",2015,0,0,39,39
"03270",2018,0,0,4,4
"03270",2019,0,0,17,17
"03271",2015,0,0,45,45
"03271",2016,0,0,77,77
"03271",2017,0,0,22,22
"03271",2018,0,0,85,85
"03271",2019,0,0,17,17
"03271",2020,0,0,18,18
"03272",2015,0,0,45,45
"03272",2016,0,0,77,77
"03272",2017,0,0,22,22
"03272",2018,0,0,58,58
"03272",2019,0,0,17,17
"03272",2020,0,0,26,26
"03273",2015,0,0,45,45
"03273",2016,0,0,77,77
"03273",2017,0,0,22,22
"03273",2018,0,0,85,85
"03273",2019,0,0,110,110
"03273",2020,0,0,89,89
"03274",2015,0,0,45,45
"03274",2016,0,0,77,77
"03274",2017,0,0,22,22
"03274",2018,0,0,58,58
"03274",2019,0,0,17,17
"03274",2020,0,0,26,26
"03275",2015,0,0,45,45
"03275",2016,0,0,77,77
"03275",2017,0,0,22,22
"03275",2018,0,0,85,85
"03275",2019,0,0,110,110
"03275",2020,0,0,89,89
"03276",2015,0,0,39,39
"03276",2018,0,0,4,4
"03276",2019,0,0,17,17
"03277",2015,0,0,39,39
"03277",2018,0,0,4,4
"03277",2019,0,0,17,17
"03278",2015,0,0,39,39
"03278",2018,0,0,4,4
"03278",2019,0,0,17,17
"03279",2015,0,0,45,45
"03279",2017,0,0,22,22
"03279",2018,0,0,42,42
"03279",2019,0,0,17,17
"03279",2020,0,0,26,26
"03280",2015,0,0,45,45
"03280",2017,0,0,22,22
"03280",2018,0,0,42,42
"03280",2019,0,0,17,17
"03280",2020,0,0,26,26
"03281",2015,0,0,39,39
"03281",2018,0,0,4,4
"03281",2019,0,0,17,17
"03282",2015,0,0,39,39
"03282",2018,0,0,4,4
"03282",2019,0,0,17,17
"03283",2015,0,0,45,45
"03283",2016,0,0,77,77
"03283",2017,0,0,22,22
"03283",2018,0,0,58,58
"03283",2019,0,0,17,17
"03283",2020,0,0,26,26
"03284",2015,0,0,45,45
"03284",2016,0,0,77,77
"03284",2017,0,0,22,22
"03284",2018,0,0,58,58
"03284",2019,0,0,17,17
"03284",2020,0,0,26,26
"03285",2015,0,0,39,39
"03285",2016,0,0,21,21
"03285",2018,0,0,4,4
"03285",2019,0,0,17,17
"03286",2015,0,0,45,45
"03286",2016,0,0,77,77
"03286",2017,0,0,22,22
"03286",2018,0,0,85,85
"03286",2019,0,0,110,110
"03286",2020,0,0,89,89
"03287",2015,0,0,39,39
"03287",2018,0,0,4,4
"03287",2019,0,0,17,17
"03288",2015,0,0,45,45
"03288",2017,0,0,22,22
"03288",2018,0,0,42,42
"03288",2019,0,0,17,17
"03288",2020,0,0,26,26
"03289",2015,0,0,45,45
"03289",2016,0,0,77,77
"03289",2017,0,0,22,22
"03289",2018,0,0,58,58
"03289",2019,0,0,17,17
"03289",2020,0,0,26,26
"03290",2015,0,0,45,45
"03290",2016,0,0,77,77
"03290",2017,0,0,22,22
"03290",2018,0,0,85,85
"03290",2019,0,0,110,110
"03290",2020,0,0,89,89
"03291",2015,0,0,45,45
"03291",2016,0,0,77,77
"03291",2017,0,0,22,22
"03291",2018,0,0,58,58
"03291",2019,0,0,17,17
"03291",2020,0,0,26,26
"03292",2015,0,0,39,39
"03292",2018,0,0,4,4
"03292",2019,0,0,17,17
"03293",2015,0,0,45,45
"03293",2017,0,0,22,22
"03293",2018,0,0,42,42
"03293",2019,0,0,17,17
"03293",2020,0,0,26,26
"03294",2015,0,0,39,39
"03294",2018,0,0,4,4
"03294",2019,0,0,17,17
"03295",2015,0,0,39,39
"03295",2018,0,0,4,4
"03295",2019,0,0,17,17
"03296",2015,0,0,45,45
"03296",2017,0,0,22,22
"03296",2018,0,0,42,42
"03296",2019,0,0,17,17
"03296",2020,0,0,26,26
"03297",2015,0,0,39,39
"03297",2018,0,0,4,4
"03297",2019,0,0,17,17
"03298",2015,0,0,45,45
"03298",2016,0,0,77,77
"03298",2017,0,0,22,22
"03298",2018,0,0,85,85
"03298",2019,0,0,110,110
"03298",2020,0,0,89,89
"03299",2015,0,0,45,45
"03299",2016,0,0,77,77
"03299",2017,0,0,22,22
"03299",2018,0,0,58,58
"03299",2019,0,0,17,17
"03299",2020,0,0,26,26
"03300",2015,0,0,45,45
"03300",2016,0,0,77,77
"03300",2017,0,0,22,22
"03300",2018,0,0,58,58
"03300",2019,0,0,17,17
"03300",2020,0,0,26,26
"03301",2015,0,0,45,45
"03301",2017,0,0,22,22
"03301",2018,0,0,42,42
"03301",2019,0,0,17,17
"03301",2020,0,0,26,26
"03302",2015,0,0,39,39
"03302",2018,0,0,4,4
"03302",2019,0,0,17,17
"03303",2015,0,0,39,39
"03303",2016,0,0,21,21
"03303",2018,0,0,4,4
"03303",2019,0,0,17,17
"03304",2015,0,0,45,45
"03304",2016,0,0,77,77
"03304",2017,0,0,22,22
"03304",2018,0,0,85,85
"03304",2019,0,0,17,17
"03304",2020,0,0,18,18
"03305",2015,0,0,39,39
"03305",2018,0,0,4,4
"03305",2019,0,0,17,17
"03306",2015,0,0,45,45
"03306",2016,0,0,77,77
"03306",2017,0,0,22,22
"03306",2018,0,0,42,42
"03306",2019,0,0,17,17
"03306",2020,0,0,62,62
"03307",2015,0,0,45,45
"03307",2016,0,0,77,77
"03307",2017,0,0,22,22
"03307",2018,0,0,42,42
"03307",2019,0,0,52,52
"03307",2020,0,0,89,89
"03308",2015,0,0,39,39
"03308",2018,0,0,4,4
"03308",2019,0,0,17,17
"03309",2015,0,0,45,45
"03309",2016,0,0,77,77
"03309",2017,0,0,22,22
"03309",2018,0,0,85,85
"03309",2019,0,0,110,110
"03309",2020,0,0,89,89
"03310",2015,0,0,45,45
"03310",2016,0,0,77,77
"03310",2017,0,0,22,22
"03310",2018,0,0,42,42
"03310",2019,0,0,17,17
"03310",2020,0,0,62,62
"03311",2015,0,0,39,39
"03311",2018,0,0,4,4
"03311",2019,0,0,17,17
"03312",2015,0,0,39,39
"03312",2016,0,0,21,21
"03312",2018,0,0,4,4
"03312",2019,0,0,17,17
"03313",2015,0,0,39,39
"03313",2018,0,0,4,4
"03313",2019,0,0,17,17
"03314",2015,0,0,45,45
"03314",2017,0,0,22,22
"03314",2018,0,0,42,42
"03314",2019,0,0,17,17
"03314",2020,0,0,26,26
"03315",2015,0,0,39,39
"03315",2016,0,0,21,21
"03315",2018,0,0,4,4
"03315",2019,0,0,17,17
"03316",2015,0,0,45,45
"03316",2016,0,0,77,77
"03316",2017,0,0,22,22
"03316",2018,0,0,85,85
"03316",2019,0,0,110,110
"03316",2020,0,0,89,89
"03317",2015,0,0,45,45
"03317",2017,0,0,22,22
"03317",2018,0,0,42,42
"03317",2019,0,0,17,17
"03317",2020,0,0,26,26
"03319",2015,0,0,39,39
"03319",2018,0,0,4,4
"03319",2019,0,0,17,17
"03320",2015,0,0,39,39
"03320",2016,0,0,21,21
"03320",2018,0,0,4,4
"03320",2019,0,0,17,17
"03321",2015,0,0,45,45
"03321",2016,0,0,77,77
"03321",2017,0,0,22,22
"03321",2018,0,0,85,85
"03321",2019,0,0,110,110
"03321",2020,0,0,89,89
"04001",2016,0,0,111,111
"04001",2017,0,0,117,117
"04001",2018,0,0,27,27
"04001",2019,0,0,93,93
"04001",2020,0,107,107,214
"04004",2016,0,0,15,15
"04004",2017,0,0,16,16
"04004",2018,0,0,27,27
"04004",2019,0,0,9,9
"04004",2020,0,107,107,214
"04005",2016,0,0,111,111
"04005",2017,0,0,32,32
"04005",2018,0,0,27,27
"04005",2019,0,0,93,93
"04005",2020,0,107,107,214
"04006",2016,0,0,111,111
"04006",2017,0,0,32,32
"04006",2018,0,0,27,27
"04006",2019,0,0,93,93
"04006",2020,0,107,107,214
"04007",2016,0,0,111,111
"04007",2017,0,0,32,32
"04007",2018,0,0,27,27
"04007",2019,0,0,93,93
"04007",2020,0,107,107,214
"04008",2016,0,0,111,111
"04008",2017,0,0,32,32
"04008",2018,0,0,27,27
"04008",2019,0,0,93,93
"04008",2020,0,107,107,214
"04009",2016,0,0,111,111
"04009",2017,0,0,14,14
"04009",2018,0,0,27,27
"04009",2019,0,0,5,5
"04009",2020,0,107,107,214
"04012",2018,0,0,27,27
"04012",2019,0,0,5,5
"04012",2020,0,107,0,107
"04013",2016,0,0,111,111
"04013",2017,0,0,56,56
"04013",2018,0,0,27,27
"04013",2019,0,0,20,20
"04013",2020,0,107,107,214
"04016",2016,0,0,50,50
"04016",2017,0,0,47,47
"04016",2018,0,0,27,27
"04016",2019,0,0,35,35
"04016",2020,0,107,107,214
"04017",2016,0,0,50,50
"04017",2017,0,0,117,117
"04017",2018,0,0,27,27
"04017",2019,0,0,35,35
"04017",2020,0,107,107,214
"04018",2017,0,0,22,22
"04018",2018,0,0,27,27
"04018",2020,0,107,0,107
"04019",2016,0,0,111,111
"04019",2017,0,0,117,117
"04019",2018,0,0,27,27
"04019",2019,0,0,93,93
"04019",2020,0,107,107,214
"04020",2016,0,0,50,50
"04020",2017,0,0,47,47
"04020",2018,0,0,27,27
"04020",2019,0,0,35,35
"04020",2020,0,107,107,214
"04021",2016,0,0,111,111
"04021",2017,0,0,117,117
"04021",2018,0,0,27,27
"04021",2019,0,0,93,93
"04021",2020,0,107,107,214
"04022",2016,0,0,111,111
"04022",2018,0,0,27,27
"04022",2019,0,0,5,5
"04022",2020,0,107,107,214
"04023",2016,0,0,50,50
"04023",2017,0,0,47,47
"04023",2018,0,0,27,27
"04023",2019,0,0,35,35
"04023",2020,0,107,107,214
"04024",2016,0,0,111,111
"04024",2017,0,0,117,117
"04024",2018,0,0,27,27
"04024",2019,0,0,93,93
"04024",2020,0,107,107,214
"04025",2016,0,0,111,111
"04025",2018,0,0,27,27
"04025",2019,0,0,93,93
"04025",2020,0,107,107,214
"04026",2016,0,0,50,50
"04026",2017,0,0,117,117
"04026",2018,0,0,27,27
"04026",2019,0,0,35,35
"04026",2020,0,107,107,214
"04027",2016,0,0,111,111
"04027",2017,0,0,56,56
"04027",2018,0,0,27,27
"04027",2019,0,0,20,20
"04027",2020,0,107,18,125
"04028",2016,0,0,111,111
"04028",2018,0,0,27,27
"04028",2019,0,0,5,5
"04028",2020,0,107,107,214
"04030",2016,0,0,111,111
"04030",2017,0,0,14,14
"04030",2018,0,0,27,27
"04030",2019,0,0,5,5
"04030",2020,0,107,107,214
"04031",2016,0,0,15,15
"04031",2018,0,0,27,27
"04031",2019,0,0,5,5
"04031",2020,0,107,107,214
"04032",2016,0,0,111,111
"04032",2017,0,0,117,117
"04032",2018,0,0,27,27
"04032",2019,0,0,93,93
"04032",2020,0,107,107,214
"04033",2016,0,0,111,111
"04033",2017,0,0,117,117
"04033",2018,0,0,27,27
"04033",2019,0,0,93,93
"04033",2020,0,107,107,214
"04034",2016,0,0,111,111
"04034",2017,0,0,53,53
"04034",2018,0,0,27,27
"04034",2019,0,0,5,5
"04034",2020,0,107,14,121
"04035",2016,0,0,15,15
"04035",2018,0,0,27,27
"04035",2019,0,0,5,5
"04035",2020,0,107,107,214
"04036",2016,0,0,111,111
"04036",2017,0,0,117,117
"04036",2018,0,0,27,27
"04036",2019,0,0,93,93
"04036",2020,0,107,107,214
"04037",2016,0,0,50,50
"04037",2017,0,0,117,117
"04037",2018,0,0,27,27
"04037",2019,0,0,35,35
"04037",2020,0,107,107,214
"04039",2016,0,0,111,111
"04039",2017,0,0,14,14
"04039",2018,0,0,27,27
"04039",2019,0,0,5,5
"04039",2020,0,107,107,214
"04040",2016,0,0,111,111
"04040",2017,0,0,47,47
"04040",2018,0,0,27,27
"04040",2019,0,0,35,35
"04040",2020,0,107,107,214
"04041",2016,0,0,111,111
"04041",2017,0,0,14,14
"04041",2018,0,0,27,27
"04041",2019,0,0,5,5
"04041",2020,0,107,107,214
"04042",2016,0,0,111,111
"04042",2017,0,0,32,32
"04042",2018,0,0,27,27
"04042",2019,0,0,93,93
"04042",2020,0,107,107,214
"04043",2016,0,0,111,111
"04043",2017,0,0,117,117
"04043",2018,0,0,27,27
"04043",2019,0,0,93,93
"04043",2020,0,107,107,214
"04045",2017,0,0,22,22
"04045",2018,0,0,27,27
"04045",2020,0,107,0,107
"04046",2016,0,0,111,111
"04046",2017,0,0,14,14
"04046",2018,0,0,27,27
"04046",2019,0,0,5,5
"04046",2020,0,107,107,214
"04047",2016,0,0,111,111
"04047",2017,0,0,117,117
"04047",2018,0,0,27,27
"04047",2019,0,0,93,93
"04047",2020,0,107,107,214
"04049",2016,0,0,111,111
"04049",2017,0,0,117,117
"04049",2018,0,0,27,27
"04049",2019,0,0,93,93
"04049",2020,0,107,107,214
"04050",2016,0,0,50,50
"04050",2017,0,0,117,117
"04050",2018,0,0,27,27
"04050",2019,0,0,35,35
"04050",2020,0,107,107,214
"04051",2016,0,0,15,15
"04051",2018,0,0,27,27
"04051",2019,0,0,5,5
"04051",2020,0,107,34,141
"04053",2016,0,0,111,111
"04053",2017,0,0,56,56
"04053",2018,0,0,27,27
"04053",2019,0,0,20,20
"04053",2020,0,107,107,214
"04054",2016,0,0,111,111
"04054",2017,0,0,14,14
"04054",2018,0,0,27,27
"04054",2019,0,0,5,5
"04054",2020,0,107,107,214
"04055",2016,0,0,111,111
"04055",2017,0,0,14,14
"04055",2018,0,0,27,27
"04055",2019,0,0,5,5
"04055",2020,0,107,107,214
"04057",2017,0,0,117,117
"04057",2018,0,0,27,27
"04057",2019,0,0,35,35
"04057",2020,0,107,107,214
"04058",2016,0,0,111,111
"04058",2017,0,0,117,117
"04058",2018,0,0,27,27
"04058",2019,0,0,93,93
"04058",2020,0,107,107,214
"04059",2016,0,0,111,111
"04059",2017,0,0,14,14
"04059",2018,0,0,27,27
"04059",2019,0,0,5,5
"04059",2020,0,107,107,214
"04061",2016,0,0,111,111
"04061",2017,0,0,32,32
"04061",2018,0,0,27,27
"04061",2019,0,0,93,93
"04061",2020,0,107,107,214
"04062",2016,0,0,111,111
"04062",2017,0,0,117,117
"04062",2018,0,0,27,27
"04062",2019,0,0,93,93
"04062",2020,0,107,107,214
"04063",2016,0,0,111,111
"04063",2017,0,0,117,117
"04063",2018,0,0,27,27
"04063",2019,0,0,93,93
"04063",2020,0,107,107,214
"04065",2016,0,0,111,111
"04065",2018,0,0,27,27
"04065",2019,0,0,5,5
"04065",2020,0,107,14,121
"04066",2016,0,0,50,50
"04066",2017,0,0,117,117
"04066",2018,0,0,27,27
"04066",2019,0,0,35,35
"04066",2020,0,107,107,214
"04067",2016,0,0,111,111
"04067",2018,0,0,27,27
"04067",2019,0,0,20,20
"04067",2020,0,107,107,214
"04068",2018,0,0,27,27
"04068",2019,0,0,5,5
"04068",2020,0,107,0,107
"04069",2016,0,0,111,111
"04069",2017,0,0,117,117
"04069",2018,0,0,27,27
"04069",2019,0,0,93,93
"04069",2020,0,107,107,214
"04070",2016,0,0,111,111
"04070",2017,0,0,14,14
"04070",2018,0,0,27,27
"04070",2019,0,0,5,5
"04070",2020,0,107,107,214
"04072",2016,0,0,111,111
"04072",2017,0,0,14,14
"04072",2018,0,0,27,27
"04072",2019,0,0,5,5
"04072",2020,0,107,107,214
"04073",2016,0,0,111,111
"04073",2017,0,0,117,117
"04073",2018,0,0,27,27
"04073",2019,0,0,93,93
"04073",2020,0,107,107,214
"04074",2016,0,0,111,111
"04074",2017,0,0,14,14
"04074",2018,0,0,27,27
"04074",2019,0,0,5,5
"04074",2020,0,107,107,214
"04075",2016,0,0,111,111
"04075",2017,0,0,47,47
"04075",2018,0,0,27,27
"04075",2019,0,0,35,35
"04075",2020,0,107,107,214
"04076",2016,0,0,111,111
"04076",2017,0,0,117,117
"04076",2018,0,0,27,27
"04076",2019,0,0,93,93
"04076",2020,0,107,107,214
"04077",2016,0,0,111,111
"04077",2017,0,0,14,14
"04077",2018,0,0,27,27
"04077",2019,0,0,5,5
"04077",2020,0,107,107,214
"04079",2016,0,0,111,111
"04079",2017,0,0,117,117
"04079",2018,0,0,27,27
"04079",2019,0,0,93,93
"04079",2020,0,107,107,214
"04081",2016,0,0,15,15
"04081",2017,0,0,16,16
"04081",2018,0,0,27,27
"04081",2019,0,0,9,9
"04081",2020,0,107,107,214
"04084",2016,0,0,111,111
"04084",2018,0,0,27,27
"04084",2019,0,0,5,5
"04084",2020,0,107,107,214
"04085",2016,0,0,50,50
"04085",2017,0,0,117,117
"04085",2018,0,0,27,27
"04085",2019,0,0,35,35
"04085",2020,0,107,107,214
"04086",2016,0,0,111,111
"04086",2017,0,0,117,117
"04086",2018,0,0,27,27
"04086",2019,0,0,93,93
"04086",2020,0,107,107,214
"04087",2016,0,0,15,15
"04087",2018,0,0,27,27
"04087",2019,0,0,5,5
"04087",2020,0,107,0,107
"04088",2016,0,0,15,15
"04088",2018,0,0,27,27
"04088",2019,0,0,5,5
"04088",2020,0,107,0,107
"04090",2016,0,0,111,111
"04090",2017,0,0,32,32
"04090",2018,0,0,27,27
"04090",2019,0,0,93,93
"04090",2020,0,107,107,214
"04091",2016,0,0,111,111
"04091",2017,0,0,117,117
"04091",2018,0,0,27,27
"04091",2019,0,0,93,93
"04091",2020,0,107,107,214
"04092",2016,0,0,111,111
"04092",2017,0,0,117,117
"04092",2018,0,0,27,27
"04092",2019,0,0,93,93
"04092",2020,0,107,107,214
"04093",2016,0,0,50,50
"04093",2017,0,0,117,117
"04093",2018,0,0,27,27
"04093",2019,0,0,35,35
"04093",2020,0,107,107,214
"04094",2016,0,0,15,15
"04094",2017,0,0,16,16
"04094",2018,0,0,27,27
"04094",2019,0,0,9,9
"04094",2020,0,107,107,214
"04095",2016,0,0,15,15
"04095",2018,0,0,27,27
"04095",2019,0,0,5,5
"04095",2020,0,107,34,141
"04096",2016,0,0,111,111
"04096",2017,0,0,117,117
"04096",2018,0,0,27,27
"04096",2019,0,0,93,93
"04096",2020,0,107,107,214
"04097",2016,0,0,111,111
"04097",2017,0,0,117,117
"04097",2018,0,0,27,27
"04097",2019,0,0,93,93
"04097",2020,0,107,107,214
"04099",2016,0,0,111,111
"04099",2018,0,0,27,27
"04099",2019,0,0,5,5
"04099",2020,0,107,107,214
"04101",2016,0,0,15,15
"04101",2018,0,0,27,27
"04101",2019,0,0,5,5
"04101",2020,0,107,14,121
"04102",2016,0,0,111,111
"04102",2017,0,0,117,117
"04102",2018,0,0,27,27
"04102",2019,0,0,93,93
"04102",2020,0,107,107,214
"04104",2018,0,0,27,27
"04104",2019,0,0,5,5
"04104",2020,0,107,0,107
"04106",2016,0,0,111,111
"04106",2017,0,0,53,53
"04106",2018,0,0,27,27
"04106",2019,0,0,5,5
"04106",2020,0,107,14,121
"04107",2016,0,0,15,15
"04107",2018,0,0,27,27
"04107",2019,0,0,5,5
"04107",2020,0,107,107,214
"04108",2016,0,0,111,111
"04108",2017,0,0,117,117
"04108",2018,0,0,27,27
"04108",2019,0,0,93,93
"04108",2020,0,107,107,214
"04109",2016,0,0,111,111
"04109",2017,0,0,27,27
"04109",2018,0,0,27,27
"04109",2019,0,0,5,5
"04109",2020,0,107,14,121
"04110",2016,0,0,111,111
"04110",2017,0,0,117,117
"04110",2018,0,0,27,27
"04110",2019,0,0,93,93
"04110",2020,0,107,107,214
"04111",2018,0,0,27,27
"04111",2019,0,0,5,5
"04111",2020,0,107,0,107
"04112",2016,0,0,15,15
"04112",2017,0,0,32,32
"04112",2018,0,0,27,27
"04112",2019,0,0,5,5
"04112",2020,0,107,34,141
"04113",2016,0,0,111,111
"04113",2017,0,0,117,117
"04113",2018,0,0,27,27
"04113",2019,0,0,93,93
"04113",2020,0,107,107,214
"04115",2016,0,0,111,111
"04115",2017,0,0,32,32
"04115",2018,0,0,27,27
"04115",2019,0,0,93,93
"04115",2020,0,107,107,214
"04116",2016,0,0,111,111
"04116",2017,0,0,117,117
"04116",2018,0,0,27,27
"04116",2019,0,0,93,93
"04116",2020,0,107,107,214
"04118",2016,0,0,50,50
"04118",2017,0,0,117,117
"04118",2018,0,0,27,27
"04118",2019,0,0,35,35
"04118",2020,0,107,107,214
"04120",2016,0,0,111,111
"04120",2017,0,0,117,117
"04120",2018,0,0,27,27
"04120",2019,0,0,93,93
"04120",2020,0,107,107,214
"04121",2016,0,0,111,111
"04121",2017,0,0,14,14
"04121",2018,0,0,27,27
"04121",2019,0,0,5,5
"04121",2020,0,107,107,214
"04122",2016,0,0,111,111
"04122",2017,0,0,117,117
"04122",2018,0,0,27,27
"04122",2019,0,0,93,93
"04122",2020,0,107,107,214
"04123",2016,0,0,111,111
"04123",2017,0,0,117,117
"04123",2018,0,0,27,27
"04123",2019,0,0,93,93
"04123",2020,0,107,18,125
"04124",2016,0,0,15,15
"04124",2017,0,0,16,16
"04124",2018,0,0,27,27
"04124",2019,0,0,9,9
"04124",2020,0,107,107,214
"04126",2016,0,0,111,111
"04126",2017,0,0,117,117
"04126",2018,0,0,27,27
"04126",2019,0,0,93,93
"04126",2020,0,107,107,214
"04127",2016,0,0,111,111
"04127",2017,0,0,117,117
"04127",2018,0,0,27,27
"04127",2019,0,0,93,93
"04127",2020,0,107,107,214
"04128",2016,0,0,14,14
"04128",2017,0,0,22,22
"04128",2018,0,0,27,27
"04128",2020,0,107,18,125
"04129",2016,0,0,14,14
"04129",2017,0,0,22,22
"04129",2018,0,0,27,27
"04129",2020,0,107,18,125
"04130",2016,0,0,111,111
"04130",2018,0,0,27,27
"04130",2019,0,0,5,5
"04130",2020,0,107,0,107
"04132",2017,0,0,22,22
"04132",2018,0,0,27,27
"04132",2020,0,107,0,107
"04133",2016,0,0,111,111
"04133",2017,0,0,14,14
"04133",2018,0,0,27,27
"04133",2019,0,0,5,5
"04133",2020,0,107,107,214
"04134",2016,0,0,50,50
"04134",2017,0,0,117,117
"04134",2018,0,0,27,27
"04134",2019,0,0,35,35
"04134",2020,0,107,107,214
"04135",2016,0,0,15,15
"04135",2018,0,0,27,27
"04135",2019,0,0,5,5
"04135",2020,0,107,107,214
"04136",2016,0,0,111,111
"04136",2018,0,0,27,27
"04136",2019,0,0,93,93
"04136",2020,0,107,107,214
"04137",2017,0,0,117,117
"04137",2018,0,0,27,27
"04137",2019,0,0,35,35
"04137",2020,0,107,107,214
"04138",2016,0,0,15,15
"04138",2017,0,0,27,27
"04138",2018,0,0,27,27
"04138",2019,0,0,5,5
"04138",2020,0,107,14,121
"04139",2016,0,0,111,111
"04139",2017,0,0,27,27
"04139",2018,0,0,27,27
"04139",2019,0,0,5,5
"04139",2020,0,107,14,121
"04140",2016,0,0,29,29
"04140",2017,0,0,22,22
"04140",2018,0,0,27,27
"04140",2020,0,107,18,125
"04141",2018,0,0,27,27
"04141",2019,0,0,5,5
"04141",2020,0,107,0,107
"04142",2017,0,0,22,22
"04142",2018,0,0,27,27
"04142",2020,0,107,0,107
"04143",2016,0,0,111,111
"04143",2017,0,0,14,14
"04143",2018,0,0,27,27
"04143",2019,0,0,5,5
"04143",2020,0,107,107,214
"04144",2016,0,0,111,111
"04144",2017,0,0,14,14
"04144",2018,0,0,27,27
"04144",2019,0,0,5,5
"04144",2020,0,107,107,214
"04145",2016,0,0,111,111
"04145",2017,0,0,56,56
"04145",2018,0,0,27,27
"04145",2019,0,0,20,20
"04145",2020,0,107,107,214
"04148",2016,0,0,111,111
"04148",2017,0,0,117,117
"04148",2018,0,0,27,27
"04148",2019,0,0,93,93
"04148",2020,0,107,107,214
"04149",2016,0,0,111,111
"04149",2017,0,0,53,53
"04149",2018,0,0,27,27
"04149",2019,0,0,5,5
"04149",2020,0,107,14,121
"04150",2016,0,0,111,111
"04150",2017,0,0,117,117
"04150",2018,0,0,27,27
"04150",2019,0,0,93,93
"04150",2020,0,107,107,214
"04151",2016,0,0,111,111
"04151",2018,0,0,27,27
"04151",2019,0,0,5,5
"04151",2020,0,107,0,107
"04152",2016,0,0,111,111
"04152",2017,0,0,117,117
"04152",2018,0,0,27,27
"04152",2019,0,0,93,93
"04152",2020,0,107,107,214
"04154",2016,0,0,111,111
"04154",2017,0,0,117,117
"04154",2018,0,0,27,27
"04154",2019,0,0,93,93
"04154",2020,0,107,107,214
"04155",2016,0,0,111,111
"04155",2017,0,0,32,32
"04155",2018,0,0,27,27
"04155",2019,0,0,93,93
"04155",2020,0,107,107,214
"04156",2016,0,0,111,111
"04156",2017,0,0,117,117
"04156",2018,0,0,27,27
"04156",2019,0,0,93,93
"04156",2020,0,107,107,214
"04157",2016,0,0,15,15
"04157",2018,0,0,27,27
"04157",2019,0,0,5,5
"04157",2020,0,107,107,214
"04158",2016,0,0,111,111
"04158",2017,0,0,117,117
"04158",2018,0,0,27,27
"04158",2019,0,0,93,93
"04158",2020,0,107,107,214
"04159",2016,0,0,14,14
"04159",2017,0,0,22,22
"04159",2018,0,0,27,27
"04159",2020,0,107,18,125
"04160",2017,0,0,22,22
"04160",2018,0,0,27,27
"04160",2020,0,107,0,107
"04161",2016,0,0,111,111
"04161",2017,0,0,32,32
"04161",2018,0,0,27,27
"04161",2019,0,0,93,93
"04161",2020,0,107,107,214
"04162",2017,0,0,22,22
"04162",2018,0,0,27,27
"04162",2020,0,107,0,107
"04163",2016,0,0,29,29
"04163",2017,0,0,38,38
"04163",2018,0,0,27,27
"04163",2019,0,0,31,31
"04163",2020,0,107,18,125
"04164",2016,0,0,15,15
"04164",2018,0,0,27,27
"04164",2019,0,0,5,5
"04164",2020,0,107,0,107
"04166",2018,0,0,27,27
"04166",2019,0,0,9,9
"04166",2020,0,107,107,214
"04167",2016,0,0,111,111
"04167",2017,0,0,47,47
"04167",2018,0,0,27,27
"04167",2019,0,0,35,35
"04167",2020,0,107,107,214
"04169",2016,0,0,14,14
"04169",2017,0,0,22,22
"04169",2018,0,0,27,27
"04169",2020,0,107,18,125
"04170",2016,0,0,111,111
"04170",2017,0,0,117,117
"04170",2018,0,0,27,27
"04170",2019,0,0,93,93
"04170",2020,0,107,107,214
"04171",2016,0,0,111,111
"04171",2017,0,0,14,14
"04171",2018,0,0,27,27
"04171",2019,0,0,5,5
"04171",2020,0,107,107,214
"04172",2016,0,0,15,15
"04172",2017,0,0,16,16
"04172",2018,0,0,27,27
"04172",2019,0,0,9,9
"04172",2020,0,107,107,214
"04173",2016,0,0,111,111
"04173",2017,0,0,14,14
"04173",2018,0,0,27,27
"04173",2019,0,0,5,5
"04173",2020,0,107,107,214
"04174",2016,0,0,111,111
"04174",2017,0,0,117,117
"04174",2018,0,0,27,27
"04174",2019,0,0,93,93
"04174",2020,0,107,107,214
"04175",2017,0,0,22,22
"04175",2018,0,0,27,27
"04175",2020,0,107,0,107
"04176",2016,0,0,15,15
"04176",2017,0,0,16,16
"04176",2018,0,0,27,27
"04176",2019,0,0,9,9
"04176",2020,0,107,107,214
"04177",2016,0,0,111,111
"04177",2017,0,0,47,47
"04177",2018,0,0,27,27
"04177",2019,0,0,35,35
"04177",2020,0,107,107,214
"04178",2016,0,0,15,15
"04178",2018,0,0,27,27
"04178",2019,0,0,5,5
"04178",2020,0,107,14,121
"04179",2016,0,0,50,50
"04179",2017,0,0,47,47
"04179",2018,0,0,27,27
"04179",2019,0,0,35,35
"04179",2020,0,107,107,214
"04180",2016,0,0,111,111
"04180",2018,0,0,27,27
"04180",2019,0,0,5,5
"04180",2020,0,107,107,214
"04181",2016,0,0,111,111
"04181",2017,0,0,14,14
"04181",2018,0,0,27,27
"04181",2019,0,0,5,5
"04181",2020,0,107,107,214
"04182",2016,0,0,111,111
"04182",2017,0,0,14,14
"04182",2018,0,0,27,27
"04182",2019,0,0,5,5
"04182",2020,0,107,107,214
"04183",2016,0,0,111,111
"04183",2017,0,0,117,117
"04183",2018,0,0,27,27
"04183",2019,0,0,93,93
"04183",2020,0,107,107,214
"04184",2016,0,0,15,15
"04184",2018,0,0,27,27
"04184",2019,0,0,5,5
"04184",2020,0,107,107,214
"04186",2016,0,0,111,111
"04186",2017,0,0,117,117
"04186",2018,0,0,27,27
"04186",2019,0,0,93,93
"04186",2020,0,107,107,214
"04187",2016,0,0,111,111
"04187",2018,0,0,27,27
"04187",2019,0,0,5,5
"04187",2020,0,107,107,214
"04188",2018,0,0,27,27
"04188",2019,0,0,5,5
"04188",2020,0,107,0,107
"04189",2016,0,0,15,15
"04189",2017,0,0,16,16
"04189",2018,0,0,27,27
"04189",2019,0,0,9,9
"04189",2020,0,107,107,214
"04190",2016,0,0,15,15
"04190",2017,0,0,32,32
"04190",2018,0,0,27,27
"04190",2019,0,0,5,5
"04190",2020,0,107,34,141
"04191",2016,0,0,50,50
"04191",2017,0,0,117,117
"04191",2018,0,0,27,27
"04191",2019,0,0,35,35
"04191",2020,0,107,107,214
"04192",2018,0,0,27,27
"04192",2019,0,0,5,5
"04192",2020,0,107,0,107
"04193",2016,0,0,111,111
"04193",2017,0,0,117,117
"04193",2018,0,0,27,27
"04193",2019,0,0,93,93
"04193",2020,0,107,107,214
"04194",2016,0,0,111,111
"04194",2017,0,0,117,117
"04194",2018,0,0,27,27
"04194",2019,0,0,93,93
"04194",2020,0,107,107,214
"04195",2016,0,0,111,111
"04195",2017,0,0,117,117
"04195",2018,0,0,27,27
"04195",2019,0,0,93,93
"04195",2020,0,107,107,214
"04197",2016,0,0,111,111
"04197",2017,0,0,117,117
"04197",2018,0,0,27,27
"04197",2019,0,0,93,93
"04197",2020,0,107,107,214
"04199",2016,0,0,111,111
"04199",2018,0,0,27,27
"04199",2019,0,0,5,5
"04199",2020,0,107,14,121
"04200",2016,0,0,111,111
"04200",2017,0,0,47,47
"04200",2018,0,0,27,27
"04200",2019,0,0,35,35
"04200",2020,0,107,107,214
"04201",2018,0,0,27,27
"04201",2019,0,0,5,5
"04201",2020,0,107,0,107
"04202",2016,0,0,111,111
"04202",2017,0,0,117,117
"04202",2018,0,0,27,27
"04202",2019,0,0,93,93
"04202",2020,0,107,107,214
"04203",2016,0,0,50,50
"04203",2017,0,0,117,117
"04203",2018,0,0,27,27
"04203",2019,0,0,35,35
"04203",2020,0,107,107,214
"04204",2016,0,0,111,111
"04204",2017,0,0,14,14
"04204",2018,0,0,27,27
"04204",2019,0,0,5,5
"04204",2020,0,107,107,214
"04205",2016,0,0,111,111
"04205",2017,0,0,117,117
"04205",2018,0,0,27,27
"04205",2019,0,0,93,93
"04205",2020,0,107,107,214
"04206",2016,0,0,111,111
"04206",2017,0,0,53,53
"04206",2018,0,0,27,27
"04206",2019,0,0,5,5
"04206",2020,0,107,14,121
"04207",2016,0,0,50,50
"04207",2017,0,0,117,117
"04207",2018,0,0,27,27
"04207",2019,0,0,35,35
"04207",2020,0,107,107,214
"04208",2016,0,0,29,29
"04208",2017,0,0,38,38
"04208",2018,0,0,27,27
"04208",2019,0,0,31,31
"04208",2020,0,107,18,125
"04209",2016,0,0,111,111
"04209",2017,0,0,56,56
"04209",2018,0,0,27,27
"04209",2019,0,0,20,20
"04209",2020,0,107,18,125
"04210",2016,0,0,111,111
"04210",2017,0,0,117,117
"04210",2018,0,0,27,27
"04210",2019,0,0,93,93
"04210",2020,0,107,107,214
"04211",2016,0,0,111,111
"04211",2017,0,0,47,47
"04211",2018,0,0,27,27
"04211",2019,0,0,35,35
"04211",2020,0,107,107,214
"04214",2016,0,0,111,111
"04214",2017,0,0,14,14
"04214",2018,0,0,27,27
"04214",2019,0,0,5,5
"04214",2020,0,107,107,214
"04216",2016,0,0,111,111
"04216",2017,0,0,117,117
"04216",2018,0,0,27,27
"04216",2019,0,0,93,93
"04216",2020,0,107,107,214
"04217",2016,0,0,111,111
"04217",2017,0,0,47,47
"04217",2018,0,0,27,27
"04217",2019,0,0,35,35
"04217",2020,0,107,107,214
"04218",2016,0,0,111,111
"04218",2017,0,0,14,14
"04218",2018,0,0,27,27
"04218",2019,0,0,5,5
"04218",2020,0,107,107,214
"04219",2016,0,0,111,111
"04219",2017,0,0,32,32
"04219",2018,0,0,27,27
"04219",2019,0,0,93,93
"04219",2020,0,107,107,214
"04220",2016,0,0,111,111
"04220",2017,0,0,117,117
"04220",2018,0,0,27,27
"04220",2019,0,0,93,93
"04220",2020,0,107,107,214
"04222",2016,0,0,50,50
"04222",2017,0,0,117,117
"04222",2018,0,0,27,27
"04222",2019,0,0,35,35
"04222",2020,0,107,107,214
"04224",2016,0,0,111,111
"04224",2017,0,0,117,117
"04224",2018,0,0,27,27
"04224",2019,0,0,93,93
"04224",2020,0,107,107,214
"04226",2016,0,0,111,111
"04226",2017,0,0,32,32
"04226",2018,0,0,27,27
"04226",2019,0,0,93,93
"04226",2020,0,107,107,214
"04227",2017,0,0,22,22
"04227",2018,0,0,27,27
"04227",2020,0,107,0,107
"04228",2016,0,0,50,50
"04228",2017,0,0,47,47
"04228",2018,0,0,27,27
"04228",2019,0,0,35,35
"04228",2020,0,107,107,214
"04229",2016,0,0,111,111
"04229",2017,0,0,27,27
"04229",2018,0,0,27,27
"04229",2019,0,0,5,5
"04229",2020,0,107,14,121
"04230",2016,0,0,15,15
"04230",2018,0,0,27,27
"04230",2019,0,0,5,5
"04230",2020,0,107,107,214
"04231",2016,0,0,50,50
"04231",2017,0,0,117,117
"04231",2018,0,0,27,27
"04231",2019,0,0,35,35
"04231",2020,0,107,107,214
"04233",2016,0,0,50,50
"04233",2017,0,0,117,117
"04233",2018,0,0,27,27
"04233",2019,0,0,35,35
"04233",2020,0,107,107,214
"04234",2016,0,0,50,50
"04234",2017,0,0,117,117
"04234",2018,0,0,27,27
"04234",2019,0,0,35,35
"04234",2020,0,107,107,214
"04235",2016,0,0,111,111
"04235",2017,0,0,117,117
"04235",2018,0,0,27,27
"04235",2019,0,0,93,93
"04235",2020,0,107,107,214
"04236",2016,0,0,111,111
"04236",2017,0,0,32,32
"04236",2018,0,0,27,27
"04236",2019,0,0,93,93
"04236",2020,0,107,107,214
"04237",2016,0,0,111,111
"04237",2017,0,0,117,117
"04237",2018,0,0,27,27
"04237",2019,0,0,93,93
"04237",2020,0,107,107,214
"04240",2016,0,0,111,111
"04240",2017,0,0,32,32
"04240",2018,0,0,27,27
"04240",2019,0,0,93,93
"04240",2020,0,107,107,214
"04241",2016,0,0,15,15
"04241",2017,0,0,32,32
"04241",2018,0,0,27,27
"04241",2019,0,0,5,5
"04241",2020,0,107,34,141
"04242",2016,0,0,15,15
"04242",2017,0,0,14,14
"04242",2018,0,0,27,27
"04242",2019,0,0,5,5
"04242",2020,0,107,14,121
"04244",2016,0,0,111,111
"04244",2017,0,0,47,47
"04244",2018,0,0,27,27
"04244",2019,0,0,35,35
"04244",2020,0,107,107,214
"04245",2016,0,0,15,15
"04245",2017,0,0,32,32
"04245",2018,0,0,27,27
"04245",2019,0,0,5,5
"04245",2020,0,107,34,141
"05001",2018,0,0,64,64
"05001",2019,0,0,96,96
"05003",2018,0,0,64,64
"05003",2019,0,0,96,96
"05004",2014,0,0,110,110
"05004",2015,0,0,77,77
"05004",2016,0,0,7,7
"05004",2017,0,0,13,13
"05004",2018,0,0,64,64
"05004",2019,0,0,23,23
"05004",2020,0,0,36,36
"05006",2014,0,0,110,110
"05006",2015,0,0,77,77
"05006",2016,0,0,7,7
"05006",2017,0,0,13,13
"05006",2018,0,0,64,64
"05006",2019,0,0,23,23
"05006",2020,0,0,36,36
"05007",2018,0,0,64,64
"05007",2019,0,0,96,96
"05008",2014,0,0,110,110
"05008",2015,0,0,77,77
"05008",2016,0,0,23,23
"05008",2017,0,0,13,13
"05008",2018,0,0,64,64
"05008",2019,0,0,23,23
"05008",2020,0,0,13,13
"05009",2018,0,0,64,64
"05009",2019,0,0,96,96
"05010",2014,0,0,110,110
"05010",2015,0,0,77,77
"05010",2016,0,0,23,23
"05010",2017,0,0,13,13
"05010",2018,0,0,64,64
"05010",2019,0,0,23,23
"05010",2020,0,0,13,13
"05011",2014,0,0,110,110
"05011",2015,0,0,77,77
"05011",2016,0,0,7,7
"05011",2017,0,0,13,13
"05011",2018,0,0,64,64
"05011",2019,0,0,23,23
"05011",2020,0,0,36,36
"05012",2018,0,0,64,64
"05012",2019,0,0,96,96
"05013",2015,0,0,77,77
"05013",2016,0,0,23,23
"05013",2017,0,0,13,13
"05013",2018,0,0,64,64
"05013",2019,0,0,23,23
"05013",2020,0,0,13,13
"05014",2014,0,0,110,110
"05014",2015,0,0,77,77
"05014",2016,0,0,23,23
"05014",2017,0,0,13,13
"05014",2018,0,0,64,64
"05014",2019,0,0,23,23
"05014",2020,0,0,13,13
"05016",2014,0,0,110,110
"05016",2015,0,0,77,77
"05016",2016,0,0,23,23
"05016",2017,0,0,13,13
"05016",2018,0,0,64,64
"05016",2019,0,0,23,23
"05016",2020,0,0,13,13
"05017",2014,0,0,110,110
"05017",2015,0,0,77,77
"05017",2016,0,0,7,7
"05017",2017,0,0,13,13
"05017",2018,0,0,64,64
"05017",2019,0,0,23,23
"05017",2020,0,0,36,36
"05018",2014,0,0,110,110
"05018",2015,0,0,77,77
"05018",2016,0,0,7,7
"05018",2017,0,0,13,13
"05018",2018,0,0,64,64
"05018",2019,0,0,23,23
"05018",2020,0,0,36,36
"05019",2014,0,0,110,110
"05019",2015,0,0,77,77
"05019",2016,0,0,23,23
"05019",2017,0,0,13,13
"05019",2018,0,0,64,64
"05019",2019,0,0,23,23
"05019",2020,0,0,13,13
"05021",2014,0,0,110,110
"05021",2015,0,0,77,77
"05021",2016,0,0,23,23
"05021",2017,0,0,13,13
"05021",2018,0,0,64,64
"05021",2019,0,0,23,23
"05021",2020,0,0,13,13
"05022",2015,0,0,77,77
"05022",2018,0,0,64,64
"05022",2019,0,0,96,96
"05023",2018,0,0,64,64
"05023",2019,0,0,96,96
"05024",2014,0,0,25,25
"05024",2015,0,0,64,64
"05024",2016,0,0,23,23
"05024",2017,0,0,13,13
"05024",2018,0,0,64,64
"05024",2019,0,0,23,23
"05024",2020,0,0,13,13
"05025",2014,0,0,110,110
"05025",2015,0,0,77,77
"05025",2016,0,0,7,7
"05025",2017,0,0,13,13
"05025",2018,0,0,64,64
"05025",2019,0,0,23,23
"05025",2020,0,0,36,36
"05026",2018,0,0,64,64
"05026",2019,0,0,96,96
"05027",2018,0,0,64,64
"05027",2019,0,0,96,96
"05028",2014,0,0,110,110
"05028",2015,0,0,77,77
"05028",2016,0,0,23,23
"05028",2017,0,0,13,13
"05028",2018,0,0,64,64
"05028",2019,0,0,23,23
"05028",2020,0,0,13,13
"05029",2014,0,0,110,110
"05029",2015,0,0,77,77
"05029",2016,0,0,7,7
"05029",2017,0,0,13,13
"05029",2018,0,0,64,64
"05029",2019,0,0,23,23
"05029",2020,0,0,36,36
"05031",2018,0,0,64,64
"05031",2019,0,0,96,96
"05032",2014,0,0,110,110
"05032",2015,0,0,77,77
"05032",2016,0,0,7,7
"05032",2017,0,0,13,13
"05032",2018,0,0,64,64
"05032",2019,0,0,23,23
"05032",2020,0,0,36,36
"05033",2014,0,0,110,110
"05033",2015,0,0,77,77
"05033",2016,0,0,23,23
"05033",2017,0,0,13,13
"05033",2018,0,0,64,64
"05033",2019,0,0,23,23
"05033",2020,0,0,13,13
"05035",2014,0,0,110,110
"05035",2015,0,0,77,77
"05035",2016,0,0,23,23
"05035",2017,0,0,13,13
"05035",2018,0,0,64,64
"05035",2019,0,0,23,23
"05035",2020,0,0,13,13
"05036",2014,0,0,110,110
"05036",2015,0,0,77,77
"05036",2016,0,0,7,7
"05036",2017,0,0,13,13
"05036",2018,0,0,64,64
"05036",2019,0,0,23,23
"05036",2020,0,0,36,36
"05037",2014,0,0,110,110
"05037",2015,0,0,77,77
"05037",2016,0,0,7,7
"05037",2017,0,0,13,13
"05037",2018,0,0,64,64
"05037",2019,0,0,23,23
"05037",2020,0,0,36,36
"05038",2018,0,0,64,64
"05038",2019,0,0,96,96
"05039",2018,0,0,64,64
"05039",2019,0,0,96,96
"05040",2014,0,0,110,110
"05040",2015,0,0,77,77
"05040",2016,0,0,7,7
"05040",2017,0,0,13,13
"05040",2018,0,0,64,64
"05040",2019,0,0,23,23
"05040",2020,0,0,36,36
"05044",2018,0,0,64,64
"05044",2019,0,0,96,96
"05045",2018,0,0,64,64
"05045",2019,0,0,96,96
"05046",2018,0,0,64,64
"05046",2019,0,0,96,96
"05047",2014,0,0,110,110
"05047",2015,0,0,77,77
"05047",2016,0,0,23,23
"05047",2017,0,0,13,13
"05047",2018,0,0,64,64
"05047",2019,0,0,23,23
"05047",2020,0,0,13,13
"05048",2014,0,0,25,25
"05048",2015,0,0,64,64
"05048",2016,0,0,23,23
"05048",2017,0,0,13,13
"05048",2018,0,0,64,64
"05048",2019,0,0,23,23
"05048",2020,0,0,13,13
"05049",2014,0,0,110,110
"05049",2015,0,0,77,77
"05049",2016,0,0,23,23
"05049",2017,0,0,13,13
"05049",2018,0,0,64,64
"05049",2019,0,0,23,23
"05049",2020,0,0,13,13
"05050",2014,0,0,110,110
"05050",2015,0,0,77,77
"05050",2016,0,0,7,7
"05050",2017,0,0,13,13
"05050",2018,0,0,64,64
"05050",2019,0,0,23,23
"05050",2020,0,0,36,36
"05051",2014,0,0,110,110
"05051",2015,0,0,77,77
"05051",2016,0,0,23,23
"05051",2017,0,0,13,13
"05051",2018,0,0,64,64
"05051",2019,0,0,23,23
"05051",2020,0,0,13,13
"05052",2018,0,0,64,64
"05052",2019,0,0,96,96
"05053",2014,0,0,110,110
"05053",2015,0,0,77,77
"05053",2016,0,0,23,23
"05053",2017,0,0,13,13
"05053",2018,0,0,64,64
"05053",2019,0,0,23,23
"05053",2020,0,0,13,13
"05054",2014,0,0,110,110
"05054",2015,0,0,77,77
"05054",2016,0,0,23,23
"05054",2017,0,0,13,13
"05054",2018,0,0,64,64
"05054",2019,0,0,23,23
"05054",2020,0,0,13,13
"05055",2014,0,0,110,110
"05055",2015,0,0,77,77
"05055",2016,0,0,23,23
"05055",2017,0,0,13,13
"05055",2018,0,0,64,64
"05055",2019,0,0,23,23
"05055",2020,0,0,13,13
"05056",2014,0,0,110,110
"05056",2015,0,0,77,77
"05056",2016,0,0,7,7
"05056",2017,0,0,13,13
"05056",2018,0,0,64,64
"05056",2019,0,0,23,23
"05056",2020,0,0,36,36
"05057",2014,0,0,110,110
"05057",2015,0,0,77,77
"05057",2016,0,0,7,7
"05057",2017,0,0,13,13
"05057",2018,0,0,64,64
"05057",2019,0,0,23,23
"05057",2020,0,0,36,36
"05058",2014,0,0,110,110
"05058",2015,0,0,77,77
"05058",2016,0,0,7,7
"05058",2017,0,0,13,13
"05058",2018,0,0,64,64
"05058",2019,0,0,23,23
"05058",2020,0,0,36,36
"05059",2014,0,0,110,110
"05059",2015,0,0,77,77
"05059",2016,0,0,23,23
"05059",2017,0,0,13,13
"05059",2018,0,0,64,64
"05059",2019,0,0,23,23
"05059",2020,0,0,13,13
"05060",2014,0,0,110,110
"05060",2015,0,0,77,77
"05060",2016,0,0,23,23
"05060",2017,0,0,13,13
"05060",2018,0,0,64,64
"05060",2019,0,0,23,23
"05060",2020,0,0,13,13
"05061",2014,0,0,110,110
"05061",2015,0,0,77,77
"05061",2016,0,0,23,23
"05061",2017,0,0,13,13
"05061",2018,0,0,64,64
"05061",2019,0,0,23,23
"05061",2020,0,0,13,13
"05062",2018,0,0,64,64
"05062",2019,0,0,96,96
"05063",2018,0,0,64,64
"05063",2019,0,0,96,96
"05064",2014,0,0,110,110
"05064",2015,0,0,77,77
"05064",2016,0,0,7,7
"05064",2017,0,0,13,13
"05064",2018,0,0,64,64
"05064",2019,0,0,23,23
"05064",2020,0,0,36,36
"05065",2018,0,0,64,64
"05065",2019,0,0,96,96
"05066",2014,0,0,110,110
"05066",2015,0,0,77,77
"05066",2016,0,0,23,23
"05066",2017,0,0,13,13
"05066",2018,0,0,64,64
"05066",2019,0,0,23,23
"05066",2020,0,0,13,13
"05068",2014,0,0,110,110
"05068",2015,0,0,77,77
"05068",2016,0,0,7,7
"05068",2017,0,0,13,13
"05068",2018,0,0,64,64
"05068",2019,0,0,23,23
"05068",2020,0,0,36,36
"05070",2014,0,0,110,110
"05070",2015,0,0,77,77
"05070",2016,0,0,23,23
"05070",2017,0,0,13,13
"05070",2018,0,0,64,64
"05070",2019,0,0,23,23
"05070",2020,0,0,13,13
"05071",2014,0,0,110,110
"05071",2015,0,0,77,77
"05071",2016,0,0,7,7
"05071",2017,0,0,13,13
"05071",2018,0,0,64,64
"05071",2019,0,0,23,23
"05071",2020,0,0,36,36
"05072",2014,0,0,110,110
"05072",2015,0,0,77,77
"05072",2016,0,0,23,23
"05072",2017,0,0,13,13
"05072",2018,0,0,64,64
"05072",2019,0,0,23,23
"05072",2020,0,0,13,13
"05073",2014,0,0,110,110
"05073",2015,0,0,77,77
"05073",2016,0,0,23,23
"05073",2017,0,0,13,13
"05073",2018,0,0,64,64
"05073",2019,0,0,23,23
"05073",2020,0,0,13,13
"05074",2014,0,0,110,110
"05074",2015,0,0,77,77
"05074",2016,0,0,7,7
"05074",2017,0,0,13,13
"05074",2018,0,0,64,64
"05074",2019,0,0,23,23
"05074",2020,0,0,36,36
"05075",2014,0,0,110,110
"05075",2015,0,0,77,77
"05075",2016,0,0,23,23
"05075",2017,0,0,13,13
"05075",2018,0,0,64,64
"05075",2019,0,0,23,23
"05075",2020,0,0,13,13
"05076",2014,0,0,110,110
"05076",2015,0,0,77,77
"05076",2016,0,0,23,23
"05076",2017,0,0,13,13
"05076",2018,0,0,64,64
"05076",2019,0,0,23,23
"05076",2020,0,0,13,13
"05077",2018,0,0,64,64
"05077",2019,0,0,96,96
"05078",2015,0,0,77,77
"05078",2018,0,0,64,64
"05078",2019,0,0,96,96
"05079",2018,0,0,64,64
"05079",2019,0,0,96,96
"05080",2014,0,0,110,110
"05080",2015,0,0,77,77
"05080",2016,0,0,23,23
"05080",2017,0,0,13,13
"05080",2018,0,0,64,64
"05080",2019,0,0,23,23
"05080",2020,0,0,13,13
"05081",2014,0,0,110,110
"05081",2015,0,0,77,77
"05081",2016,0,0,23,23
"05081",2017,0,0,13,13
"05081",2018,0,0,64,64
"05081",2019,0,0,23,23
"05081",2020,0,0,13,13
"05082",2018,0,0,64,64
"05082",2019,0,0,96,96
"05084",2014,0,0,110,110
"05084",2015,0,0,77,77
"05084",2016,0,0,7,7
"05084",2017,0,0,13,13
"05084",2018,0,0,64,64
"05084",2019,0,0,23,23
"05084",2020,0,0,36,36
"05085",2018,0,0,64,64
"05085",2019,0,0,96,96
"05086",2014,0,0,25,25
"05086",2015,0,0,64,64
"05086",2016,0,0,23,23
"05086",2017,0,0,13,13
"05086",2018,0,0,64,64
"05086",2019,0,0,23,23
"05086",2020,0,0,13,13
"05087",2014,0,0,110,110
"05087",2015,0,0,77,77
"05087",2016,0,0,23,23
"05087",2017,0,0,13,13
"05087",2018,0,0,64,64
"05087",2019,0,0,23,23
"05087",2020,0,0,13,13
"05089",2014,0,0,110,110
"05089",2015,0,0,77,77
"05089",2016,0,0,23,23
"05089",2017,0,0,13,13
"05089",2018,0,0,64,64
"05089",2019,0,0,23,23
"05089",2020,0,0,13,13
"05090",2014,0,0,110,110
"05090",2015,0,0,77,77
"05090",2016,0,0,7,7
"05090",2017,0,0,13,13
"05090",2018,0,0,64,64
"05090",2019,0,0,23,23
"05090",2020,0,0,36,36
"05091",2016,0,0,23,23
"05091",2017,0,0,13,13
"05091",2018,0,0,64,64
"05091",2019,0,0,23,23
"05091",2020,0,0,13,13
"05092",2014,0,0,110,110
"05092",2015,0,0,77,77
"05092",2016,0,0,7,7
"05092",2017,0,0,13,13
"05092",2018,0,0,64,64
"05092",2019,0,0,23,23
"05092",2020,0,0,36,36
"05093",2018,0,0,64,64
"05093",2019,0,0,96,96
"05094",2014,0,0,110,110
"05094",2015,0,0,77,77
"05094",2016,0,0,23,23
"05094",2017,0,0,13,13
"05094",2018,0,0,64,64
"05094",2019,0,0,23,23
"05094",2020,0,0,13,13
"05095",2014,0,0,110,110
"05095",2015,0,0,77,77
"05095",2016,0,0,23,23
"05095",2017,0,0,13,13
"05095",2018,0,0,64,64
"05095",2019,0,0,23,23
"05095",2020,0,0,13,13
"05096",2014,0,0,110,110
"05096",2015,0,0,77,77
"05096",2016,0,0,7,7
"05096",2017,0,0,13,13
"05096",2018,0,0,64,64
"05096",2019,0,0,23,23
"05096",2020,0,0,36,36
"05097",2014,0,0,110,110
"05097",2015,0,0,77,77
"05097",2016,0,0,23,23
"05097",2017,0,0,13,13
"05097",2018,0,0,64,64
"05097",2019,0,0,23,23
"05097",2020,0,0,13,13
"05098",2018,0,0,64,64
"05098",2019,0,0,96,96
"05099",2014,0,0,110,110
"05099",2015,0,0,77,77
"05099",2016,0,0,23,23
"05099",2017,0,0,13,13
"05099",2018,0,0,64,64
"05099",2019,0,0,23,23
"05099",2020,0,0,13,13
"05100",2014,0,0,110,110
"05100",2015,0,0,77,77
"05100",2016,0,0,23,23
"05100",2017,0,0,13,13
"05100",2018,0,0,64,64
"05100",2019,0,0,23,23
"05100",2020,0,0,13,13
"05101",2014,0,0,110,110
"05101",2015,0,0,77,77
"05101",2016,0,0,7,7
"05101",2017,0,0,13,13
"05101",2018,0,0,64,64
"05101",2019,0,0,23,23
"05101",2020,0,0,36,36
"05102",2014,0,0,110,110
"05102",2015,0,0,77,77
"05102",2016,0,0,23,23
"05102",2017,0,0,13,13
"05102",2018,0,0,64,64
"05102",2019,0,0,23,23
"05102",2020,0,0,13,13
"05103",2015,0,0,77,77
"05103",2016,0,0,23,23
"05103",2017,0,0,13,13
"05103",2018,0,0,64,64
"05103",2019,0,0,23,23
"05103",2020,0,0,13,13
"05104",2014,0,0,110,110
"05104",2015,0,0,77,77
"05104",2016,0,0,23,23
"05104",2017,0,0,13,13
"05104",2018,0,0,64,64
"05104",2019,0,0,23,23
"05104",2020,0,0,13,13
"05106",2014,0,0,110,110
"05106",2015,0,0,77,77
"05106",2016,0,0,7,7
"05106",2017,0,0,13,13
"05106",2018,0,0,64,64
"05106",2019,0,0,23,23
"05106",2020,0,0,36,36
"05107",2018,0,0,64,64
"05107",2019,0,0,96,96
"05108",2018,0,0,64,64
"05108",2019,0,0,96,96
"05109",2018,0,0,64,64
"05109",2019,0,0,96,96
"05110",2018,0,0,64,64
"05110",2019,0,0,96,96
"05111",2018,0,0,64,64
"05111",2019,0,0,96,96
"05112",2014,0,0,110,110
"05112",2015,0,0,77,77
"05112",2016,0,0,23,23
"05112",2017,0,0,13,13
"05112",2018,0,0,64,64
"05112",2019,0,0,23,23
"05112",2020,0,0,13,13
"05113",2014,0,0,110,110
"05113",2015,0,0,77,77
"05113",2016,0,0,7,7
"05113",2017,0,0,13,13
"05113",2018,0,0,64,64
"05113",2019,0,0,23,23
"05113",2020,0,0,36,36
"05114",2014,0,0,110,110
"05114",2015,0,0,77,77
"05114",2016,0,0,7,7
"05114",2017,0,0,13,13
"05114",2018,0,0,64,64
"05114",2019,0,0,23,23
"05114",2020,0,0,36,36
"05115",2014,0,0,110,110
"05115",2015,0,0,77,77
"05115",2016,0,0,7,7
"05115",2017,0,0,13,13
"05115",2018,0,0,64,64
"05115",2019,0,0,23,23
"05115",2020,0,0,36,36
"05116",2018,0,0,64,64
"05116",2019,0,0,96,96
"05117",2014,0,0,25,25
"05117",2015,0,0,64,64
"05117",2016,0,0,23,23
"05117",2017,0,0,13,13
"05117",2018,0,0,64,64
"05117",2019,0,0,23,23
"05117",2020,0,0,13,13
"05118",2014,0,0,110,110
"05118",2015,0,0,77,77
"05118",2016,0,0,23,23
"05118",2017,0,0,13,13
"05118",2018,0,0,64,64
"05118",2019,0,0,23,23
"05118",2020,0,0,13,13
"05119",2018,0,0,64,64
"05119",2019,0,0,96,96
"05121",2015,0,0,77,77
"05121",2018,0,0,64,64
"05121",2019,0,0,96,96
"05122",2018,0,0,64,64
"05122",2019,0,0,96,96
"05123",2014,0,0,110,110
"05123",2015,0,0,77,77
"05123",2016,0,0,23,23
"05123",2017,0,0,13,13
"05123",2018,0,0,64,64
"05123",2019,0,0,23,23
"05123",2020,0,0,13,13
"05124",2014,0,0,110,110
"05124",2015,0,0,77,77
"05124",2016,0,0,7,7
"05124",2017,0,0,13,13
"05124",2018,0,0,64,64
"05124",2019,0,0,23,23
"05124",2020,0,0,36,36
"05126",2016,0,0,23,23
"05126",2017,0,0,13,13
"05126",2018,0,0,64,64
"05126",2019,0,0,23,23
"05126",2020,0,0,13,13
"05127",2014,0,0,110,110
"05127",2015,0,0,77,77
"05127",2016,0,0,7,7
"05127",2017,0,0,13,13
"05127",2018,0,0,64,64
"05127",2019,0,0,23,23
"05127",2020,0,0,36,36
"05128",2018,0,0,64,64
"05128",2019,0,0,96,96
"05129",2016,0,0,23,23
"05129",2017,0,0,13,13
"05129",2018,0,0,64,64
"05129",2019,0,0,23,23
"05129",2020,0,0,13,13
"05130",2018,0,0,64,64
"05130",2019,0,0,96,96
"05131",2014,0,0,110,110
"05131",2015,0,0,77,77
"05131",2016,0,0,23,23
"05131",2017,0,0,13,13
"05131",2018,0,0,64,64
"05131",2019,0,0,23,23
"05131",2020,0,0,13,13
"05132",2014,0,0,110,110
"05132",2015,0,0,77,77
"05132",2016,0,0,7,7
"05132",2017,0,0,13,13
"05132",2018,0,0,64,64
"05132",2019,0,0,23,23
"05132",2020,0,0,36,36
"05133",2018,0,0,64,64
"05133",2019,0,0,96,96
"05134",2018,0,0,64,64
"05134",2019,0,0,96,96
"05135",2014,0,0,110,110
"05135",2015,0,0,77,77
"05135",2016,0,0,23,23
"05135",2017,0,0,13,13
"05135",2018,0,0,64,64
"05135",2019,0,0,23,23
"05135",2020,0,0,13,13
"05136",2018,0,0,64,64
"05136",2019,0,0,96,96
"05139",2014,0,0,110,110
"05139",2015,0,0,77,77
"05139",2016,0,0,23,23
"05139",2017,0,0,13,13
"05139",2018,0,0,64,64
"05139",2019,0,0,23,23
"05139",2020,0,0,13,13
"05140",2014,0,0,110,110
"05140",2015,0,0,77,77
"05140",2016,0,0,7,7
"05140",2017,0,0,13,13
"05140",2018,0,0,64,64
"05140",2019,0,0,23,23
"05140",2020,0,0,36,36
"05142",2018,0,0,64,64
"05142",2019,0,0,96,96
"05144",2018,0,0,64,64
"05144",2019,0,0,96,96
"05145",2014,0,0,110,110
"05145",2015,0,0,77,77
"05145",2016,0,0,7,7
"05145",2017,0,0,13,13
"05145",2018,0,0,64,64
"05145",2019,0,0,23,23
"05145",2020,0,0,36,36
"05146",2014,0,0,110,110
"05146",2015,0,0,77,77
"05146",2016,0,0,23,23
"05146",2017,0,0,13,13
"05146",2018,0,0,64,64
"05146",2019,0,0,23,23
"05146",2020,0,0,13,13
"05147",2014,0,0,110,110
"05147",2015,0,0,77,77
"05147",2016,0,0,7,7
"05147",2017,0,0,13,13
"05147",2018,0,0,64,64
"05147",2019,0,0,23,23
"05147",2020,0,0,36,36
"05148",2014,0,0,110,110
"05148",2015,0,0,77,77
"05148",2016,0,0,7,7
"05148",2017,0,0,13,13
"05148",2018,0,0,64,64
"05148",2019,0,0,23,23
"05148",2020,0,0,36,36
"05149",2014,0,0,110,110
"05149",2015,0,0,77,77
"05149",2016,0,0,7,7
"05149",2017,0,0,13,13
"05149",2018,0,0,64,64
"05149",2019,0,0,23,23
"05149",2020,0,0,36,36
"05151",2018,0,0,64,64
"05151",2019,0,0,96,96
"05152",2018,0,0,64,64
"05152",2019,0,0,96,96
"05153",2014,0,0,110,110
"05153",2015,0,0,77,77
"05153",2016,0,0,7,7
"05153",2017,0,0,13,13
"05153",2018,0,0,64,64
"05153",2019,0,0,23,23
"05153",2020,0,0,36,36
"05154",2014,0,0,110,110
"05154",2015,0,0,77,77
"05154",2016,0,0,23,23
"05154",2017,0,0,13,13
"05154",2018,0,0,64,64
"05154",2019,0,0,23,23
"05154",2020,0,0,13,13
"05155",2014,0,0,110,110
"05155",2015,0,0,77,77
"05155",2016,0,0,23,23
"05155",2017,0,0,13,13
"05155",2018,0,0,64,64
"05155",2019,0,0,23,23
"05155",2020,0,0,13,13
"05156",2018,0,0,64,64
"05156",2019,0,0,96,96
"05157",2018,0,0,64,64
"05157",2019,0,0,96,96
"05158",2014,0,0,110,110
"05158",2015,0,0,77,77
"05158",2016,0,0,23,23
"05158",2017,0,0,13,13
"05158",2018,0,0,64,64
"05158",2019,0,0,23,23
"05158",2020,0,0,13,13
"05159",2014,0,0,110,110
"05159",2015,0,0,77,77
"05159",2016,0,0,23,23
"05159",2017,0,0,13,13
"05159",2018,0,0,64,64
"05159",2019,0,0,23,23
"05159",2020,0,0,13,13
"05160",2014,0,0,110,110
"05160",2015,0,0,77,77
"05160",2016,0,0,23,23
"05160",2017,0,0,13,13
"05160",2018,0,0,64,64
"05160",2019,0,0,23,23
"05160",2020,0,0,13,13
"05161",2018,0,0,64,64
"05161",2019,0,0,96,96
"05162",2014,0,0,110,110
"05162",2015,0,0,77,77
"05162",2016,0,0,7,7
"05162",2017,0,0,13,13
"05162",2018,0,0,64,64
"05162",2019,0,0,23,23
"05162",2020,0,0,36,36
"05163",2014,0,0,110,110
"05163",2015,0,0,77,77
"05163",2016,0,0,7,7
"05163",2017,0,0,13,13
"05163",2018,0,0,64,64
"05163",2019,0,0,23,23
"05163",2020,0,0,36,36
"05164",2018,0,0,64,64
"05164",2019,0,0,96,96
"05165",2014,0,0,110,110
"05165",2015,0,0,77,77
"05165",2016,0,0,23,23
"05165",2017,0,0,13,13
"05165",2018,0,0,64,64
"05165",2019,0,0,23,23
"05165",2020,0,0,13,13
"05166",2014,0,0,110,110
"05166",2015,0,0,77,77
"05166",2016,0,0,23,23
"05166",2017,0,0,13,13
"05166",2018,0,0,64,64
"05166",2019,0,0,23,23
"05166",2020,0,0,13,13
"05167",2014,0,0,110,110
"05167",2015,0,0,77,77
"05167",2016,0,0,23,23
"05167",2017,0,0,13,13
"05167",2018,0,0,64,64
"05167",2019,0,0,23,23
"05167",2020,0,0,13,13
"05168",2014,0,0,110,110
"05168",2015,0,0,77,77
"05168",2016,0,0,23,23
"05168",2017,0,0,13,13
"05168",2018,0,0,64,64
"05168",2019,0,0,23,23
"05168",2020,0,0,13,13
"05169",2014,0,0,25,25
"05169",2015,0,0,64,64
"05169",2016,0,0,23,23
"05169",2017,0,0,13,13
"05169",2018,0,0,64,64
"05169",2019,0,0,23,23
"05169",2020,0,0,13,13
"05170",2014,0,0,110,110
"05170",2015,0,0,77,77
"05170",2016,0,0,7,7
"05170",2017,0,0,13,13
"05170",2018,0,0,64,64
"05170",2019,0,0,23,23
"05170",2020,0,0,36,36
"05171",2014,0,0,110,110
"05171",2015,0,0,77,77
"05171",2016,0,0,7,7
"05171",2017,0,0,13,13
"05171",2018,0,0,64,64
"05171",2019,0,0,23,23
"05171",2020,0,0,36,36
"05172",2014,0,0,110,110
"05172",2015,0,0,77,77
"05172",2016,0,0,23,23
"05172",2017,0,0,13,13
"05172",2018,0,0,64,64
"05172",2019,0,0,23,23
"05172",2020,0,0,13,13
"05173",2014,0,0,110,110
"05173",2015,0,0,77,77
"05173",2016,0,0,23,23
"05173",2017,0,0,13,13
"05173",2018,0,0,64,64
"05173",2019,0,0,23,23
"05173",2020,0,0,13,13
"05174",2018,0,0,64,64
"05174",2019,0,0,96,96
"05176",2014,0,0,110,110
"05176",2015,0,0,77,77
"05176",2016,0,0,7,7
"05176",2017,0,0,13,13
"05176",2018,0,0,64,64
"05176",2019,0,0,23,23
"05176",2020,0,0,36,36
"05177",2018,0,0,64,64
"05177",2019,0,0,96,96
"05178",2014,0,0,110,110
"05178",2015,0,0,77,77
"05178",2016,0,0,23,23
"05178",2017,0,0,13,13
"05178",2018,0,0,64,64
"05178",2019,0,0,23,23
"05178",2020,0,0,13,13
"05179",2014,0,0,110,110
"05179",2015,0,0,77,77
"05179",2016,0,0,23,23
"05179",2017,0,0,13,13
"05179",2018,0,0,64,64
"05179",2019,0,0,23,23
"05179",2020,0,0,13,13
"05180",2018,0,0,64,64
"05180",2019,0,0,96,96
"05181",2018,0,0,64,64
"05181",2019,0,0,96,96
"05182",2018,0,0,64,64
"05182",2019,0,0,96,96
"05183",2018,0,0,64,64
"05183",2019,0,0,96,96
"05184",2014,0,0,110,110
"05184",2015,0,0,77,77
"05184",2018,0,0,64,64
"05184",2019,0,0,96,96
"06001",2016,0,85,85,170
"06001",2017,0,101,32,133
"06001",2019,0,99,84,183
"06002",2016,0,85,85,170
"06002",2017,0,101,32,133
"06002",2019,0,99,84,183
"06003",2016,0,85,85,170
"06003",2017,0,101,32,133
"06003",2019,0,99,84,183
"06004",2016,0,85,85,170
"06004",2017,0,101,32,133
"06004",2019,0,99,84,183
"06005",2016,0,85,85,170
"06005",2017,0,101,32,133
"06005",2019,0,99,84,183
"06006",2016,0,85,85,170
"06006",2017,0,101,120,221
"06006",2019,0,99,84,183
"06007",2016,0,85,85,170
"06007",2017,0,101,32,133
"06007",2019,0,99,84,183
"06008",2016,0,85,85,170
"06008",2017,0,101,32,133
"06008",2019,0,99,84,183
"06009",2016,0,85,85,170
"06009",2017,0,101,32,133
"06009",2019,0,99,84,183
"06010",2016,0,85,85,170
"06010",2017,0,101,32,133
"06010",2019,0,99,84,183
"06011",2016,0,85,85,170
"06011",2017,0,101,120,221
"06011",2019,0,99,84,183
"06012",2016,0,85,85,170
"06012",2017,0,101,32,133
"06012",2019,0,99,84,183
"06013",2016,0,85,85,170
"06013",2017,0,101,32,133
"06013",2019,0,99,84,183
"06014",2016,0,85,85,170
"06014",2017,0,101,32,133
"06014",2019,0,99,84,183
"06015",2016,0,85,85,170
"06015",2017,0,101,32,133
"06015",2019,0,99,84,183
"06016",2016,0,85,85,170
"06016",2017,0,101,32,133
"06016",2019,0,99,84,183
"06017",2016,0,85,85,170
"06017",2017,0,101,32,133
"06017",2019,0,99,84,183
"06018",2016,0,85,85,170
"06018",2017,0,101,32,133
"06018",2019,0,99,84,183
"06019",2016,0,85,85,170
"06019",2017,0,101,32,133
"06019",2019,0,99,84,183
"06020",2016,0,85,85,170
"06020",2017,0,101,32,133
"06020",2019,0,99,84,183
"06021",2016,0,85,85,170
"06021",2017,0,101,32,133
"06021",2019,0,99,84,183
"06022",2016,0,85,85,170
"06022",2017,0,101,32,133
"06022",2019,0,99,84,183
"06023",2016,0,85,85,170
"06023",2017,0,101,32,133
"06023",2019,0,99,84,183
"06024",2016,0,85,85,170
"06024",2017,0,101,32,133
"06024",2019,0,99,84,183
"06025",2016,0,85,85,170
"06025",2017,0,101,32,133
"06025",2019,0,99,84,183
"06026",2016,0,85,85,170
"06026",2017,0,101,32,133
"06026",2019,0,99,84,183
"06027",2016,0,85,85,170
"06027",2017,0,101,32,133
"06027",2019,0,99,84,183
"06028",2016,0,85,85,170
"06028",2017,0,101,56,157
"06028",2019,0,99,84,183
"06029",2016,0,85,85,170
"06029",2017,0,101,32,133
"06029",2019,0,99,84,183
"06030",2016,0,85,85,170
"06030",2017,0,101,32,133
"06030",2019,0,99,84,183
"06031",2016,0,85,85,170
"06031",2017,0,101,32,133
"06031",2019,0,99,84,183
"06032",2016,0,85,85,170
"06032",2017,0,101,120,221
"06032",2019,0,99,84,183
"06033",2016,0,85,85,170
"06033",2017,0,101,120,221
"06033",2019,0,99,84,183
"06034",2016,0,85,85,170
"06034",2017,0,101,120,221
"06034",2019,0,99,84,183
"06035",2016,0,85,85,170
"06035",2017,0,101,32,133
"06035",2019,0,99,84,183
"06036",2016,0,85,85,170
"06036",2017,0,101,32,133
"06036",2019,0,99,84,183
"06037",2016,0,85,85,170
"06037",2017,0,101,32,133
"06037",2019,0,99,84,183
"06038",2016,0,85,85,170
"06038",2017,0,101,32,133
"06038",2019,0,99,84,183
"06039",2016,0,85,85,170
"06039",2017,0,101,32,133
"06039",2019,0,99,84,183
"06040",2016,0,85,85,170
"06040",2017,0,101,32,133
"06040",2019,0,99,84,183
"06041",2016,0,85,85,170
"06041",2017,0,101,32,133
"06041",2019,0,99,84,183
"06042",2016,0,85,85,170
"06042",2017,0,101,32,133
"06042",2019,0,99,84,183
"06043",2016,0,85,85,170
"06043",2017,0,101,32,133
"06043",2019,0,99,84,183
"06044",2016,0,85,85,170
"06044",2017,0,101,32,133
"06044",2019,0,99,84,183
"06045",2016,0,85,85,170
"06045",2017,0,101,32,133
"06045",2019,0,99,84,183
"06046",2016,0,85,85,170
"06046",2017,0,101,120,221
"06046",2019,0,99,84,183
"06047",2016,0,85,85,170
"06047",2017,0,101,32,133
"06047",2019,0,99,84,183
"06048",2016,0,85,85,170
"06048",2017,0,101,32,133
"06048",2019,0,99,84,183
"06049",2016,0,85,85,170
"06049",2017,0,101,32,133
"06049",2019,0,99,84,183
"06050",2016,0,85,85,170
"06050",2017,0,101,32,133
"06050",2019,0,99,84,183
"06051",2016,0,85,85,170
"06051",2017,0,101,32,133
"06051",2019,0,99,84,183
"06052",2016,0,85,85,170
"06052",2017,0,101,32,133
"06052",2019,0,99,84,183
"06053",2016,0,85,85,170
"06053",2017,0,101,32,133
"06053",2019,0,99,84,183
"06054",2016,0,85,85,170
"06054",2017,0,101,32,133
"06054",2019,0,99,84,183
"06055",2016,0,85,85,170
"06055",2017,0,101,32,133
"06055",2019,0,99,84,183
"06056",2016,0,85,85,170
"06056",2017,0,101,32,133
"06056",2019,0,99,84,183
"06057",2016,0,85,85,170
"06057",2017,0,101,32,133
"06057",2019,0,99,84,183
"06058",2016,0,85,85,170
"06058",2017,0,101,56,157
"06058",2019,0,99,84,183
"06059",2016,0,85,85,170
"06059",2017,0,101,32,133
"06059",2019,0,99,84,183
"06060",2016,0,85,85,170
"06060",2017,0,101,120,221
"06060",2019,0,99,84,183
"06061",2016,0,85,85,170
"06061",2017,0,101,32,133
"06061",2019,0,99,84,183
"06062",2016,0,85,85,170
"06062",2017,0,101,32,133
"06062",2019,0,99,84,183
"06063",2016,0,85,85,170
"06063",2017,0,101,32,133
"06063",2019,0,99,84,183
"06064",2016,0,85,85,170
"06064",2017,0,101,32,133
"06064",2019,0,99,84,183
"06065",2016,0,85,85,170
"06065",2017,0,101,32,133
"06065",2019,0,99,84,183
"06066",2016,0,85,85,170
"06066",2017,0,101,32,133
"06066",2019,0,99,84,183
"06067",2016,0,85,85,170
"06067",2017,0,101,32,133
"06067",2019,0,99,84,183
"06068",2016,0,85,85,170
"06068",2017,0,101,32,133
"06068",2019,0,99,84,183
"06069",2016,0,85,85,170
"06069",2017,0,101,32,133
"06069",2019,0,99,84,183
"06070",2016,0,85,85,170
"06070",2017,0,101,32,133
"06070",2019,0,99,84,183
"06071",2016,0,85,85,170
"06071",2017,0,101,32,133
"06071",2019,0,99,84,183
"06072",2016,0,85,85,170
"06072",2017,0,101,32,133
"06072",2019,0,99,84,183
"06073",2016,0,85,85,170
"06073",2017,0,101,32,133
"06073",2019,0,99,84,183
"06074",2016,0,85,85,170
"06074",2017,0,101,32,133
"06074",2019,0,99,84,183
"06075",2016,0,85,85,170
"06075",2017,0,101,32,133
"06075",2019,0,99,84,183
"06076",2016,0,85,85,170
"06076",2017,0,101,32,133
"06076",2019,0,99,84,183
"06077",2016,0,85,85,170
"06077",2017,0,101,32,133
"06077",2019,0,99,84,183
"06078",2016,0,85,85,170
"06078",2017,0,101,32,133
"06078",2019,0,99,84,183
"06079",2016,0,85,85,170
"06079",2017,0,101,181,282
"06079",2019,0,99,84,183
"06080",2016,0,85,85,170
"06080",2017,0,101,32,133
"06080",2019,0,99,84,183
"06081",2016,0,85,85,170
"06081",2017,0,101,32,133
"06081",2019,0,99,84,183
"06082",2016,0,85,85,170
"06082",2017,0,101,32,133
"06082",2019,0,99,84,183
"06083",2016,0,85,85,170
"06083",2017,0,101,32,133
"06083",2019,0,99,84,183
"06084",2016,0,85,85,170
"06084",2017,0,101,32,133
"06084",2019,0,99,84,183
"06085",2016,0,85,85,170
"06085",2017,0,101,32,133
"06085",2019,0,99,84,183
"06086",2016,0,85,85,170
"06086",2017,0,101,32,133
"06086",2019,0,99,84,183
"06087",2016,0,85,85,170
"06087",2017,0,101,32,133
"06087",2019,0,99,84,183
"06088",2016,0,85,85,170
"06088",2017,0,101,32,133
"06088",2019,0,99,84,183
"06089",2016,0,85,85,170
"06089",2017,0,101,32,133
"06089",2019,0,99,84,183
"06090",2016,0,85,85,170
"06090",2017,0,101,181,282
"06090",2019,0,99,84,183
"06091",2016,0,85,85,170
"06091",2017,0,101,32,133
"06091",2019,0,99,84,183
"06092",2016,0,85,85,170
"06092",2017,0,101,32,133
"06092",2019,0,99,84,183
"06093",2016,0,85,85,170
"06093",2017,0,101,32,133
"06093",2019,0,99,84,183
"06094",2016,0,85,85,170
"06094",2017,0,101,32,133
"06094",2019,0,99,84,183
"06095",2016,0,85,85,170
"06095",2017,0,101,32,133
"06095",2019,0,99,84,183
"06096",2016,0,85,85,170
"06096",2017,0,101,32,133
"06096",2019,0,99,84,183
"06097",2016,0,85,85,170
"06097",2017,0,101,32,133
"06097",2019,0,99,84,183
"06098",2016,0,85,85,170
"06098",2017,0,101,32,133
"06098",2019,0,99,84,183
"06099",2016,0,85,85,170
"06099",2017,0,101,32,133
"06099",2019,0,99,84,183
"06100",2016,0,85,85,170
"06100",2017,0,101,32,133
"06100",2019,0,99,84,183
"06101",2016,0,85,85,170
"06101",2017,0,101,32,133
"06101",2019,0,99,84,183
"06102",2016,0,85,85,170
"06102",2017,0,101,32,133
"06102",2019,0,99,84,183
"06103",2016,0,85,85,170
"06103",2017,0,101,32,133
"06103",2019,0,99,84,183
"06104",2016,0,85,85,170
"06104",2017,0,101,32,133
"06104",2019,0,99,84,183
"06105",2016,0,85,85,170
"06105",2017,0,101,32,133
"06105",2019,0,99,84,183
"06106",2016,0,85,85,170
"06106",2017,0,101,32,133
"06106",2019,0,99,84,183
"06107",2016,0,85,85,170
"06107",2017,0,101,32,133
"06107",2019,0,99,84,183
"06108",2016,0,85,85,170
"06108",2017,0,101,32,133
"06108",2019,0,99,84,183
"06109",2016,0,85,85,170
"06109",2017,0,101,32,133
"06109",2019,0,99,84,183
"06110",2016,0,85,85,170
"06110",2017,0,101,32,133
"06110",2019,0,99,84,183
"06111",2016,0,85,85,170
"06111",2017,0,101,32,133
"06111",2019,0,99,84,183
"06112",2016,0,85,85,170
"06112",2017,0,101,32,133
"06112",2019,0,99,84,183
"06113",2016,0,85,85,170
"06113",2017,0,101,32,133
"06113",2019,0,99,84,183
"06114",2016,0,85,85,170
"06114",2017,0,101,120,221
"06114",2019,0,99,84,183
"06115",2016,0,85,85,170
"06115",2017,0,101,32,133
"06115",2019,0,99,84,183
"06116",2016,0,85,85,170
"06116",2017,0,101,32,133
"06116",2019,0,99,84,183
"06117",2016,0,85,85,170
"06117",2017,0,101,120,221
"06117",2019,0,99,84,183
"06118",2016,0,85,85,170
"06118",2017,0,101,181,282
"06118",2019,0,99,84,183
"06119",2016,0,85,85,170
"06119",2017,0,101,32,133
"06119",2019,0,99,84,183
"06120",2016,0,85,85,170
"06120",2017,0,101,32,133
"06120",2019,0,99,84,183
"06121",2016,0,85,85,170
"06121",2017,0,101,120,221
"06121",2019,0,99,84,183
"06122",2016,0,85,85,170
"06122",2017,0,101,32,133
"06122",2019,0,99,84,183
"06123",2016,0,85,85,170
"06123",2017,0,101,32,133
"06123",2019,0,99,84,183
"06124",2016,0,85,85,170
"06124",2017,0,101,32,133
"06124",2019,0,99,84,183
"06125",2016,0,85,85,170
"06125",2017,0,101,32,133
"06125",2019,0,99,84,183
"06126",2016,0,85,85,170
"06126",2017,0,101,120,221
"06126",2019,0,99,84,183
"06127",2016,0,85,85,170
"06127",2017,0,101,32,133
"06127",2019,0,99,84,183
"06128",2016,0,85,85,170
"06128",2017,0,101,32,133
"06128",2019,0,99,84,183
"06129",2016,0,85,85,170
"06129",2017,0,101,32,133
"06129",2019,0,99,84,183
"06130",2016,0,85,85,170
"06130",2017,0,101,32,133
"06130",2019,0,99,84,183
"06131",2016,0,85,85,170
"06131",2017,0,101,32,133
"06131",2019,0,99,84,183
"06132",2016,0,85,85,170
"06132",2017,0,101,32,133
"06132",2019,0,99,84,183
"06133",2016,0,85,85,170
"06133",2017,0,101,32,133
"06133",2019,0,99,84,183
"06134",2016,0,85,85,170
"06134",2017,0,101,56,157
"06134",2019,0,99,84,183
"06135",2016,0,85,85,170
"06135",2017,0,101,32,133
"06135",2019,0,99,84,183
"06136",2016,0,85,85,170
"06136",2017,0,101,32,133
"06136",2019,0,99,84,183
"06137",2016,0,85,85,170
"06137",2017,0,101,181,282
"06137",2019,0,99,84,183
"06138",2016,0,85,85,170
"06138",2017,0,101,181,282
"06138",2019,0,99,84,183
"06139",2016,0,85,85,170
"06139",2017,0,101,32,133
"06139",2019,0,99,84,183
"06140",2016,0,85,85,170
"06140",2017,0,101,181,282
"06140",2019,0,99,84,183
"06141",2016,0,85,85,170
"06141",2017,0,101,32,133
"06141",2019,0,99,84,183
"06142",2016,0,85,85,170
"06142",2017,0,101,32,133
"06142",2019,0,99,84,183
"06143",2016,0,85,85,170
"06143",2017,0,101,32,133
"06143",2019,0,99,84,183
"06144",2016,0,85,85,170
"06144",2017,0,101,32,133
"06144",2019,0,99,84,183
"06145",2016,0,85,85,170
"06145",2017,0,101,32,133
"06145",2019,0,99,84,183
"06146",2016,0,85,85,170
"06146",2017,0,101,32,133
"06146",2019,0,99,84,183
"06147",2016,0,85,85,170
"06147",2017,0,101,32,133
"06147",2019,0,99,84,183
"06148",2016,0,85,85,170
"06148",2017,0,101,32,133
"06148",2019,0,99,84,183
"06149",2016,0,85,85,170
"06149",2017,0,101,32,133
"06149",2019,0,99,84,183
"06150",2016,0,85,85,170
"06150",2017,0,101,32,133
"06150",2019,0,99,84,183
"06151",2016,0,85,85,170
"06151",2017,0,101,32,133
"06151",2019,0,99,84,183
"06152",2016,0,85,85,170
"06152",2017,0,101,32,133
"06152",2019,0,99,84,183
"06153",2016,0,85,85,170
"06153",2017,0,101,32,133
"06153",2019,0,99,84,183
"06154",2016,0,85,85,170
"06154",2017,0,101,32,133
"06154",2019,0,99,84,183
"06155",2016,0,85,85,170
"06155",2017,0,101,32,133
"06155",2019,0,99,84,183
"06156",2016,0,85,85,170
"06156",2017,0,101,32,133
"06156",2019,0,99,84,183
"06157",2016,0,85,85,170
"06157",2017,0,101,32,133
"06157",2019,0,99,84,183
"06158",2016,0,85,85,170
"06158",2017,0,101,32,133
"06158",2019,0,99,84,183
"06159",2016,0,85,85,170
"06159",2017,0,101,120,221
"06159",2019,0,99,84,183
"06160",2016,0,85,85,170
"06160",2017,0,101,32,133
"06160",2019,0,99,84,183
"06161",2016,0,85,85,170
"06161",2017,0,101,32,133
"06161",2019,0,99,84,183
"06162",2016,0,85,85,170
"06162",2017,0,101,32,133
"06162",2019,0,99,84,183
"06163",2016,0,85,85,170
"06163",2017,0,101,32,133
"06163",2019,0,99,84,183
"07001",2014,0,53,51,104
"07001",2015,0,8,0,8
"07001",2016,0,25,0,25
"07001",2017,0,54,0,54
"07001",2020,0,0,17,17
"07002",2014,0,53,61,114
"07002",2015,0,8,0,8
"07002",2016,0,25,0,25
"07002",2017,0,54,0,54
"07002",2020,0,0,61,61
"07003",2014,0,53,61,114
"07003",2015,0,8,0,8
"07003",2016,0,25,0,25
"07003",2017,0,54,0,54
"07003",2020,0,0,61,61
"07004",2014,0,53,51,104
"07004",2015,0,8,0,8
"07004",2016,0,25,0,25
"07004",2017,0,54,0,54
"07004",2020,0,0,17,17
"07005",2014,0,53,61,114
"07005",2015,0,8,0,8
"07005",2016,0,25,0,25
"07005",2017,0,54,0,54
"07005",2020,0,0,61,61
"07006",2014,0,53,51,104
"07006",2015,0,8,0,8
"07006",2016,0,25,0,25
"07006",2017,0,54,0,54
"07006",2020,0,0,17,17
"07007",2014,0,53,37,90
"07007",2015,0,8,0,8
"07007",2016,0,25,24,49
"07007",2017,0,54,0,54
"07007",2018,0,0,14,14
"07008",2014,0,53,51,104
"07008",2015,0,8,0,8
"07008",2016,0,25,0,25
"07008",2017,0,54,0,54
"07008",2020,0,0,17,17
"07009",2014,0,53,37,90
"07009",2015,0,8,0,8
"07009",2016,0,25,24,49
"07009",2017,0,54,0,54
"07009",2018,0,0,14,14
"07010",2013,0,0,54,54
"07010",2014,0,53,104,157
"07010",2015,0,8,8,16
"07010",2016,0,25,24,49
"07010",2017,0,54,25,79
"07010",2018,0,0,14,14
"07010",2019,0,0,18,18
"07011",2014,0,53,51,104
"07011",2015,0,8,0,8
"07011",2016,0,25,0,25
"07011",2017,0,54,0,54
"07011",2020,0,0,17,17
"07012",2014,0,53,51,104
"07012",2015,0,8,0,8
"07012",2016,0,25,0,25
"07012",2017,0,54,0,54
"07012",2020,0,0,17,17
"07013",2014,0,53,37,90
"07013",2015,0,8,0,8
"07013",2016,0,25,24,49
"07013",2017,0,54,0,54
"07013",2018,0,0,14,14
"07014",2014,0,53,37,90
"07014",2015,0,8,0,8
"07014",2016,0,25,24,49
"07014",2017,0,54,0,54
"07014",2018,0,0,14,14
"07015",2014,0,53,37,90
"07015",2015,0,8,0,8
"07015",2016,0,25,24,49
"07015",2017,0,54,0,54
"07015",2018,0,0,14,14
"07017",2014,0,53,61,114
"07017",2015,0,8,0,8
"07017",2016,0,25,0,25
"07017",2017,0,54,0,54
"07017",2020,0,0,61,61
"07018",2014,0,53,61,114
"07018",2015,0,8,0,8
"07018",2016,0,25,0,25
"07018",2017,0,54,0,54
"07018",2020,0,0,50,50
"07019",2014,0,53,61,114
"07019",2015,0,8,0,8
"07019",2016,0,25,0,25
"07019",2017,0,54,0,54
"07019",2020,0,0,61,61
"07020",2014,0,53,61,114
"07020",2015,0,8,0,8
"07020",2016,0,25,0,25
"07020",2017,0,54,0,54
"07020",2020,0,0,61,61
"07022",2014,0,53,51,104
"07022",2015,0,8,0,8
"07022",2016,0,25,0,25
"07022",2017,0,54,0,54
"07022",2020,0,0,17,17
"07023",2014,0,53,61,114
"07023",2015,0,8,0,8
"07023",2016,0,25,0,25
"07023",2017,0,54,0,54
"07023",2020,0,0,61,61
"07024",2014,0,53,61,114
"07024",2015,0,8,0,8
"07024",2016,0,25,0,25
"07024",2017,0,54,0,54
"07024",2020,0,0,61,61
"07025",2014,0,53,61,114
"07025",2015,0,8,0,8
"07025",2016,0,25,0,25
"07025",2017,0,54,0,54
"07025",2020,0,0,50,50
"07026",2014,0,53,51,104
"07026",2015,0,8,0,8
"07026",2016,0,25,0,25
"07026",2017,0,54,0,54
"07026",2020,0,0,17,17
"07027",2014,0,53,51,104
"07027",2015,0,8,0,8
"07027",2016,0,25,0,25
"07027",2017,0,54,0,54
"07027",2020,0,0,17,17
"07028",2014,0,53,61,114
"07028",2015,0,8,0,8
"07028",2016,0,25,0,25
"07028",2017,0,54,0,54
"07028",2020,0,0,61,61
"07029",2014,0,53,61,114
"07029",2015,0,8,0,8
"07029",2016,0,25,0,25
"07029",2017,0,54,0,54
"07029",2020,0,0,61,61
"07030",2014,0,53,51,104
"07030",2015,0,8,0,8
"07030",2016,0,25,0,25
"07030",2017,0,54,0,54
"07030",2020,0,0,17,17
"07031",2014,0,53,61,114
"07031",2015,0,8,0,8
"07031",2016,0,25,0,25
"07031",2017,0,54,0,54
"07031",2020,0,0,61,61
"07032",2014,0,53,51,104
"07032",2015,0,8,0,8
"07032",2016,0,25,0,25
"07032",2017,0,54,0,54
"07032",2020,0,0,17,17
"07033",2014,0,53,61,114
"07033",2015,0,8,0,8
"07033",2016,0,25,0,25
"07033",2017,0,54,0,54
"07033",2020,0,0,61,61
"07034",2014,0,53,61,114
"07034",2015,0,8,0,8
"07034",2016,0,25,0,25
"07034",2017,0,54,0,54
"07034",2020,0,0,61,61
"07035",2014,0,53,37,90
"07035",2015,0,8,0,8
"07035",2016,0,25,0,25
"07035",2017,0,54,0,54
"07036",2013,0,0,54,54
"07036",2014,0,53,104,157
"07036",2015,0,8,8,16
"07036",2016,0,25,24,49
"07036",2017,0,54,25,79
"07036",2018,0,0,14,14
"07036",2019,0,0,18,18
"07037",2014,0,53,51,104
"07037",2015,0,8,0,8
"07037",2016,0,25,0,25
"07037",2017,0,54,0,54
"07037",2020,0,0,17,17
"07038",2014,0,53,61,114
"07038",2015,0,8,0,8
"07038",2016,0,25,0,25
"07038",2017,0,54,0,54
"07038",2020,0,0,50,50
"07039",2014,0,53,37,90
"07039",2015,0,8,0,8
"07039",2016,0,25,24,49
"07039",2017,0,54,0,54
"07039",2018,0,0,14,14
"07040",2014,0,53,37,90
"07040",2015,0,8,0,8
"07040",2016,0,25,24,49
"07040",2017,0,54,0,54
"07040",2018,0,0,14,14
"07041",2013,0,0,54,54
"07041",2014,0,53,104,157
"07041",2015,0,8,8,16
"07041",2016,0,25,24,49
"07041",2017,0,54,25,79
"07041",2018,0,0,14,14
"07041",2019,0,0,18,18
"07042",2014,0,53,61,114
"07042",2015,0,8,0,8
"07042",2016,0,25,0,25
"07042",2017,0,54,0,54
"07042",2020,0,0,61,61
"07044",2013,0,0,54,54
"07044",2014,0,53,104,157
"07044",2015,0,8,8,16
"07044",2016,0,25,24,49
"07044",2017,0,54,25,79
"07044",2018,0,0,14,14
"07044",2019,0,0,18,18
"07045",2014,0,53,61,114
"07045",2015,0,8,0,8
"07045",2016,0,25,0,25
"07045",2017,0,54,0,54
"07045",2020,0,0,50,50
"07047",2013,0,0,54,54
"07047",2014,0,53,132,185
"07047",2015,0,8,107,115
"07047",2016,0,25,55,80
"07047",2017,0,54,142,196
"07047",2020,0,0,50,50
"07048",2014,0,53,51,104
"07048",2015,0,8,0,8
"07048",2016,0,25,0,25
"07048",2017,0,54,0,54
"07048",2020,0,0,17,17
"07049",2014,0,53,51,104
"07049",2015,0,8,0,8
"07049",2016,0,25,0,25
"07049",2017,0,54,0,54
"07049",2020,0,0,17,17
"07050",2014,0,53,61,114
"07050",2015,0,8,0,8
"07050",2016,0,25,0,25
"07050",2017,0,54,0,54
"07050",2020,0,0,61,61
"07051",2013,0,0,54,54
"07051",2014,0,53,104,157
"07051",2015,0,8,8,16
"07051",2016,0,25,24,49
"07051",2017,0,54,25,79
"07051",2018,0,0,14,14
"07051",2019,0,0,18,18
"07052",2014,0,53,37,90
"07052",2015,0,8,0,8
"07052",2016,0,25,24,49
"07052",2017,0,54,0,54
"07052",2018,0,0,14,14
"07053",2014,0,53,61,114
"07053",2015,0,8,0,8
"07053",2016,0,25,0,25
"07053",2017,0,54,0,54
"07053",2020,0,0,61,61
"07054",2014,0,53,51,104
"07054",2015,0,8,0,8
"07054",2016,0,25,0,25
"07054",2017,0,54,0,54
"07054",2020,0,0,17,17
"07055",2014,0,53,37,90
"07055",2015,0,8,0,8
"07055",2016,0,25,0,25
"07055",2017,0,54,0,54
"07056",2013,0,0,54,54
"07056",2014,0,53,104,157
"07056",2015,0,8,8,16
"07056",2016,0,25,24,49
"07056",2017,0,54,25,79
"07056",2018,0,0,14,14
"07056",2019,0,0,18,18
"07058",2014,0,53,61,114
"07058",2015,0,8,0,8
"07058",2016,0,25,0,25
"07058",2017,0,54,0,54
"07058",2020,0,0,61,61
"07059",2014,0,53,37,90
"07059",2015,0,8,0,8
"07059",2016,0,25,24,49
"07059",2017,0,54,0,54
"07059",2018,0,0,14,14
"07060",2014,0,53,37,90
"07060",2015,0,8,0,8
"07060",2016,0,25,0,25
"07060",2017,0,54,0,54
"07061",2014,0,53,61,114
"07061",2015,0,8,0,8
"07061",2016,0,25,0,25
"07061",2017,0,54,0,54
"07061",2020,0,0,61,61
"07062",2014,0,53,61,114
"07062",2015,0,8,0,8
"07062",2016,0,25,0,25
"07062",2017,0,54,0,54
"07062",2020,0,0,61,61
"07063",2014,0,53,37,90
"07063",2015,0,8,0,8
"07063",2016,0,25,24,49
"07063",2017,0,54,0,54
"07063",2018,0,0,14,14
"07064",2014,0,53,51,104
"07064",2015,0,8,0,8
"07064",2016,0,25,0,25
"07064",2017,0,54,0,54
"07064",2020,0,0,17,17
"07065",2014,0,53,61,114
"07065",2015,0,8,0,8
"07065",2016,0,25,0,25
"07065",2017,0,54,0,54
"07065",2020,0,0,61,61
"07066",2014,0,53,51,104
"07066",2015,0,8,0,8
"07066",2016,0,25,0,25
"07066",2017,0,54,0,54
"07066",2020,0,0,17,17
"07067",2013,0,0,54,54
"07067",2014,0,53,104,157
"07067",2015,0,8,8,16
"07067",2016,0,25,24,49
"07067",2017,0,54,25,79
"07067",2018,0,0,14,14
"07067",2019,0,0,18,18
"07068",2014,0,53,37,90
"07068",2015,0,8,0,8
"07068",2016,0,25,24,49
"07068",2017,0,54,0,54
"07068",2018,0,0,14,14
"07069",2014,0,53,37,90
"07069",2015,0,8,0,8
"07069",2016,0,25,24,49
"07069",2017,0,54,0,54
"07069",2018,0,0,14,14
"07070",2014,0,53,37,90
"07070",2015,0,8,0,8
"07070",2016,0,25,24,49
"07070",2017,0,54,0,54
"07070",2018,0,0,14,14
"07071",2013,0,0,54,54
"07071",2014,0,53,132,185
"07071",2015,0,8,107,115
"07071",2016,0,25,55,80
"07071",2017,0,54,142,196
"07071",2020,0,0,50,50
"07072",2014,0,53,51,104
"07072",2015,0,8,0,8
"07072",2016,0,25,0,25
"07072",2017,0,54,0,54
"07072",2020,0,0,17,17
"07073",2014,0,53,37,90
"07073",2015,0,8,0,8
"07073",2016,0,25,24,49
"07073",2017,0,54,0,54
"07073",2018,0,0,14,14
"07074",2014,0,53,51,104
"07074",2015,0,8,0,8
"07074",2016,0,25,0,25
"07074",2017,0,54,0,54
"07074",2020,0,0,17,17
"07075",2013,0,0,54,54
"07075",2014,0,53,132,185
"07075",2015,0,8,107,115
"07075",2016,0,25,55,80
"07075",2017,0,54,142,196
"07075",2020,0,0,50,50
"07076",2014,0,53,51,104
"07076",2015,0,8,0,8
"07076",2016,0,25,0,25
"07076",2017,0,54,0,54
"07076",2020,0,0,17,17
"07077",2014,0,53,51,104
"07077",2015,0,8,0,8
"07077",2016,0,25,0,25
"07077",2017,0,54,0,54
"07077",2020,0,0,17,17
"07078",2013,0,0,54,54
"07078",2014,0,53,104,157
"07078",2015,0,8,8,16
"07078",2016,0,25,24,49
"07078",2017,0,54,25,79
"07078",2018,0,0,14,14
"07078",2019,0,0,18,18
"07079",2014,0,53,37,90
"07079",2015,0,8,0,8
"07079",2016,0,25,0,25
"07079",2017,0,54,0,54
"07080",2014,0,53,37,90
"07080",2015,0,8,0,8
"07080",2016,0,25,0,25
"07080",2017,0,54,0,54
"07081",2014,0,53,61,114
"07081",2015,0,8,0,8
"07081",2016,0,25,0,25
"07081",2017,0,54,0,54
"07081",2020,0,0,61,61
"07082",2014,0,53,51,104
"07082",2015,0,8,0,8
"07082",2016,0,25,0,25
"07082",2017,0,54,0,54
"07082",2020,0,0,17,17
"07083",2014,0,53,51,104
"07083",2015,0,8,0,8
"07083",2016,0,25,0,25
"07083",2017,0,54,0,54
"07083",2020,0,0,17,17
"07084",2014,0,53,37,90
"07084",2015,0,8,0,8
"07084",2016,0,25,24,49
"07084",2017,0,54,0,54
"07084",2018,0,0,14,14
"07085",2014,0,53,37,90
"07085",2015,0,8,0,8
"07085",2016,0,25,24,49
"07085",2017,0,54,0,54
"07085",2018,0,0,14,14
"07086",2014,0,53,37,90
"07086",2015,0,8,0,8
"07086",2016,0,25,24,49
"07086",2017,0,54,0,54
"07086",2018,0,0,14,14
"07087",2014,0,53,61,114
"07087",2015,0,8,0,8
"07087",2016,0,25,0,25
"07087",2017,0,54,0,54
"07087",2020,0,0,61,61
"07088",2014,0,53,61,114
"07088",2015,0,8,0,8
"07088",2016,0,25,0,25
"07088",2017,0,54,0,54
"07088",2020,0,0,61,61
"07089",2013,0,0,54,54
"07089",2014,0,53,104,157
"07089",2015,0,8,8,16
"07089",2016,0,25,24,49
"07089",2017,0,54,25,79
"07089",2018,0,0,14,14
"07089",2019,0,0,18,18
"07090",2014,0,53,51,104
"07090",2015,0,8,0,8
"07090",2016,0,25,0,25
"07090",2017,0,54,0,54
"07090",2020,0,0,17,17
"07091",2014,0,53,61,114
"07091",2015,0,8,0,8
"07091",2016,0,25,0,25
"07091",2017,0,54,0,54
"07091",2020,0,0,61,61
"07092",2014,0,53,51,104
"07092",2015,0,8,0,8
"07092",2016,0,25,0,25
"07092",2017,0,54,0,54
"07092",2020,0,0,17,17
"07093",2014,0,53,51,104
"07093",2015,0,8,0,8
"07093",2016,0,25,0,25
"07093",2017,0,54,0,54
"07093",2020,0,0,17,17
"07094",2014,0,53,37,90
"07094",2015,0,8,0,8
"07094",2016,0,25,0,25
"07094",2017,0,54,0,54
"07095",2014,0,53,37,90
"07095",2015,0,8,0,8
"07095",2016,0,25,24,49
"07095",2017,0,54,0,54
"07095",2018,0,0,14,14
"07096",2014,0,53,51,104
"07096",2015,0,8,0,8
"07096",2016,0,25,0,25
"07096",2017,0,54,0,54
"07096",2020,0,0,17,17
"07097",2014,0,53,37,90
"07097",2015,0,8,0,8
"07097",2016,0,25,24,49
"07097",2017,0,54,0,54
"07097",2018,0,0,14,14
"07098",2014,0,53,51,104
"07098",2015,0,8,0,8
"07098",2016,0,25,0,25
"07098",2017,0,54,0,54
"07098",2020,0,0,17,17
"07099",2014,0,53,61,114
"07099",2015,0,8,0,8
"07099",2016,0,25,0,25
"07099",2017,0,54,0,54
"07099",2020,0,0,61,61
"07100",2014,0,53,61,114
"07100",2015,0,8,0,8
"07100",2016,0,25,0,25
"07100",2017,0,54,0,54
"07100",2020,0,0,61,61
"07101",2014,0,53,61,114
"07101",2015,0,8,0,8
"07101",2016,0,25,0,25
"07101",2017,0,54,0,54
"07101",2020,0,0,61,61
"07102",2014,0,53,37,90
"07102",2015,0,8,0,8
"07102",2016,0,25,24,49
"07102",2017,0,54,0,54
"07102",2018,0,0,14,14
"07103",2014,0,53,51,104
"07103",2015,0,8,0,8
"07103",2016,0,25,0,25
"07103",2017,0,54,0,54
"07103",2020,0,0,17,17
"07104",2014,0,53,51,104
"07104",2015,0,8,0,8
"07104",2016,0,25,0,25
"07104",2017,0,54,0,54
"07104",2020,0,0,17,17
"07105",2013,0,0,54,54
"07105",2014,0,53,132,185
"07105",2015,0,8,107,115
"07105",2016,0,25,55,80
"07105",2017,0,54,142,196
"07105",2020,0,0,50,50
"07106",2013,0,0,54,54
"07106",2014,0,53,132,185
"07106",2015,0,8,107,115
"07106",2016,0,25,55,80
"07106",2017,0,54,142,196
"07106",2020,0,0,50,50
"07107",2014,0,53,61,114
"07107",2015,0,8,0,8
"07107",2016,0,25,0,25
"07107",2017,0,54,0,54
"07107",2020,0,0,61,61
"07108",2014,0,53,51,104
"07108",2015,0,8,0,8
"07108",2016,0,25,0,25
"07108",2017,0,54,0,54
"07108",2020,0,0,17,17
"07109",2014,0,53,61,114
"07109",2015,0,8,0,8
"07109",2016,0,25,0,25
"07109",2017,0,54,0,54
"07109",2020,0,0,61,61
"07110",2014,0,53,61,114
"07110",2015,0,8,0,8
"07110",2016,0,25,0,25
"07110",2017,0,54,0,54
"07110",2020,0,0,61,61
"07111",2014,0,53,61,114
"07111",2015,0,8,0,8
"07111",2016,0,25,0,25
"07111",2017,0,54,0,54
"07111",2020,0,0,61,61
"07112",2014,0,53,61,114
"07112",2015,0,8,0,8
"07112",2016,0,25,0,25
"07112",2017,0,54,0,54
"07112",2020,0,0,61,61
"07113",2014,0,53,61,114
"07113",2015,0,8,0,8
"07113",2016,0,25,0,25
"07113",2017,0,54,0,54
"07113",2020,0,0,61,61
"07114",2014,0,53,37,90
"07114",2015,0,8,0,8
"07114",2016,0,25,24,49
"07114",2017,0,54,0,54
"07114",2018,0,0,14,14
"07115",2014,0,53,61,114
"07115",2015,0,8,0,8
"07115",2016,0,25,0,25
"07115",2017,0,54,0,54
"07115",2020,0,0,61,61
"07116",2014,0,53,61,114
"07116",2015,0,8,0,8
"07116",2016,0,25,0,25
"07116",2017,0,54,0,54
"07116",2020,0,0,61,61
"07117",2014,0,53,61,114
"07117",2015,0,8,0,8
"07117",2016,0,25,0,25
"07117",2017,0,54,0,54
"07117",2020,0,0,61,61
"07118",2014,0,53,61,114
"07118",2015,0,8,0,8
"07118",2016,0,25,0,25
"07118",2017,0,54,0,54
"07118",2020,0,0,61,61
"07119",2013,0,0,54,54
"07119",2014,0,53,132,185
"07119",2015,0,8,107,115
"07119",2016,0,25,55,80
"07119",2017,0,54,142,196
"07119",2020,0,0,50,50
"07120",2014,0,53,51,104
"07120",2015,0,8,0,8
"07120",2016,0,25,0,25
"07120",2017,0,54,0,54
"07120",2020,0,0,17,17
"07121",2013,0,0,54,54
"07121",2014,0,53,132,185
"07121",2015,0,8,107,115
"07121",2016,0,25,55,80
"07121",2017,0,54,142,196
"07121",2020,0,0,50,50
"07122",2014,0,53,61,114
"07122",2015,0,8,0,8
"07122",2016,0,25,0,25
"07122",2017,0,54,0,54
"07122",2020,0,0,61,61
"07123",2014,0,53,51,104
"07123",2015,0,8,0,8
"07123",2016,0,25,0,25
"07123",2017,0,54,0,54
"07123",2020,0,0,17,17
"07124",2014,0,53,37,90
"07124",2015,0,8,0,8
"07124",2016,0,25,24,49
"07124",2017,0,54,0,54
"07124",2018,0,0,14,14
"07126",2014,0,53,61,114
"07126",2015,0,8,0,8
"07126",2016,0,25,0,25
"07126",2017,0,54,0,54
"07126",2020,0,0,61,61
"07127",2014,0,53,61,114
"07127",2015,0,8,0,8
"07127",2016,0,25,0,25
"07127",2017,0,54,0,54
"07127",2020,0,0,61,61
"07128",2014,0,53,37,90
"07128",2015,0,8,0,8
"07128",2016,0,25,24,49
"07128",2017,0,54,0,54
"07128",2018,0,0,14,14
"07129",2014,0,53,37,90
"07129",2015,0,8,0,8
"07129",2016,0,25,0,25
"07129",2017,0,54,0,54
"07130",2014,0,53,61,114
"07130",2015,0,8,0,8
"07130",2016,0,25,0,25
"07130",2017,0,54,0,54
"07130",2020,0,0,50,50
"07131",2014,0,53,61,114
"07131",2015,0,8,0,8
"07131",2016,0,25,0,25
"07131",2017,0,54,0,54
"07131",2020,0,0,61,61
"07132",2014,0,53,61,114
"07132",2015,0,8,0,8
"07132",2016,0,25,0,25
"07132",2017,0,54,0,54
"07132",2020,0,0,61,61
"07133",2014,0,53,61,114
"07133",2015,0,8,0,8
"07133",2016,0,25,0,25
"07133",2017,0,54,0,54
"07133",2020,0,0,61,61
"07134",2014,0,53,61,114
"07134",2015,0,8,0,8
"07134",2016,0,25,0,25
"07134",2017,0,54,0,54
"07134",2020,0,0,61,61
"07136",2014,0,53,61,114
"07136",2015,0,8,0,8
"07136",2016,0,25,0,25
"07136",2017,0,54,0,54
"07136",2020,0,0,50,50
"07137",2014,0,53,61,114
"07137",2015,0,8,0,8
"07137",2016,0,25,0,25
"07137",2017,0,54,0,54
"07137",2020,0,0,50,50
"07138",2014,0,53,61,114
"07138",2015,0,8,0,8
"07138",2016,0,25,0,25
"07138",2017,0,54,0,54
"07138",2020,0,0,61,61
"07139",2014,0,53,51,104
"07139",2015,0,8,0,8
"07139",2016,0,25,0,25
"07139",2017,0,54,0,54
"07139",2020,0,0,17,17
"07140",2014,0,53,37,90
"07140",2015,0,8,0,8
"07140",2016,0,25,24,49
"07140",2017,0,54,0,54
"07140",2018,0,0,14,14
"07141",2014,0,53,61,114
"07141",2015,0,8,0,8
"07141",2016,0,25,0,25
"07141",2017,0,54,0,54
"07141",2020,0,0,61,61
"07142",2013,0,0,54,54
"07142",2014,0,53,132,185
"07142",2015,0,8,107,115
"07142",2016,0,25,55,80
"07142",2017,0,54,142,196
"07142",2020,0,0,50,50
"07143",2013,0,0,54,54
"07143",2014,0,53,104,157
"07143",2015,0,8,8,16
"07143",2016,0,25,24,49
"07143",2017,0,54,25,79
"07143",2018,0,0,14,14
"07143",2019,0,0,18,18
"07144",2014,0,53,61,114
"07144",2015,0,8,0,8
"07144",2016,0,25,0,25
"07144",2017,0,54,0,54
"07144",2020,0,0,61,61
"07145",2014,0,53,61,114
"07145",2015,0,8,0,8
"07145",2016,0,25,0,25
"07145",2017,0,54,0,54
"07145",2020,0,0,61,61
"07146",2014,0,53,51,104
"07146",2015,0,8,0,8
"07146",2016,0,25,0,25
"07146",2017,0,54,0,54
"07146",2020,0,0,17,17
"07147",2014,0,53,61,114
"07147",2015,0,8,0,8
"07147",2016,0,25,0,25
"07147",2017,0,54,0,54
"07147",2020,0,0,61,61
"07148",2014,0,53,61,114
"07148",2015,0,8,0,8
"07148",2016,0,25,0,25
"07148",2017,0,54,0,54
"07148",2020,0,0,61,61
"07149",2014,0,53,51,104
"07149",2015,0,8,0,8
"07149",2016,0,25,0,25
"07149",2017,0,54,0,54
"07149",2020,0,0,17,17
"07150",2014,0,53,51,104
"07150",2015,0,8,0,8
"07150",2016,0,25,0,25
"07150",2017,0,54,0,54
"07150",2020,0,0,17,17
"07151",2014,0,53,51,104
"07151",2015,0,8,0,8
"07151",2016,0,25,0,25
"07151",2017,0,54,0,54
"07151",2020,0,0,17,17
"07152",2014,0,53,37,90
"07152",2015,0,8,0,8
"07152",2016,0,25,24,49
"07152",2017,0,54,0,54
"07152",2018,0,0,14,14
"07153",2014,0,53,61,114
"07153",2015,0,8,0,8
"07153",2016,0,25,0,25
"07153",2017,0,54,0,54
"07153",2020,0,0,50,50
"07154",2014,0,53,61,114
"07154",2015,0,8,0,8
"07154",2016,0,25,0,25
"07154",2017,0,54,0,54
"07154",2020,0,0,50,50
"07155",2014,0,53,61,114
"07155",2015,0,8,0,8
"07155",2016,0,25,0,25
"07155",2017,0,54,0,54
"07155",2020,0,0,61,61
"07156",2014,0,53,61,114
"07156",2015,0,8,0,8
"07156",2016,0,25,0,25
"07156",2017,0,54,0,54
"07156",2020,0,0,61,61
"07157",2014,0,53,61,114
"07157",2015,0,8,0,8
"07157",2016,0,25,0,25
"07157",2017,0,54,0,54
"07157",2020,0,0,61,61
"07158",2014,0,53,51,104
"07158",2015,0,8,0,8
"07158",2016,0,25,0,25
"07158",2017,0,54,0,54
"07158",2020,0,0,17,17
"07159",2014,0,53,61,114
"07159",2015,0,8,0,8
"07159",2016,0,25,0,25
"07159",2017,0,54,0,54
"07159",2020,0,0,61,61
"07160",2013,0,0,54,54
"07160",2014,0,53,104,157
"07160",2015,0,8,8,16
"07160",2016,0,25,24,49
"07160",2017,0,54,25,79
"07160",2018,0,0,14,14
"07160",2019,0,0,18,18
"07161",2014,0,53,61,114
"07161",2015,0,8,0,8
"07161",2016,0,25,0,25
"07161",2017,0,54,0,54
"07161",2020,0,0,50,50
"07162",2014,0,53,61,114
"07162",2015,0,8,0,8
"07162",2016,0,25,0,25
"07162",2017,0,54,0,54
"07162",2020,0,0,61,61
"07163",2014,0,53,61,114
"07163",2015,0,8,0,8
"07163",2016,0,25,0,25
"07163",2017,0,54,0,54
"07163",2020,0,0,61,61
"07165",2014,0,53,37,90
"07165",2015,0,8,0,8
"07165",2016,0,25,0,25
"07165",2017,0,54,0,54
"07166",2014,0,53,37,90
"07166",2015,0,8,0,8
"07166",2016,0,25,24,49
"07166",2017,0,54,0,54
"07166",2018,0,0,14,14
"07167",2014,0,53,51,104
"07167",2015,0,8,0,8
"07167",2016,0,25,0,25
"07167",2017,0,54,0,54
"07167",2020,0,0,17,17
"07168",2014,0,53,61,114
"07168",2015,0,8,0,8
"07168",2016,0,25,0,25
"07168",2017,0,54,0,54
"07168",2020,0,0,61,61
"07169",2014,0,53,37,90
"07169",2015,0,8,0,8
"07169",2016,0,25,24,49
"07169",2017,0,54,0,54
"07169",2018,0,0,14,14
"07170",2014,0,53,37,90
"07170",2015,0,8,0,8
"07170",2016,0,25,24,49
"07170",2017,0,54,0,54
"07170",2018,0,0,14,14
"07171",2014,0,53,61,114
"07171",2015,0,8,0,8
"07171",2016,0,25,0,25
"07171",2017,0,54,0,54
"07171",2020,0,0,61,61
"07172",2013,0,0,54,54
"07172",2014,0,53,104,157
"07172",2015,0,8,8,16
"07172",2016,0,25,24,49
"07172",2017,0,54,25,79
"07172",2018,0,0,14,14
"07172",2019,0,0,18,18
"07173",2014,0,53,61,114
"07173",2015,0,8,0,8
"07173",2016,0,25,0,25
"07173",2017,0,54,0,54
"07173",2020,0,0,50,50
"07174",2013,0,0,54,54
"07174",2014,0,53,104,157
"07174",2015,0,8,8,16
"07174",2016,0,25,24,49
"07174",2017,0,54,25,79
"07174",2018,0,0,14,14
"07174",2019,0,0,18,18
"07175",2014,0,53,61,114
"07175",2015,0,8,0,8
"07175",2016,0,25,0,25
"07175",2017,0,54,0,54
"07175",2020,0,0,50,50
"07176",2014,0,53,61,114
"07176",2015,0,8,0,8
"07176",2016,0,25,0,25
"07176",2017,0,54,0,54
"07176",2020,0,0,61,61
"07177",2014,0,53,37,90
"07177",2015,0,8,0,8
"07177",2016,0,25,24,49
"07177",2017,0,54,0,54
"07177",2018,0,0,14,14
"07178",2014,0,53,61,114
"07178",2015,0,8,0,8
"07178",2016,0,25,0,25
"07178",2017,0,54,0,54
"07178",2020,0,0,61,61
"07179",2014,0,53,51,104
"07179",2015,0,8,0,8
"07179",2016,0,25,0,25
"07179",2017,0,54,0,54
"07179",2020,0,0,17,17
"07181",2014,0,53,51,104
"07181",2015,0,8,0,8
"07181",2016,0,25,0,25
"07181",2017,0,54,0,54
"07181",2020,0,0,17,17
"07182",2014,0,53,61,114
"07182",2015,0,8,0,8
"07182",2016,0,25,0,25
"07182",2017,0,54,0,54
"07182",2020,0,0,61,61
"07183",2014,0,53,61,114
"07183",2015,0,8,0,8
"07183",2016,0,25,0,25
"07183",2017,0,54,0,54
"07183",2020,0,0,61,61
"07184",2014,0,53,51,104
"07184",2015,0,8,0,8
"07184",2016,0,25,0,25
"07184",2017,0,54,0,54
"07184",2020,0,0,17,17
"07185",2014,0,53,37,90
"07185",2015,0,8,0,8
"07185",2016,0,25,24,49
"07185",2017,0,54,0,54
"07185",2018,0,0,14,14
"07186",2014,0,53,51,104
"07186",2015,0,8,0,8
"07186",2016,0,25,0,25
"07186",2017,0,54,0,54
"07186",2020,0,0,17,17
"07187",2014,0,53,61,114
"07187",2015,0,8,0,8
"07187",2016,0,25,0,25
"07187",2017,0,54,0,54
"07187",2020,0,0,61,61
"07188",2014,0,53,37,90
"07188",2015,0,8,0,8
"07188",2016,0,25,24,49
"07188",2017,0,54,0,54
"07188",2018,0,0,14,14
"07189",2014,0,53,61,114
"07189",2015,0,8,0,8
"07189",2016,0,25,0,25
"07189",2017,0,54,0,54
"07189",2020,0,0,61,61
"07190",2014,0,53,61,114
"07190",2015,0,8,0,8
"07190",2016,0,25,0,25
"07190",2017,0,54,0,54
"07190",2020,0,0,61,61
"07191",2014,0,53,61,114
"07191",2015,0,8,0,8
"07191",2016,0,25,0,25
"07191",2017,0,54,0,54
"07191",2020,0,0,61,61
"07192",2014,0,53,37,90
"07192",2015,0,8,0,8
"07192",2016,0,25,0,25
"07192",2017,0,54,0,54
"07193",2014,0,53,61,114
"07193",2015,0,8,0,8
"07193",2016,0,25,0,25
"07193",2017,0,54,0,54
"07193",2020,0,0,61,61
"07194",2014,0,53,51,104
"07194",2015,0,8,0,8
"07194",2016,0,25,0,25
"07194",2017,0,54,0,54
"07194",2020,0,0,17,17
"07195",2014,0,53,51,104
"07195",2015,0,8,0,8
"07195",2016,0,25,0,25
"07195",2017,0,54,0,54
"07195",2020,0,0,17,17
"07196",2014,0,53,61,114
"07196",2015,0,8,0,8
"07196",2016,0,25,0,25
"07196",2017,0,54,0,54
"07196",2020,0,0,61,61
"07197",2014,0,53,37,90
"07197",2015,0,8,0,8
"07197",2016,0,25,24,49
"07197",2017,0,54,0,54
"07197",2018,0,0,14,14
"07198",2014,0,53,51,104
"07198",2015,0,8,0,8
"07198",2016,0,25,0,25
"07198",2017,0,54,0,54
"07198",2020,0,0,17,17
"07199",2014,0,53,61,114
"07199",2015,0,8,0,8
"07199",2016,0,25,0,25
"07199",2017,0,54,0,54
"07199",2020,0,0,61,61
"07200",2014,0,53,61,114
"07200",2015,0,8,0,8
"07200",2016,0,25,0,25
"07200",2017,0,54,0,54
"07200",2020,0,0,50,50
"07201",2014,0,53,61,114
"07201",2015,0,8,0,8
"07201",2016,0,25,0,25
"07201",2017,0,54,0,54
"07201",2020,0,0,61,61
"07202",2014,0,53,61,114
"07202",2015,0,8,0,8
"07202",2016,0,25,0,25
"07202",2017,0,54,0,54
"07202",2020,0,0,61,61
"07203",2014,0,53,51,104
"07203",2015,0,8,0,8
"07203",2016,0,25,0,25
"07203",2017,0,54,0,54
"07203",2020,0,0,17,17
"07204",2014,0,53,37,90
"07204",2015,0,8,0,8
"07204",2016,0,25,0,25
"07204",2017,0,54,0,54
"07205",2014,0,53,37,90
"07205",2015,0,8,0,8
"07205",2016,0,25,24,49
"07205",2017,0,54,0,54
"07205",2018,0,0,14,14
"07206",2013,0,0,54,54
"07206",2014,0,53,132,185
"07206",2015,0,8,107,115
"07206",2016,0,25,55,80
"07206",2017,0,54,142,196
"07206",2020,0,0,50,50
"07207",2014,0,53,61,114
"07207",2015,0,8,0,8
"07207",2016,0,25,0,25
"07207",2017,0,54,0,54
"07207",2020,0,0,61,61
"07208",2014,0,53,61,114
"07208",2015,0,8,0,8
"07208",2016,0,25,0,25
"07208",2017,0,54,0,54
"07208",2020,0,0,61,61
"07209",2014,0,53,51,104
"07209",2015,0,8,0,8
"07209",2016,0,25,0,25
"07209",2017,0,54,0,54
"07209",2020,0,0,17,17
"07210",2014,0,53,61,114
"07210",2015,0,8,0,8
"07210",2016,0,25,0,25
"07210",2017,0,54,0,54
"07210",2020,0,0,61,61
"07211",2014,0,53,61,114
"07211",2015,0,8,0,8
"07211",2016,0,25,0,25
"07211",2017,0,54,0,54
"07211",2020,0,0,61,61
"07212",2014,0,53,37,90
"07212",2015,0,8,0,8
"07212",2016,0,25,0,25
"07212",2017,0,54,0,54
"07213",2014,0,53,61,114
"07213",2015,0,8,0,8
"07213",2016,0,25,0,25
"07213",2017,0,54,0,54
"07213",2020,0,0,61,61
"07214",2014,0,53,37,90
"07214",2015,0,8,0,8
"07214",2016,0,25,0,25
"07214",2017,0,54,0,54
"07215",2014,0,53,51,104
"07215",2015,0,8,0,8
"07215",2016,0,25,0,25
"07215",2017,0,54,0,54
"07215",2020,0,0,17,17
"07216",2014,0,53,37,90
"07216",2015,0,8,0,8
"07216",2016,0,25,0,25
"07216",2017,0,54,0,54
"07217",2014,0,53,37,90
"07217",2015,0,8,0,8
"07217",2016,0,25,24,49
"07217",2017,0,54,0,54
"07217",2018,0,0,14,14
"07218",2014,0,53,37,90
"07218",2015,0,8,0,8
"07218",2016,0,25,0,25
"07218",2017,0,54,0,54
"07219",2014,0,53,51,104
"07219",2015,0,8,0,8
"07219",2016,0,25,0,25
"07219",2017,0,54,0,54
"07219",2020,0,0,17,17
"07220",2014,0,53,51,104
"07220",2015,0,8,0,8
"07220",2016,0,25,0,25
"07220",2017,0,54,0,54
"07220",2020,0,0,17,17
"07221",2014,0,53,51,104
"07221",2015,0,8,0,8
"07221",2016,0,25,0,25
"07221",2017,0,54,0,54
"07221",2020,0,0,17,17
"07222",2014,0,53,51,104
"07222",2015,0,8,0,8
"07222",2016,0,25,0,25
"07222",2017,0,54,0,54
"07222",2020,0,0,17,17
"07223",2014,0,53,61,114
"07223",2015,0,8,0,8
"07223",2016,0,25,0,25
"07223",2017,0,54,0,54
"07223",2020,0,0,61,61
"07224",2014,0,53,61,114
"07224",2015,0,8,0,8
"07224",2016,0,25,0,25
"07224",2017,0,54,0,54
"07224",2020,0,0,50,50
"07225",2013,0,0,54,54
"07225",2014,0,53,104,157
"07225",2015,0,8,8,16
"07225",2016,0,25,24,49
"07225",2017,0,54,25,79
"07225",2018,0,0,14,14
"07225",2019,0,0,18,18
"07226",2014,0,53,51,104
"07226",2015,0,8,0,8
"07226",2016,0,25,0,25
"07226",2017,0,54,0,54
"07226",2020,0,0,17,17
"07227",2013,0,0,54,54
"07227",2014,0,53,104,157
"07227",2015,0,8,8,16
"07227",2016,0,25,24,49
"07227",2017,0,54,25,79
"07227",2018,0,0,14,14
"07227",2019,0,0,18,18
"07228",2013,0,0,54,54
"07228",2014,0,53,104,157
"07228",2015,0,8,8,16
"07228",2016,0,25,24,49
"07228",2017,0,54,25,79
"07228",2018,0,0,14,14
"07228",2019,0,0,18,18
"07229",2014,0,53,61,114
"07229",2015,0,8,0,8
"07229",2016,0,25,0,25
"07229",2017,0,54,0,54
"07229",2020,0,0,61,61
"07230",2014,0,53,51,104
"07230",2015,0,8,0,8
"07230",2016,0,25,0,25
"07230",2017,0,54,0,54
"07230",2020,0,0,17,17
"07231",2014,0,53,61,114
"07231",2015,0,8,0,8
"07231",2016,0,25,0,25
"07231",2017,0,54,0,54
"07231",2020,0,0,61,61
"07232",2014,0,53,61,114
"07232",2015,0,8,0,8
"07232",2016,0,25,0,25
"07232",2017,0,54,0,54
"07232",2020,0,0,50,50
"07233",2014,0,53,51,104
"07233",2015,0,8,0,8
"07233",2016,0,25,0,25
"07233",2017,0,54,0,54
"07233",2020,0,0,17,17
"07234",2013,0,0,54,54
"07234",2014,0,53,104,157
"07234",2015,0,8,8,16
"07234",2016,0,25,24,49
"07234",2017,0,54,25,79
"07234",2018,0,0,14,14
"07234",2019,0,0,18,18
"07235",2014,0,53,51,104
"07235",2015,0,8,0,8
"07235",2016,0,25,0,25
"07235",2017,0,54,0,54
"07235",2020,0,0,17,17
"07236",2014,0,53,37,90
"07236",2015,0,8,0,8
"07236",2016,0,25,24,49
"07236",2017,0,54,0,54
"07236",2018,0,0,14,14
"07237",2014,0,53,51,104
"07237",2015,0,8,0,8
"07237",2016,0,25,0,25
"07237",2017,0,54,0,54
"07237",2020,0,0,17,17
"07238",2014,0,53,61,114
"07238",2015,0,8,0,8
"07238",2016,0,25,0,25
"07238",2017,0,54,0,54
"07238",2020,0,0,61,61
"07239",2014,0,53,51,104
"07239",2015,0,8,0,8
"07239",2016,0,25,0,25
"07239",2017,0,54,0,54
"07239",2020,0,0,17,17
"07240",2014,0,53,37,90
"07240",2015,0,8,0,8
"07240",2016,0,25,0,25
"07240",2017,0,54,0,54
"07241",2014,0,53,61,114
"07241",2015,0,8,0,8
"07241",2016,0,25,0,25
"07241",2017,0,54,0,54
"07241",2020,0,0,61,61
"07242",2014,0,53,51,104
"07242",2015,0,8,0,8
"07242",2016,0,25,0,25
"07242",2017,0,54,0,54
"07242",2020,0,0,17,17
"07243",2013,0,0,54,54
"07243",2014,0,53,104,157
"07243",2015,0,8,8,16
"07243",2016,0,25,24,49
"07243",2017,0,54,25,79
"07243",2018,0,0,14,14
"07243",2019,0,0,18,18
"07244",2014,0,53,37,90
"07244",2015,0,8,0,8
"07244",2016,0,25,0,25
"07244",2017,0,54,0,54
"07245",2014,0,53,37,90
"07245",2015,0,8,0,8
"07245",2016,0,25,24,49
"07245",2017,0,54,0,54
"07245",2018,0,0,14,14
"07247",2014,0,53,61,114
"07247",2015,0,8,0,8
"07247",2016,0,25,0,25
"07247",2017,0,54,0,54
"07247",2020,0,0,61,61
"07248",2014,0,53,51,104
"07248",2015,0,8,0,8
"07248",2016,0,25,0,25
"07248",2017,0,54,0,54
"07249",2014,0,53,37,90
"07249",2015,0,8,0,8
"07249",2016,0,25,0,25
"07249",2017,0,54,0,54
"07250",2014,0,53,37,90
"07250",2015,0,8,0,8
"07250",2016,0,25,24,49
"07250",2017,0,54,0,54
"07250",2018,0,0,14,14
"07251",2014,0,53,51,104
"07251",2015,0,8,0,8
"07251",2016,0,25,0,25
"07251",2017,0,54,0,54
"07251",2020,0,0,17,17
"07253",2014,0,53,51,104
"07253",2015,0,8,0,8
"07253",2016,0,25,0,25
"07253",2017,0,54,0,54
"07253",2020,0,0,17,17
"07254",2014,0,53,61,114
"07254",2015,0,8,0,8
"07254",2016,0,25,0,25
"07254",2017,0,54,0,54
"07254",2020,0,0,61,61
"07255",2014,0,53,51,104
"07255",2015,0,8,0,8
"07255",2016,0,25,0,25
"07255",2017,0,54,0,54
"07255",2020,0,0,17,17
"07257",2014,0,53,37,90
"07257",2015,0,8,0,8
"07257",2016,0,25,0,25
"07257",2017,0,54,0,54
"07258",2014,0,53,37,90
"07258",2015,0,8,0,8
"07258",2016,0,25,24,49
"07258",2017,0,54,0,54
"07258",2018,0,0,14,14
"07259",2014,0,53,61,114
"07259",2015,0,8,0,8
"07259",2016,0,25,0,25
"07259",2017,0,54,0,54
"07259",2020,0,0,61,61
"07260",2014,0,53,51,104
"07260",2015,0,8,0,8
"07260",2016,0,25,0,25
"07260",2017,0,54,0,54
"07260",2020,0,0,17,17
"07261",2014,0,53,51,104
"07261",2015,0,8,0,8
"07261",2016,0,25,0,25
"07261",2017,0,54,0,54
"07261",2020,0,0,17,17
"07262",2014,0,53,61,114
"07262",2015,0,8,0,8
"07262",2016,0,25,0,25
"07262",2017,0,54,0,54
"07262",2020,0,0,50,50
"07263",2014,0,53,51,104
"07263",2015,0,8,0,8
"07263",2016,0,25,0,25
"07263",2017,0,54,0,54
"07263",2020,0,0,17,17
"07264",2014,0,53,61,114
"07264",2015,0,8,0,8
"07264",2016,0,25,0,25
"07264",2017,0,54,0,54
"07264",2020,0,0,61,61
"07265",2013,0,0,54,54
"07265",2014,0,53,104,157
"07265",2015,0,8,8,16
"07265",2016,0,25,24,49
"07265",2017,0,54,25,79
"07265",2018,0,0,14,14
"07265",2019,0,0,18,18
"07266",2014,0,53,61,114
"07266",2015,0,8,0,8
"07266",2016,0,25,0,25
"07266",2017,0,54,0,54
"07266",2020,0,0,61,61
"07267",2014,0,53,51,104
"07267",2015,0,8,0,8
"07267",2016,0,25,0,25
"07267",2017,0,54,0,54
"07267",2020,0,0,17,17
"07268",2014,0,53,61,114
"07268",2015,0,8,0,8
"07268",2016,0,25,0,25
"07268",2017,0,54,0,54
"07268",2020,0,0,61,61
"07269",2014,0,53,51,104
"07269",2015,0,8,0,8
"07269",2016,0,25,0,25
"07269",2017,0,54,0,54
"07269",2020,0,0,17,17
"07270",2014,0,53,51,104
"07270",2015,0,8,0,8
"07270",2016,0,25,0,25
"07270",2017,0,54,0,54
"07270",2020,0,0,17,17
"07272",2014,0,53,61,114
"07272",2015,0,8,0,8
"07272",2016,0,25,0,25
"07272",2017,0,54,0,54
"07272",2020,0,0,61,61
"07273",2014,0,53,61,114
"07273",2015,0,8,0,8
"07273",2016,0,25,0,25
"07273",2017,0,54,0,54
"07273",2020,0,0,61,61
"07274",2014,0,53,51,104
"07274",2015,0,8,0,8
"07274",2016,0,25,0,25
"07274",2017,0,54,0,54
"07274",2020,0,0,17,17
"07275",2014,0,53,61,114
"07275",2015,0,8,0,8
"07275",2016,0,25,0,25
"07275",2017,0,54,0,54
"07275",2020,0,0,61,61
"07276",2014,0,53,51,104
"07276",2015,0,8,0,8
"07276",2016,0,25,0,25
"07276",2017,0,54,0,54
"07276",2020,0,0,17,17
"07277",2014,0,53,61,114
"07277",2015,0,8,0,8
"07277",2016,0,25,0,25
"07277",2017,0,54,0,54
"07277",2020,0,0,61,61
"07278",2014,0,53,51,104
"07278",2015,0,8,0,8
"07278",2016,0,25,0,25
"07278",2017,0,54,0,54
"07278",2020,0,0,17,17
"07279",2014,0,53,61,114
"07279",2015,0,8,0,8
"07279",2016,0,25,0,25
"07279",2017,0,54,0,54
"07279",2020,0,0,61,61
"07280",2014,0,53,61,114
"07280",2015,0,8,0,8
"07280",2016,0,25,0,25
"07280",2017,0,54,0,54
"07280",2020,0,0,61,61
"07281",2014,0,53,37,90
"07281",2015,0,8,0,8
"07281",2016,0,25,24,49
"07281",2017,0,54,0,54
"07281",2018,0,0,14,14
"07282",2014,0,53,61,114
"07282",2015,0,8,0,8
"07282",2016,0,25,0,25
"07282",2017,0,54,0,54
"07282",2020,0,0,61,61
"07283",2014,0,53,51,104
"07283",2015,0,8,0,8
"07283",2016,0,25,0,25
"07283",2017,0,54,0,54
"07283",2020,0,0,17,17
"07284",2014,0,53,61,114
"07284",2015,0,8,0,8
"07284",2016,0,25,0,25
"07284",2017,0,54,0,54
"07284",2020,0,0,61,61
"07285",2014,0,53,37,90
"07285",2015,0,8,0,8
"07285",2016,0,25,24,49
"07285",2017,0,54,0,54
"07285",2018,0,0,14,14
"07286",2014,0,53,51,104
"07286",2015,0,8,0,8
"07286",2016,0,25,0,25
"07286",2017,0,54,0,54
"07286",2020,0,0,17,17
"07287",2014,0,53,51,104
"07287",2015,0,8,0,8
"07287",2016,0,25,0,25
"07287",2017,0,54,0,54
"07287",2020,0,0,17,17
"07288",2014,0,53,51,104
"07288",2015,0,8,0,8
"07288",2016,0,25,0,25
"07288",2017,0,54,0,54
"07288",2020,0,0,17,17
"07289",2014,0,53,61,114
"07289",2015,0,8,0,8
"07289",2016,0,25,0,25
"07289",2017,0,54,0,54
"07289",2020,0,0,61,61
"07290",2014,0,53,37,90
"07290",2015,0,8,0,8
"07290",2016,0,25,0,25
"07290",2017,0,54,0,54
"07291",2014,0,53,61,114
"07291",2015,0,8,0,8
"07291",2016,0,25,0,25
"07291",2017,0,54,0,54
"07291",2020,0,0,61,61
"07292",2014,0,53,37,90
"07292",2015,0,8,0,8
"07292",2016,0,25,24,49
"07292",2017,0,54,0,54
"07292",2018,0,0,14,14
"07293",2014,0,53,37,90
"07293",2015,0,8,0,8
"07293",2016,0,25,24,49
"07293",2017,0,54,0,54
"07293",2018,0,0,14,14
"07294",2014,0,53,61,114
"07294",2015,0,8,0,8
"07294",2016,0,25,0,25
"07294",2017,0,54,0,54
"07294",2020,0,0,61,61
"07295",2014,0,53,51,104
"07295",2015,0,8,0,8
"07295",2016,0,25,0,25
"07295",2017,0,54,0,54
"07295",2020,0,0,17,17
"07296",2014,0,53,61,114
"07296",2015,0,8,0,8
"07296",2016,0,25,0,25
"07296",2017,0,54,0,54
"07296",2020,0,0,61,61
"07297",2014,0,53,37,90
"07297",2015,0,8,0,8
"07297",2016,0,25,24,49
"07297",2017,0,54,0,54
"07297",2018,0,0,14,14
"07298",2014,0,53,51,104
"07298",2015,0,8,0,8
"07298",2016,0,25,0,25
"07298",2017,0,54,0,54
"07298",2020,0,0,17,17
"07299",2014,0,53,37,90
"07299",2015,0,8,0,8
"07299",2016,0,25,24,49
"07299",2017,0,54,0,54
"07299",2018,0,0,14,14
"07300",2014,0,53,61,114
"07300",2015,0,8,0,8
"07300",2016,0,25,0,25
"07300",2017,0,54,0,54
"07300",2020,0,0,61,61
"07301",2014,0,53,37,90
"07301",2015,0,8,0,8
"07301",2016,0,25,24,49
"07301",2017,0,54,0,54
"07301",2018,0,0,14,14
"07302",2014,0,53,51,104
"07302",2015,0,8,0,8
"07302",2016,0,25,0,25
"07302",2017,0,54,0,54
"07302",2020,0,0,17,17
"07303",2014,0,53,51,104
"07303",2015,0,8,0,8
"07303",2016,0,25,0,25
"07303",2017,0,54,0,54
"07303",2020,0,0,17,17
"07304",2014,0,53,61,114
"07304",2015,0,8,0,8
"07304",2016,0,25,0,25
"07304",2017,0,54,0,54
"07304",2020,0,0,61,61
"07305",2014,0,53,61,114
"07305",2015,0,8,0,8
"07305",2016,0,25,0,25
"07305",2017,0,54,0,54
"07305",2020,0,0,61,61
"07306",2014,0,53,61,114
"07306",2015,0,8,0,8
"07306",2016,0,25,0,25
"07306",2017,0,54,0,54
"07306",2020,0,0,61,61
"07307",2014,0,53,61,114
"07307",2015,0,8,0,8
"07307",2016,0,25,0,25
"07307",2017,0,54,0,54
"07307",2020,0,0,61,61
"07308",2014,0,53,37,90
"07308",2015,0,8,0,8
"07308",2016,0,25,24,49
"07308",2017,0,54,0,54
"07308",2018,0,0,14,14
"07309",2014,0,53,37,90
"07309",2015,0,8,0,8
"07309",2016,0,25,24,49
"07309",2017,0,54,0,54
"07309",2018,0,0,14,14
"07310",2013,0,0,54,54
"07310",2014,0,53,104,157
"07310",2015,0,8,8,16
"07310",2016,0,25,24,49
"07310",2017,0,54,25,79
"07310",2018,0,0,14,14
"07310",2019,0,0,18,18
"07311",2014,0,53,51,104
"07311",2015,0,8,0,8
"07311",2016,0,25,0,25
"07311",2017,0,54,0,54
"07311",2020,0,0,17,17
"07312",2014,0,53,37,90
"07312",2015,0,8,0,8
"07312",2016,0,25,24,49
"07312",2017,0,54,0,54
"07312",2018,0,0,14,14
"07313",2013,0,0,54,54
"07313",2014,0,53,104,157
"07313",2015,0,8,8,16
"07313",2016,0,25,24,49
"07313",2017,0,54,25,79
"07313",2018,0,0,14,14
"07313",2019,0,0,18,18
"07314",2014,0,53,51,104
"07314",2015,0,8,0,8
"07314",2016,0,25,0,25
"07314",2017,0,54,0,54
"07314",2020,0,0,17,17
"07315",2014,0,53,61,114
"07315",2015,0,8,0,8
"07315",2016,0,25,0,25
"07315",2017,0,54,0,54
"07315",2020,0,0,61,61
"07316",2014,0,53,37,90
"07316",2015,0,8,0,8
"07316",2016,0,25,0,25
"07316",2017,0,54,0,54
"07317",2014,0,53,37,90
"07317",2015,0,8,0,8
"07317",2016,0,25,24,49
"07317",2017,0,54,0,54
"07317",2018,0,0,14,14
"07317",2019,0,0,18,18
"07318",2014,0,53,61,114
"07318",2015,0,8,0,8
"07318",2016,0,25,0,25
"07318",2017,0,54,0,54
"07318",2020,0,0,61,61
"07319",2014,0,53,61,114
"07319",2015,0,8,0,8
"07319",2016,0,25,0,25
"07319",2017,0,54,0,54
"07319",2020,0,0,61,61
"07321",2013,0,0,54,54
"07321",2014,0,53,104,157
"07321",2015,0,8,8,16
"07321",2016,0,25,24,49
"07321",2017,0,54,25,79
"07321",2018,0,0,14,14
"07321",2019,0,0,18,18
"07322",2014,0,53,61,114
"07322",2015,0,8,0,8
"07322",2016,0,25,0,25
"07322",2017,0,54,0,54
"07322",2020,0,0,61,61
"07323",2014,0,53,37,90
"07323",2015,0,8,0,8
"07323",2016,0,25,0,25
"07323",2017,0,54,0,54
"07324",2014,0,53,37,90
"07324",2015,0,8,0,8
"07324",2016,0,25,24,49
"07324",2017,0,54,0,54
"07324",2018,0,0,14,14
"07325",2014,0,53,61,114
"07325",2015,0,8,0,8
"07325",2016,0,25,0,25
"07325",2017,0,54,0,54
"07325",2020,0,0,61,61
"07326",2014,0,53,61,114
"07326",2015,0,8,0,8
"07326",2016,0,25,0,25
"07326",2017,0,54,0,54
"07326",2020,0,0,50,50
"07327",2014,0,53,61,114
"07327",2015,0,8,0,8
"07327",2016,0,25,0,25
"07327",2017,0,54,0,54
"07327",2020,0,0,61,61
"07328",2014,0,53,61,114
"07328",2015,0,8,0,8
"07328",2016,0,25,0,25
"07328",2017,0,54,0,54
"07328",2020,0,0,61,61
"07329",2014,0,53,61,114
"07329",2015,0,8,0,8
"07329",2016,0,25,0,25
"07329",2017,0,54,0,54
"07329",2020,0,0,61,61
"07330",2014,0,53,61,114
"07330",2015,0,8,0,8
"07330",2016,0,25,0,25
"07330",2017,0,54,0,54
"07330",2020,0,0,61,61
"07331",2014,0,53,61,114
"07331",2015,0,8,0,8
"07331",2016,0,25,0,25
"07331",2017,0,54,0,54
"07331",2020,0,0,61,61
"07332",2014,0,53,61,114
"07332",2015,0,8,0,8
"07332",2016,0,25,0,25
"07332",2017,0,54,0,54
"07332",2020,0,0,61,61
"07333",2013,0,0,54,54
"07333",2014,0,53,104,157
"07333",2015,0,8,8,16
"07333",2016,0,25,24,49
"07333",2017,0,54,25,79
"07333",2018,0,0,14,14
"07333",2019,0,0,18,18
"07334",2014,0,53,61,114
"07334",2015,0,8,0,8
"07334",2016,0,25,0,25
"07334",2017,0,54,0,54
"07334",2020,0,0,61,61
"07335",2014,0,53,37,90
"07335",2015,0,8,0,8
"07335",2016,0,25,24,49
"07335",2017,0,54,0,54
"07335",2018,0,0,14,14
"07336",2014,0,53,61,114
"07336",2015,0,8,0,8
"07336",2016,0,25,0,25
"07336",2017,0,54,0,54
"07336",2020,0,0,61,61
"07337",2013,0,0,54,54
"07337",2014,0,53,104,157
"07337",2015,0,8,8,16
"07337",2016,0,25,24,49
"07337",2017,0,54,25,79
"07337",2018,0,0,14,14
"07337",2019,0,0,18,18
"07338",2014,0,53,37,90
"07338",2015,0,8,0,8
"07338",2016,0,25,0,25
"07338",2017,0,54,0,54
"07339",2014,0,53,61,114
"07339",2015,0,8,0,8
"07339",2016,0,25,0,25
"07339",2017,0,54,0,54
"07339",2020,0,0,61,61
"07340",2014,0,53,51,104
"07340",2015,0,8,0,8
"07340",2016,0,25,0,25
"07340",2017,0,54,0,54
"07340",2020,0,0,17,17
"07341",2014,0,53,61,114
"07341",2015,0,8,0,8
"07341",2016,0,25,0,25
"07341",2017,0,54,0,54
"07341",2020,0,0,61,61
"07342",2013,0,0,54,54
"07342",2014,0,53,104,157
"07342",2015,0,8,8,16
"07342",2016,0,25,24,49
"07342",2017,0,54,25,79
"07342",2018,0,0,14,14
"07342",2019,0,0,18,18
"07343",2014,0,53,61,114
"07343",2015,0,8,0,8
"07343",2016,0,25,0,25
"07343",2017,0,54,0,54
"07343",2020,0,0,61,61
"07344",2013,0,0,54,54
"07344",2014,0,53,104,157
"07344",2015,0,8,8,16
"07344",2016,0,25,24,49
"07344",2017,0,54,25,79
"07344",2018,0,0,14,14
"07344",2019,0,0,18,18
"07345",2014,0,53,37,90
"07345",2015,0,8,0,8
"07345",2016,0,25,24,49
"07345",2017,0,54,0,54
"07345",2018,0,0,14,14
"07346",2014,0,53,61,114
"07346",2015,0,8,0,8
"07346",2016,0,25,0,25
"07346",2017,0,54,0,54
"07346",2020,0,0,61,61
"07347",2014,0,53,37,90
"07347",2015,0,8,0,8
"07347",2016,0,25,24,49
"07347",2017,0,54,0,54
"07347",2018,0,0,14,14
"07348",2014,0,53,61,114
"07348",2015,0,8,0,8
"07348",2016,0,25,0,25
"07348",2017,0,54,0,54
"07348",2020,0,0,61,61
"07349",2014,0,53,51,104
"07349",2015,0,8,0,8
"07349",2016,0,25,0,25
"07349",2017,0,54,0,54
"07349",2020,0,0,17,17
"11001",2014,0,0,137,137
"11001",2016,0,0,9,9
"11001",2017,0,0,33,33
"11001",2018,0,0,83,83
"11001",2019,0,0,52,52
"11001",2020,0,0,44,44
"11002",2018,0,0,45,45
"11002",2019,0,0,17,17
"11002",2020,0,0,45,45
"11003",2015,0,0,55,55
"11003",2017,0,0,132,132
"11003",2018,0,0,45,45
"11003",2019,0,0,110,110
"11004",2015,0,0,55,55
"11004",2017,0,0,132,132
"11004",2018,0,0,45,45
"11004",2019,0,0,110,110
"11005",2015,0,0,55,55
"11005",2018,0,0,45,45
"11005",2019,0,0,17,17
"11005",2020,0,0,45,45
"11006",2014,0,0,137,137
"11006",2015,0,0,55,55
"11006",2017,0,0,115,115
"11006",2018,0,0,98,98
"11006",2019,0,0,8,8
"11006",2020,0,0,45,45
"11007",2014,0,0,137,137
"11007",2015,0,0,55,55
"11007",2017,0,0,132,132
"11007",2018,0,0,98,98
"11007",2019,0,0,8,8
"11007",2020,0,0,45,45
"11008",2015,0,0,55,55
"11008",2017,0,0,132,132
"11008",2018,0,0,45,45
"11008",2019,0,0,45,45
"11008",2020,0,0,45,45
"11009",2018,0,0,45,45
"11009",2019,0,0,17,17
"11009",2020,0,0,45,45
"11010",2015,0,0,55,55
"11010",2017,0,0,132,132
"11010",2018,0,0,45,45
"11010",2019,0,0,110,110
"11011",2015,0,0,55,55
"11011",2018,0,0,83,83
"11011",2019,0,0,17,17
"11011",2020,0,0,45,45
"11012",2014,0,0,137,137
"11012",2015,0,0,55,55
"11012",2017,0,0,95,95
"11012",2018,0,0,98,98
"11012",2019,0,0,44,44
"11012",2020,0,0,62,62
"11013",2014,0,0,137,137
"11013",2017,0,0,33,33
"11013",2018,0,0,98,98
"11013",2019,0,0,35,35
"11013",2020,0,0,44,44
"11014",2014,0,0,137,137
"11014",2015,0,0,55,55
"11014",2017,0,0,95,95
"11014",2018,0,0,98,98
"11014",2019,0,0,52,52
"11014",2020,0,0,27,27
"11015",2015,0,0,55,55
"11015",2017,0,0,132,132
"11015",2018,0,0,45,45
"11015",2019,0,0,110,110
"11016",2014,0,0,137,137
"11016",2015,0,0,55,55
"11016",2017,0,0,132,132
"11016",2018,0,0,98,98
"11016",2019,0,0,8,8
"11016",2020,0,0,45,45
"11017",2015,0,0,55,55
"11017",2017,0,0,132,132
"11017",2018,0,0,45,45
"11017",2019,0,0,45,45
"11017",2020,0,0,45,45
"11018",2018,0,0,45,45
"11018",2019,0,0,17,17
"11018",2020,0,0,45,45
"11019",2015,0,0,55,55
"11019",2017,0,0,132,132
"11019",2018,0,0,45,45
"11019",2019,0,0,45,45
"11019",2020,0,0,45,45
"11020",2014,0,0,137,137
"11020",2015,0,0,55,55
"11020",2017,0,0,67,67
"11020",2018,0,0,98,98
"11020",2020,0,0,45,45
"11021",2015,0,0,55,55
"11021",2017,0,0,132,132
"11021",2018,0,0,45,45
"11021",2019,0,0,45,45
"11021",2020,0,0,45,45
"11022",2014,0,0,137,137
"11022",2016,0,0,9,9
"11022",2017,0,0,33,33
"11022",2018,0,0,83,83
"11022",2019,0,0,17,17
"11022",2020,0,0,44,44
"11023",2014,0,0,137,137
"11023",2016,0,0,9,9
"11023",2017,0,0,33,33
"11023",2018,0,0,83,83
"11023",2019,0,0,17,17
"11023",2020,0,0,44,44
"11024",2014,0,0,137,137
"11024",2015,0,0,55,55
"11024",2017,0,0,95,95
"11024",2018,0,0,98,98
"11024",2019,0,0,52,52
"11024",2020,0,0,27,27
"11025",2014,0,0,137,137
"11025",2016,0,0,9,9
"11025",2017,0,0,33,33
"11025",2018,0,0,83,83
"11025",2019,0,0,52,52
"11025",2020,0,0,44,44
"11026",2018,0,0,45,45
"11026",2019,0,0,17,17
"11027",2014,0,0,137,137
"11027",2015,0,0,55,55
"11027",2017,0,0,103,103
"11027",2018,0,0,98,98
"11027",2019,0,0,8,8
"11027",2020,0,0,45,45
"11028",2015,0,0,55,55
"11028",2017,0,0,15,15
"11028",2018,0,0,45,45
"11028",2019,0,0,110,110
"11029",2015,0,0,55,55
"11029",2017,0,0,132,132
"11029",2018,0,0,45,45
"11029",2019,0,0,110,110
"11030",2018,0,0,45,45
"11030",2019,0,0,17,17
"11031",2015,0,0,55,55
"11031",2017,0,0,132,132
"11031",2018,0,0,45,45
"11031",2019,0,0,110,110
"11032",2015,0,0,55,55
"11032",2017,0,0,132,132
"11032",2018,0,0,45,45
"11032",2019,0,0,110,110
"11034",2015,0,0,55,55
"11034",2017,0,0,132,132
"11034",2018,0,0,45,45
"11034",2019,0,0,110,110
"11035",2015,0,0,55,55
"11035",2017,0,0,132,132
"11035",2018,0,0,45,45
"11035",2019,0,0,45,45
"11035",2020,0,0,45,45
"11036",2015,0,0,55,55
"11036",2017,0,0,15,15
"11036",2018,0,0,45,45
"11036",2019,0,0,110,110
"11037",2014,0,0,137,137
"11037",2015,0,0,55,55
"11037",2017,0,0,103,103
"11037",2018,0,0,98,98
"11037",2019,0,0,8,8
"11037",2020,0,0,45,45
"11038",2015,0,0,55,55
"11038",2017,0,0,132,132
"11038",2018,0,0,45,45
"11038",2019,0,0,45,45
"11038",2020,0,0,45,45
"11039",2015,0,0,55,55
"11039",2017,0,0,15,15
"11039",2018,0,0,45,45
"11039",2019,0,0,110,110
"11040",2014,0,0,137,137
"11040",2015,0,0,55,55
"11040",2017,0,0,115,115
"11040",2018,0,0,98,98
"11040",2019,0,0,8,8
"11040",2020,0,0,45,45
"11041",2014,0,0,137,137
"11041",2015,0,0,55,55
"11041",2017,0,0,95,95
"11041",2018,0,0,98,98
"11041",2019,0,0,79,79
"11041",2020,0,0,62,62
"11042",2014,0,0,137,137
"11042",2017,0,0,33,33
"11042",2018,0,0,98,98
"11042",2019,0,0,8,8
"11042",2020,0,0,44,44
"11043",2014,0,0,137,137
"11043",2016,0,0,9,9
"11043",2017,0,0,33,33
"11043",2018,0,0,83,83
"11043",2019,0,0,52,52
"11043",2020,0,0,44,44
"11044",2014,0,0,137,137
"11044",2015,0,0,55,55
"11044",2017,0,0,132,132
"11044",2018,0,0,98,98
"11044",2019,0,0,8,8
"11044",2020,0,0,45,45
"11045",2015,0,0,55,55
"11045",2017,0,0,132,132
"11045",2018,0,0,45,45
"11045",2019,0,0,110,110
"11046",2015,0,0,55,55
"11046",2017,0,0,15,15
"11046",2018,0,0,45,45
"11046",2019,0,0,110,110
"11047",2015,0,0,55,55
"11047",2017,0,0,132,132
"11047",2018,0,0,45,45
"11047",2019,0,0,110,110
"11048",2014,0,0,137,137
"11048",2015,0,0,55,55
"11048",2017,0,0,132,132
"11048",2018,0,0,98,98
"11048",2019,0,0,8,8
"11048",2020,0,0,45,45
"11049",2018,0,0,45,45
"11049",2019,0,0,17,17
"11049",2020,0,0,45,45
"11051",2015,0,0,55,55
"11051",2018,0,0,45,45
"11051",2019,0,0,17,17
"11051",2020,0,0,45,45
"11052",2015,0,0,55,55
"11052",2018,0,0,83,83
"11052",2019,0,0,17,17
"11052",2020,0,0,45,45
"11053",2015,0,0,55,55
"11053",2018,0,0,45,45
"11053",2019,0,0,17,17
"11053",2020,0,0,45,45
"11054",2018,0,0,45,45
"11054",2019,0,0,17,17
"11054",2020,0,0,45,45
"11055",2015,0,0,55,55
"11055",2017,0,0,67,67
"11055",2018,0,0,45,45
"11056",2014,0,0,137,137
"11056",2016,0,0,9,9
"11056",2017,0,0,33,33
"11056",2018,0,0,83,83
"11056",2019,0,0,52,52
"11056",2020,0,0,44,44
"11058",2015,0,0,55,55
"11058",2018,0,0,45,45
"11058",2019,0,0,17,17
"11058",2020,0,0,45,45
"11059",2015,0,0,55,55
"11059",2018,0,0,45,45
"11059",2019,0,0,17,17
"11059",2020,0,0,45,45
"11060",2015,0,0,55,55
"11060",2017,0,0,132,132
"11060",2018,0,0,45,45
"11060",2019,0,0,45,45
"11060",2020,0,0,45,45
"11061",2015,0,0,55,55
"11061",2017,0,0,132,132
"11061",2018,0,0,45,45
"11061",2019,0,0,110,110
"11062",2015,0,0,55,55
"11062",2017,0,0,132,132
"11062",2018,0,0,45,45
"11062",2019,0,0,45,45
"11062",2020,0,0,45,45
"11063",2015,0,0,55,55
"11063",2017,0,0,132,132
"11063",2018,0,0,45,45
"11063",2019,0,0,45,45
"11063",2020,0,0,45,45
"11064",2014,0,0,137,137
"11064",2015,0,0,55,55
"11064",2017,0,0,132,132
"11064",2018,0,0,98,98
"11064",2019,0,0,8,8
"11064",2020,0,0,45,45
"11065",2014,0,0,137,137
"11065",2015,0,0,55,55
"11065",2017,0,0,67,67
"11065",2018,0,0,98,98
"11065",2020,0,0,45,45
"11066",2015,0,0,55,55
"11066",2017,0,0,15,15
"11066",2018,0,0,45,45
"11066",2019,0,0,110,110
"11067",2014,0,0,137,137
"11067",2015,0,0,55,55
"11067",2017,0,0,103,103
"11067",2018,0,0,98,98
"11067",2019,0,0,35,35
"11067",2020,0,0,62,62
"11068",2014,0,0,137,137
"11068",2017,0,0,33,33
"11068",2018,0,0,98,98
"11068",2019,0,0,8,8
"11068",2020,0,0,44,44
"11069",2014,0,0,137,137
"11069",2015,0,0,55,55
"11069",2018,0,0,98,98
"11069",2019,0,0,8,8
"11069",2020,0,0,45,45
"11070",2018,0,0,45,45
"11070",2019,0,0,17,17
"11070",2020,0,0,45,45
"11071",2014,0,0,137,137
"11071",2015,0,0,55,55
"11071",2017,0,0,95,95
"11071",2018,0,0,98,98
"11071",2019,0,0,52,52
"11071",2020,0,0,27,27
"11072",2018,0,0,45,45
"11072",2019,0,0,17,17
"11072",2020,0,0,45,45
"11073",2015,0,0,55,55
"11073",2017,0,0,132,132
"11073",2018,0,0,45,45
"11073",2019,0,0,110,110
"11074",2018,0,0,45,45
"11074",2019,0,0,17,17
"11075",2014,0,0,137,137
"11075",2016,0,0,9,9
"11075",2017,0,0,33,33
"11075",2018,0,0,83,83
"11075",2019,0,0,52,52
"11075",2020,0,0,44,44
"11076",2018,0,0,45,45
"11076",2019,0,0,17,17
"11076",2020,0,0,45,45
"11077",2014,0,0,137,137
"11077",2017,0,0,33,33
"11077",2018,0,0,98,98
"11077",2019,0,0,8,8
"11077",2020,0,0,44,44
"11078",2015,0,0,55,55
"11078",2017,0,0,132,132
"11078",2018,0,0,45,45
"11078",2019,0,0,110,110
"11079",2015,0,0,55,55
"11079",2018,0,0,83,83
"11079",2019,0,0,17,17
"11079",2020,0,0,45,45
"11080",2015,0,0,55,55
"11080",2017,0,0,15,15
"11080",2018,0,0,45,45
"11080",2019,0,0,110,110
"11081",2014,0,0,137,137
"11081",2016,0,0,9,9
"11081",2017,0,0,33,33
"11081",2018,0,0,83,83
"11081",2019,0,0,52,52
"11081",2020,0,0,44,44
"11082",2014,0,0,137,137
"11082",2015,0,0,55,55
"11082",2017,0,0,132,132
"11082",2018,0,0,98,98
"11082",2019,0,0,8,8
"11082",2020,0,0,45,45
"11083",2014,0,0,137,137
"11083",2015,0,0,55,55
"11083",2017,0,0,132,132
"11083",2018,0,0,98,98
"11083",2019,0,0,8,8
"11083",2020,0,0,45,45
"11084",2018,0,0,45,45
"11084",2019,0,0,17,17
"11084",2020,0,0,45,45
"11085",2015,0,0,55,55
"11085",2017,0,0,132,132
"11085",2018,0,0,45,45
"11085",2019,0,0,45,45
"11085",2020,0,0,45,45
"11086",2014,0,0,137,137
"11086",2015,0,0,55,55
"11086",2017,0,0,95,95
"11086",2018,0,0,98,98
"11086",2019,0,0,52,52
"11086",2020,0,0,27,27
"11088",2015,0,0,55,55
"11088",2017,0,0,132,132
"11088",2018,0,0,45,45
"11088",2019,0,0,110,110
"11089",2018,0,0,45,45
"11089",2019,0,0,17,17
"11089",2020,0,0,45,45
"11090",2015,0,0,55,55
"11090",2017,0,0,132,132
"11090",2018,0,0,45,45
"11090",2019,0,0,45,45
"11090",2020,0,0,45,45
"11091",2017,0,0,15,15
"11092",2014,0,0,137,137
"11092",2016,0,0,9,9
"11092",2017,0,0,33,33
"11092",2018,0,0,83,83
"11092",2019,0,0,52,52
"11092",2020,0,0,44,44
"11093",2015,0,0,55,55
"11093",2017,0,0,132,132
"11093",2018,0,0,45,45
"11093",2019,0,0,45,45
"11093",2020,0,0,45,45
"11094",2014,0,0,137,137
"11094",2015,0,0,55,55
"11094",2017,0,0,132,132
"11094",2018,0,0,98,98
"11094",2019,0,0,8,8
"11094",2020,0,0,45,45
"11095",2014,0,0,137,137
"11095",2015,0,0,55,55
"11095",2017,0,0,132,132
"11095",2018,0,0,98,98
"11095",2019,0,0,8,8
"11095",2020,0,0,45,45
"11096",2015,0,0,55,55
"11096",2017,0,0,15,15
"11096",2018,0,0,45,45
"11096",2019,0,0,110,110
"11098",2014,0,0,137,137
"11098",2015,0,0,55,55
"11098",2017,0,0,132,132
"11098",2018,0,0,98,98
"11098",2019,0,0,8,8
"11098",2020,0,0,45,45
"11099",2015,0,0,55,55
"11099",2017,0,0,99,99
"11099",2018,0,0,83,83
"11099",2019,0,0,99,99
"11099",2020,0,0,45,45
"11100",2017,0,0,15,15
"11101",2015,0,0,55,55
"11101",2017,0,0,15,15
"11101",2018,0,0,45,45
"11101",2019,0,0,110,110
"11102",2015,0,0,55,55
"11102",2017,0,0,132,132
"11102",2018,0,0,45,45
"11102",2019,0,0,45,45
"11102",2020,0,0,45,45
"11103",2015,0,0,55,55
"11103",2017,0,0,132,132
"11103",2018,0,0,45,45
"11103",2019,0,0,45,45
"11103",2020,0,0,45,45
"11104",2015,0,0,55,55
"11104",2017,0,0,132,132
"11104",2018,0,0,45,45
"11104",2019,0,0,110,110
"11105",2015,0,0,55,55
"11105",2017,0,0,132,132
"11105",2018,0,0,45,45
"11105",2019,0,0,45,45
"11105",2020,0,0,45,45
"11106",2014,0,0,137,137
"11106",2015,0,0,55,55
"11106",2017,0,0,86,86
"11106",2018,0,0,98,98
"11106",2019,0,0,17,17
"11106",2020,0,0,45,45
"11107",2015,0,0,55,55
"11107",2017,0,0,15,15
"11107",2018,0,0,45,45
"11107",2019,0,0,110,110
"11108",2015,0,0,55,55
"11108",2017,0,0,12,12
"11108",2018,0,0,45,45
"11108",2019,0,0,110,110
"11109",2015,0,0,55,55
"11109",2017,0,0,132,132
"11109",2018,0,0,45,45
"11109",2019,0,0,110,110
"11110",2014,0,0,137,137
"11110",2015,0,0,55,55
"11110",2017,0,0,132,132
"11110",2018,0,0,98,98
"11110",2019,0,0,8,8
"11110",2020,0,0,45,45
"11111",2014,0,0,137,137
"11111",2015,0,0,55,55
"11111",2017,0,0,132,132
"11111",2018,0,0,98,98
"11111",2019,0,0,8,8
"11111",2020,0,0,45,45
"11112",2014,0,0,137,137
"11112",2015,0,0,55,55
"11112",2017,0,0,67,67
"11112",2018,0,0,98,98
"11112",2020,0,0,45,45
"11115",2015,0,0,55,55
"11115",2018,0,0,83,83
"11115",2019,0,0,17,17
"11115",2020,0,0,45,45
"11116",2014,0,0,137,137
"11116",2015,0,0,55,55
"11116",2017,0,0,86,86
"11116",2018,0,0,98,98
"11116",2019,0,0,17,17
"11116",2020,0,0,45,45
"11117",2014,0,0,137,137
"11117",2015,0,0,55,55
"11117",2017,0,0,67,67
"11117",2018,0,0,98,98
"11117",2020,0,0,45,45
"11118",2014,0,0,137,137
"11118",2015,0,0,55,55
"11118",2017,0,0,67,67
"11118",2018,0,0,98,98
"11118",2020,0,0,45,45
"11119",2015,0,0,55,55
"11119",2017,0,0,132,132
"11119",2018,0,0,45,45
"11119",2019,0,0,110,110
"11120",2015,0,0,55,55
"11120",2017,0,0,132,132
"11120",2018,0,0,45,45
"11120",2019,0,0,110,110
"11121",2015,0,0,55,55
"11121",2017,0,0,132,132
"11121",2018,0,0,45,45
"11121",2019,0,0,110,110
"11122",2014,0,0,137,137
"11122",2017,0,0,33,33
"11122",2018,0,0,98,98
"11122",2019,0,0,8,8
"11122",2020,0,0,44,44
"11124",2014,0,0,137,137
"11124",2015,0,0,55,55
"11124",2017,0,0,95,95
"11124",2018,0,0,98,98
"11124",2019,0,0,52,52
"11124",2020,0,0,27,27
"11125",2014,0,0,137,137
"11125",2015,0,0,55,55
"11125",2017,0,0,47,47
"11125",2018,0,0,98,98
"11125",2020,0,0,27,27
"11126",2014,0,0,137,137
"11126",2015,0,0,55,55
"11126",2017,0,0,132,132
"11126",2018,0,0,98,98
"11126",2019,0,0,8,8
"11126",2020,0,0,45,45
"11127",2015,0,0,55,55
"11127",2017,0,0,132,132
"11127",2018,0,0,45,45
"11127",2019,0,0,45,45
"11127",2020,0,0,45,45
"11128",2015,0,0,55,55
"11128",2018,0,0,45,45
"11128",2019,0,0,110,110
"11129",2015,0,0,55,55
"11129",2017,0,0,132,132
"11129",2018,0,0,45,45
"11129",2019,0,0,45,45
"11129",2020,0,0,45,45
"11130",2015,0,0,55,55
"11130",2017,0,0,15,15
"11130",2018,0,0,45,45
"11130",2019,0,0,110,110
"11131",2015,0,0,55,55
"11131",2017,0,0,132,132
"11131",2018,0,0,45,45
"11131",2019,0,0,110,110
"11132",2014,0,0,137,137
"11132",2015,0,0,55,55
"11132",2017,0,0,132,132
"11132",2018,0,0,98,98
"11132",2019,0,0,8,8
"11132",2020,0,0,45,45
"11133",2014,0,0,137,137
"11133",2015,0,0,55,55
"11133",2017,0,0,132,132
"11133",2018,0,0,98,98
"11133",2019,0,0,8,8
"11133",2020,0,0,45,45
"11135",2015,0,0,55,55
"11135",2017,0,0,132,132
"11135",2018,0,0,45,45
"11135",2019,0,0,110,110
"11136",2015,0,0,55,55
"11136",2018,0,0,45,45
"11136",2019,0,0,17,17
"11136",2020,0,0,45,45
"11137",2014,0,0,137,137
"11137",2015,0,0,55,55
"11137",2017,0,0,67,67
"11137",2018,0,0,98,98
"11137",2020,0,0,45,45
"11138",2018,0,0,45,45
"11138",2019,0,0,17,17
"11138",2020,0,0,45,45
"11139",2015,0,0,55,55
"11139",2018,0,0,45,45
"11139",2019,0,0,17,17
"11139",2020,0,0,45,45
"11140",2014,0,0,137,137
"11140",2015,0,0,55,55
"11140",2017,0,0,132,132
"11140",2018,0,0,98,98
"11140",2019,0,0,8,8
"11140",2020,0,0,45,45
"11141",2015,0,0,55,55
"11141",2018,0,0,45,45
"11141",2019,0,0,17,17
"11141",2020,0,0,45,45
"11142",2015,0,0,55,55
"11142",2017,0,0,15,15
"11142",2018,0,0,45,45
"11142",2019,0,0,110,110
"11143",2014,0,0,137,137
"11143",2015,0,0,55,55
"11143",2017,0,0,95,95
"11143",2018,0,0,98,98
"11143",2019,0,0,52,52
"11143",2020,0,0,27,27
"11144",2014,0,0,137,137
"11144",2015,0,0,55,55
"11144",2017,0,0,95,95
"11144",2018,0,41,98,139
"11144",2019,0,0,52,52
"11144",2020,0,0,27,27
"11145",2014,0,0,137,137
"11145",2015,0,0,55,55
"11145",2016,0,49,0,49
"11145",2017,0,70,86,156
"11145",2018,0,0,98,98
"11145",2019,0,116,17,133
"11145",2020,0,0,45,45
"11146",2014,0,0,137,137
"11146",2017,0,0,33,33
"11146",2018,0,0,98,98
"11146",2019,0,0,8,8
"11146",2020,0,0,44,44
"11147",2015,0,0,55,55
"11147",2017,0,0,132,132
"11147",2018,0,0,45,45
"11147",2019,0,0,45,45
"11147",2020,0,0,45,45
"11148",2014,0,0,137,137
"11148",2015,0,0,55,55
"11148",2017,0,0,132,132
"11148",2018,0,0,98,98
"11148",2019,0,0,8,8
"11148",2020,0,0,45,45
"11149",2018,0,0,45,45
"11149",2019,0,0,17,17
"11150",2015,0,0,55,55
"11150",2018,0,0,83,83
"11150",2019,0,0,17,17
"11150",2020,0,0,45,45
"11151",2014,0,0,137,137
"11151",2015,0,0,55,55
"11151",2017,0,0,103,103
"11151",2018,0,0,98,98
"11151",2019,0,0,8,8
"11151",2020,0,0,45,45
"11152",2014,0,0,137,137
"11152",2015,0,0,55,55
"11152",2017,0,0,115,115
"11152",2018,0,0,98,98
"11152",2019,0,0,8,8
"11152",2020,0,0,45,45
"11153",2018,0,0,45,45
"11153",2019,0,0,17,17
"11153",2020,0,0,45,45
"11154",2015,0,0,55,55
"11154",2017,0,0,99,99
"11154",2018,0,0,83,83
"11154",2019,0,0,99,99
"11154",2020,0,0,45,45
"11155",2014,0,0,137,137
"11155",2015,0,0,55,55
"11155",2017,0,0,67,67
"11155",2018,0,0,98,98
"11155",2020,0,0,45,45
"11156",2015,0,0,55,55
"11156",2018,0,0,83,83
"11156",2019,0,0,17,17
"11156",2020,0,0,45,45
"11157",2014,0,0,137,137
"11157",2015,0,0,55,55
"11157",2017,0,0,95,95
"11157",2018,0,0,98,98
"11157",2019,0,0,52,52
"11157",2020,0,0,27,27
"11158",2015,0,0,55,55
"11158",2017,0,0,132,132
"11158",2018,0,0,45,45
"11158",2019,0,0,110,110
"11160",2015,0,0,55,55
"11160",2017,0,0,132,132
"11160",2018,0,0,45,45
"11160",2019,0,0,110,110
"11161",2015,0,0,55,55
"11161",2017,0,0,132,132
"11161",2018,0,0,45,45
"11161",2019,0,0,110,110
"11164",2014,0,0,137,137
"11164",2015,0,0,55,55
"11164",2017,0,0,95,95
"11164",2018,0,0,98,98
"11164",2019,0,0,44,44
"11164",2020,0,0,62,62
"11165",2015,0,0,55,55
"11165",2017,0,0,132,132
"11165",2018,0,0,45,45
"11165",2019,0,0,110,110
"11167",2015,0,0,55,55
"11167",2017,0,0,132,132
"11167",2018,0,0,45,45
"11167",2019,0,0,110,110
"11168",2015,0,0,55,55
"11168",2017,0,0,132,132
"11168",2018,0,0,45,45
"11168",2019,0,0,110,110
"11169",2014,0,0,137,137
"11169",2015,0,0,55,55
"11169",2017,0,0,132,132
"11169",2018,0,0,98,98
"11169",2019,0,0,8,8
"11169",2020,0,0,45,45
"11170",2014,0,0,137,137
"11170",2015,0,0,55,55
"11170",2017,0,0,95,95
"11170",2018,0,0,98,98
"11170",2019,0,0,17,17
"11170",2020,0,0,45,45
"11172",2014,0,0,137,137
"11172",2016,0,0,9,9
"11172",2017,0,0,33,33
"11172",2018,0,0,83,83
"11172",2019,0,0,17,17
"11172",2020,0,0,44,44
"11173",2015,0,0,55,55
"11173",2017,0,0,12,12
"11173",2018,0,0,45,45
"11173",2019,0,0,110,110
"11174",2015,0,0,55,55
"11174",2017,0,0,99,99
"11174",2018,0,0,83,83
"11174",2019,0,0,99,99
"11174",2020,0,0,45,45
"11175",2018,0,0,45,45
"11175",2019,0,0,17,17
"11175",2020,0,0,45,45
"11176",2014,0,0,137,137
"11176",2015,0,0,55,55
"11176",2017,0,0,132,132
"11176",2018,0,0,98,98
"11176",2019,0,0,8,8
"11176",2020,0,0,45,45
"11177",2015,0,0,55,55
"11177",2017,0,0,132,132
"11177",2018,0,0,45,45
"11177",2019,0,0,110,110
"11178",2018,0,0,45,45
"11178",2019,0,0,17,17
"11178",2020,0,0,45,45
"11179",2014,0,0,137,137
"11179",2015,0,0,55,55
"11179",2017,0,0,132,132
"11179",2018,0,0,98,98
"11179",2019,0,0,8,8
"11179",2020,0,0,45,45
"11180",2015,0,0,55,55
"11180",2017,0,0,99,99
"11180",2018,0,0,83,83
"11180",2019,0,0,99,99
"11180",2020,0,0,45,45
"11181",2018,0,0,45,45
"11181",2019,0,0,17,17
"11181",2020,0,0,45,45
"11182",2018,0,0,45,45
"11182",2019,0,0,17,17
"11182",2020,0,0,45,45
"11183",2014,0,0,137,137
"11183",2015,0,0,55,55
"11183",2017,0,0,132,132
"11183",2018,0,0,98,98
"11183",2019,0,0,8,8
"11183",2020,0,0,45,45
"11185",2014,0,0,137,137
"11185",2015,0,0,55,55
"11185",2017,0,0,132,132
"11185",2018,0,0,98,98
"11185",2019,0,0,8,8
"11185",2020,0,0,45,45
"11186",2014,0,0,137,137
"11186",2015,0,0,55,55
"11186",2017,0,0,132,132
"11186",2018,0,0,98,98
"11186",2019,0,0,8,8
"11186",2020,0,0,45,45
"11187",2014,0,0,137,137
"11187",2015,0,0,55,55
"11187",2017,0,0,132,132
"11187",2018,0,0,98,98
"11187",2019,0,0,8,8
"11187",2020,0,0,45,45
"11188",2014,0,0,137,137
"11188",2015,0,0,55,55
"11188",2017,0,0,95,95
"11188",2018,0,0,98,98
"11188",2019,0,0,52,52
"11188",2020,0,0,27,27
"11189",2018,0,0,45,45
"11189",2019,0,0,17,17
"11189",2020,0,0,45,45
"11190",2014,0,0,137,137
"11190",2017,0,0,33,33
"11190",2018,0,0,98,98
"11190",2019,0,0,8,8
"11190",2020,0,0,44,44
"11191",2014,0,0,137,137
"11191",2015,0,0,55,55
"11191",2017,0,0,67,67
"11191",2018,0,0,98,98
"11191",2020,0,0,45,45
"11192",2018,0,0,45,45
"11192",2019,0,0,17,17
"11192",2020,0,0,45,45
"11193",2018,0,0,45,45
"11193",2019,0,0,17,17
"11193",2020,0,0,45,45
"11194",2015,0,0,55,55
"11194",2017,0,0,99,99
"11194",2018,0,0,83,83
"11194",2019,0,0,99,99
"11194",2020,0,0,45,45
"11195",2018,0,0,45,45
"11195",2019,0,0,17,17
"11195",2020,0,0,45,45
"11196",2018,0,0,45,45
"11196",2019,0,0,17,17
"11197",2015,0,0,55,55
"11197",2017,0,0,132,132
"11197",2018,0,0,45,45
"11197",2019,0,0,110,110
"11198",2014,0,0,137,137
"11198",2016,0,0,9,9
"11198",2017,0,0,33,33
"11198",2018,0,0,83,83
"11198",2019,0,0,52,52
"11198",2020,0,0,44,44
"11199",2015,0,0,55,55
"11199",2018,0,0,45,45
"11199",2019,0,0,17,17
"11199",2020,0,0,45,45
"11200",2014,0,0,137,137
"11200",2016,0,0,9,9
"11200",2017,0,0,33,33
"11200",2018,0,0,83,83
"11200",2019,0,0,52,52
"11200",2020,0,0,44,44
"11201",2015,0,0,55,55
"11201",2017,0,0,132,132
"11201",2018,0,0,45,45
"11201",2019,0,0,110,110
"11202",2014,0,0,137,137
"11202",2015,0,0,55,55
"11202",2017,0,0,95,95
"11202",2018,0,41,98,139
"11202",2019,0,0,52,52
"11202",2020,0,0,27,27
"11203",2014,0,0,137,137
"11203",2015,0,0,55,55
"11203",2017,0,0,103,103
"11203",2018,0,0,98,98
"11203",2019,0,0,35,35
"11203",2020,0,0,62,62
"11204",2015,0,0,55,55
"11204",2017,0,0,15,15
"11204",2018,0,0,45,45
"11204",2019,0,0,110,110
"11205",2015,0,0,55,55
"11205",2017,0,0,99,99
"11205",2018,0,0,83,83
"11205",2019,0,0,99,99
"11205",2020,0,0,45,45
"11206",2015,0,0,55,55
"11206",2017,0,0,132,132
"11206",2018,0,0,45,45
"11206",2019,0,0,45,45
"11206",2020,0,0,45,45
"11207",2015,0,0,55,55
"11207",2017,0,0,132,132
"11207",2018,0,0,45,45
"11207",2019,0,0,110,110
"11209",2015,0,0,55,55
"11209",2017,0,0,132,132
"11209",2018,0,0,45,45
"11209",2019,0,0,45,45
"11209",2020,0,0,45,45
"11210",2014,0,0,137,137
"11210",2015,0,0,55,55
"11210",2017,0,0,132,132
"11210",2018,0,0,98,98
"11210",2019,0,0,8,8
"11210",2020,0,0,45,45
"11211",2015,0,0,55,55
"11211",2017,0,0,132,132
"11211",2018,0,0,45,45
"11211",2019,0,0,110,110
"11212",2014,0,0,137,137
"11212",2015,0,0,55,55
"11212",2016,0,0,49,49
"11212",2017,0,0,112,112
"11212",2018,0,0,98,98
"11212",2019,0,0,143,143
"11212",2020,0,0,62,62
"11213",2014,0,0,137,137
"11213",2015,0,0,55,55
"11213",2017,0,0,67,67
"11213",2018,0,0,98,98
"11213",2020,0,0,45,45
"11214",2015,0,0,55,55
"11214",2017,0,0,132,132
"11214",2018,0,0,45,45
"11214",2019,0,0,110,110
"11215",2014,0,0,137,137
"11215",2016,0,0,9,9
"11215",2017,0,0,33,33
"11215",2018,0,0,83,83
"11215",2019,0,0,52,52
"11215",2020,0,0,44,44
"11216",2015,0,0,55,55
"11216",2017,0,0,132,132
"11216",2018,0,0,45,45
"11216",2019,0,0,110,110
"11217",2014,0,0,137,137
"11217",2015,0,0,55,55
"11217",2017,0,0,103,103
"11217",2018,0,0,98,98
"11217",2019,0,0,35,35
"11217",2020,0,0,62,62
"11219",2015,0,0,55,55
"11219",2017,0,0,132,132
"11219",2018,0,0,45,45
"11219",2019,0,0,110,110
"11220",2014,0,0,137,137
"11220",2017,0,0,33,33
"11220",2018,0,0,98,98
"11220",2019,0,0,8,8
"11220",2020,0,0,44,44
"11221",2015,0,0,55,55
"11221",2018,0,0,83,83
"11221",2019,0,0,17,17
"11221",2020,0,0,45,45
"11222",2015,0,0,55,55
"11222",2017,0,0,99,99
"11222",2018,0,0,83,83
"11222",2019,0,0,99,99
"11222",2020,0,0,45,45
"11223",2014,0,0,137,137
"11223",2015,0,0,55,55
"11223",2017,0,0,132,132
"11223",2018,0,0,98,98
"11223",2019,0,0,8,8
"11223",2020,0,0,45,45
"11224",2014,0,0,137,137
"11224",2015,0,0,55,55
"11224",2017,0,0,67,67
"11224",2018,0,0,98,98
"11224",2020,0,0,45,45
"11225",2018,0,0,45,45
"11225",2019,0,0,17,17
"11227",2014,0,0,137,137
"11227",2015,0,0,55,55
"11227",2017,0,0,132,132
"11227",2018,0,0,98,98
"11227",2019,0,0,8,8
"11227",2020,0,0,45,45
"11228",2015,0,0,55,55
"11228",2017,0,0,132,132
"11228",2018,0,0,45,45
"11228",2019,0,0,110,110
"11229",2015,0,0,55,55
"11229",2017,0,0,132,132
"11229",2018,0,0,45,45
"11229",2019,0,0,110,110
"11230",2015,0,0,55,55
"11230",2017,0,0,15,15
"11230",2018,0,0,45,45
"11230",2019,0,0,110,110
"11232",2015,0,0,55,55
"11232",2017,0,0,99,99
"11232",2018,0,0,83,83
"11232",2019,0,0,99,99
"11232",2020,0,0,45,45
"11233",2014,0,0,137,137
"11233",2015,0,0,55,55
"11233",2017,0,0,95,95
"11233",2018,0,0,98,98
"11233",2019,0,0,44,44
"11233",2020,0,0,62,62
"11234",2018,0,0,45,45
"11234",2019,0,0,17,17
"11235",2015,0,0,55,55
"11235",2017,0,0,132,132
"11235",2018,0,0,45,45
"11235",2019,0,0,110,110
"11238",2018,0,0,45,45
"11238",2019,0,0,17,17
"11240",2015,0,0,55,55
"11240",2017,0,0,132,132
"11240",2018,0,0,45,45
"11240",2019,0,0,45,45
"11240",2020,0,0,45,45
"11241",2014,0,0,137,137
"11241",2015,0,0,55,55
"11241",2017,0,0,132,132
"11241",2018,0,0,98,98
"11241",2019,0,0,8,8
"11241",2020,0,0,45,45
"11242",2015,0,0,55,55
"11242",2017,0,0,132,132
"11242",2018,0,0,45,45
"11242",2019,0,0,110,110
"11243",2018,0,0,45,45
"11243",2019,0,0,17,17
"11244",2015,0,0,55,55
"11244",2017,0,0,67,67
"11244",2018,0,0,45,45
"11246",2015,0,0,55,55
"11246",2017,0,0,132,132
"11246",2018,0,0,45,45
"11246",2019,0,0,110,110
"11247",2015,0,0,55,55
"11247",2017,0,0,15,15
"11247",2018,0,0,45,45
"11247",2019,0,0,110,110
"11248",2014,0,0,137,137
"11248",2015,0,0,55,55
"11248",2017,0,0,132,132
"11248",2018,0,0,98,98
"11248",2019,0,0,8,8
"11248",2020,0,0,45,45
"11249",2017,0,0,15,15
"11250",2014,0,0,137,137
"11250",2015,0,0,55,55
"11250",2017,0,0,132,132
"11250",2018,0,0,98,98
"11250",2019,0,0,8,8
"11250",2020,0,0,45,45
"11251",2014,0,0,137,137
"11251",2015,0,0,55,55
"11251",2017,0,0,132,132
"11251",2018,0,0,98,98
"11251",2019,0,0,8,8
"11251",2020,0,0,45,45
"11252",2018,0,0,45,45
"11252",2019,0,0,17,17
"11253",2015,0,0,55,55
"11253",2018,0,0,83,83
"11253",2019,0,0,17,17
"11253",2020,0,0,45,45
"11254",2015,0,0,55,55
"11254",2018,0,0,45,45
"11254",2019,0,0,17,17
"11254",2020,0,0,45,45
"11255",2014,0,0,137,137
"11255",2015,0,0,55,55
"11255",2017,0,0,115,115
"11255",2018,0,0,98,98
"11255",2019,0,0,8,8
"11255",2020,0,0,45,45
"11256",2014,0,0,137,137
"11256",2015,0,0,55,55
"11256",2017,0,0,132,132
"11256",2018,0,0,98,98
"11256",2019,0,0,8,8
"11256",2020,0,0,45,45
"11257",2014,0,0,137,137
"11257",2015,0,0,55,55
"11257",2017,0,0,132,132
"11257",2018,0,0,98,98
"11257",2019,0,0,8,8
"11257",2020,0,0,45,45
"11258",2014,0,0,137,137
"11258",2015,0,0,55,55
"11258",2017,0,0,86,86
"11258",2018,0,0,98,98
"11258",2019,0,0,35,35
"11258",2020,0,0,62,62
"11259",2018,0,0,45,45
"11259",2019,0,0,17,17
"11259",2020,0,0,45,45
"11260",2014,0,0,137,137
"11260",2015,0,0,55,55
"11260",2017,0,0,132,132
"11260",2018,0,0,98,98
"11260",2019,0,0,8,8
"11260",2020,0,0,45,45
"11261",2014,0,0,137,137
"11261",2015,0,0,55,55
"11261",2017,0,0,132,132
"11261",2018,0,0,98,98
"11261",2019,0,0,8,8
"11261",2020,0,0,45,45
"11262",2014,0,0,137,137
"11262",2015,0,0,55,55
"11262",2017,0,0,86,86
"11262",2018,0,0,98,98
"11262",2019,0,0,8,8
"11262",2020,0,0,45,45
"11263",2015,0,0,55,55
"11263",2017,0,0,15,15
"11263",2018,0,0,45,45
"11263",2019,0,0,110,110
"11264",2014,0,0,137,137
"11264",2015,0,0,55,55
"11264",2017,0,0,115,115
"11264",2018,0,0,98,98
"11264",2019,0,0,8,8
"11264",2020,0,0,45,45
"11265",2015,0,0,55,55
"11265",2017,0,0,132,132
"11265",2018,0,0,45,45
"11265",2019,0,0,110,110
"11266",2014,0,0,137,137
"11266",2015,0,0,55,55
"11266",2017,0,0,95,95
"11266",2018,0,0,98,98
"11266",2019,0,0,17,17
"11266",2020,0,0,45,45
"11267",2014,0,0,137,137
"11267",2015,0,0,55,55
"11267",2017,0,0,132,132
"11267",2018,0,0,98,98
"11267",2019,0,0,8,8
"11267",2020,0,0,45,45
"11269",2014,0,0,137,137
"11269",2015,0,0,55,55
"11269",2017,0,0,95,95
"11269",2018,0,0,98,98
"11269",2019,0,0,17,17
"11269",2020,0,0,45,45
"11271",2014,0,0,137,137
"11271",2015,0,0,55,55
"11271",2017,0,0,67,67
"11271",2018,0,0,98,98
"11271",2020,0,0,45,45
"11272",2014,0,0,137,137
"11272",2015,0,0,55,55
"11272",2017,0,0,132,132
"11272",2018,0,0,98,98
"11272",2019,0,0,8,8
"11272",2020,0,0,45,45
"11273",2014,0,0,137,137
"11273",2015,0,0,55,55
"11273",2017,0,0,103,103
"11273",2018,0,0,98,98
"11273",2019,0,0,35,35
"11273",2020,0,0,62,62
"11274",2015,0,0,55,55
"11274",2017,0,0,132,132
"11274",2018,0,0,45,45
"11274",2019,0,0,110,110
"11275",2018,0,0,45,45
"11275",2019,0,0,17,17
"11279",2015,0,0,55,55
"11279",2018,0,0,83,83
"11279",2019,0,0,17,17
"11279",2020,0,0,45,45
"11280",2014,0,0,137,137
"11280",2016,0,0,9,9
"11280",2017,0,0,33,33
"11280",2018,0,0,83,83
"11280",2019,0,0,52,52
"11280",2020,0,0,44,44
"11281",2018,0,0,45,45
"11281",2019,0,0,17,17
"11281",2020,0,0,45,45
"11282",2015,0,0,55,55
"11282",2017,0,0,15,15
"11282",2018,0,0,45,45
"11282",2019,0,0,110,110
"11284",2018,0,0,45,45
"11284",2019,0,0,17,17
"11284",2020,0,0,45,45
"11285",2014,0,0,137,137
"11285",2015,0,0,55,55
"11285",2017,0,0,115,115
"11285",2018,0,0,98,98
"11285",2019,0,0,8,8
"11285",2020,0,0,45,45
"11286",2014,0,0,137,137
"11286",2016,0,0,9,9
"11286",2017,0,0,33,33
"11286",2018,0,0,83,83
"11286",2019,0,0,52,52
"11286",2020,0,0,44,44
"11287",2015,0,0,55,55
"11287",2017,0,0,132,132
"11287",2018,0,0,45,45
"11287",2019,0,0,110,110
"11288",2018,0,0,45,45
"11288",2019,0,0,17,17
"11288",2020,0,0,45,45
"11289",2015,0,0,55,55
"11289",2017,0,0,132,132
"11289",2018,0,0,45,45
"11289",2019,0,0,45,45
"11289",2020,0,0,45,45
"11292",2018,0,0,45,45
"11292",2019,0,0,17,17
"11292",2020,0,0,45,45
"11293",2015,0,0,55,55
"11293",2017,0,0,132,132
"11293",2018,0,0,45,45
"11293",2019,0,0,45,45
"11293",2020,0,0,45,45
"11294",2015,0,0,55,55
"11294",2017,0,0,15,15
"11294",2018,0,0,45,45
"11294",2019,0,0,110,110
"11295",2014,0,0,137,137
"11295",2015,0,0,55,55
"11295",2017,0,0,115,115
"11295",2018,0,0,98,98
"11295",2019,0,0,8,8
"11295",2020,0,0,45,45
"11296",2014,0,0,137,137
"11296",2015,0,0,55,55
"11296",2016,0,0,49,49
"11296",2017,0,0,112,112
"11296",2018,0,0,98,98
"11296",2019,0,0,143,143
"11296",2020,0,0,62,62
"11297",2015,0,0,55,55
"11297",2017,0,0,99,99
"11297",2018,0,0,83,83
"11297",2019,0,0,99,99
"11297",2020,0,0,45,45
"11299",2015,0,0,55,55
"11299",2017,0,0,132,132
"11299",2018,0,0,45,45
"11299",2019,0,0,45,45
"11299",2020,0,0,45,45
"11300",2018,0,0,45,45
"11300",2019,0,0,17,17
"11300",2020,0,0,45,45
"11301",2014,0,0,137,137
"11301",2017,0,0,33,33
"11301",2018,0,0,98,98
"11301",2019,0,0,8,8
"11301",2020,0,0,44,44
"11302",2015,0,0,55,55
"11302",2017,0,0,67,67
"11302",2018,0,0,45,45
"11303",2015,0,0,55,55
"11303",2017,0,0,15,15
"11303",2018,0,0,45,45
"11303",2019,0,0,110,110
"11304",2015,0,0,55,55
"11304",2017,0,0,132,132
"11304",2018,0,0,45,45
"11304",2019,0,0,45,45
"11304",2020,0,0,45,45
"11305",2014,0,0,137,137
"11305",2015,0,0,55,55
"11305",2017,0,0,67,67
"11305",2018,0,0,98,98
"11305",2020,0,0,45,45
"11306",2015,0,0,55,55
"11306",2017,0,0,132,132
"11306",2018,0,0,45,45
"11306",2019,0,0,45,45
"11306",2020,0,0,45,45
"11307",2014,0,0,137,137
"11307",2015,0,0,55,55
"11307",2017,0,0,103,103
"11307",2018,0,0,98,98
"11307",2019,0,0,35,35
"11307",2020,0,0,62,62
"11308",2018,0,0,45,45
"11308",2019,0,0,17,17
"11308",2020,0,0,45,45
"11309",2015,0,0,55,55
"11309",2017,0,0,132,132
"11309",2018,0,0,45,45
"11309",2019,0,0,110,110
"11310",2015,0,0,55,55
"11310",2017,0,0,132,132
"11310",2018,0,0,45,45
"11310",2019,0,0,110,110
"11311",2014,0,0,137,137
"11311",2015,0,0,55,55
"11311",2017,0,0,132,132
"11311",2018,0,0,98,98
"11311",2019,0,0,8,8
"11311",2020,0,0,45,45
"11313",2018,0,0,45,45
"11313",2019,0,0,17,17
"11313",2020,0,0,45,45
"11314",2014,0,0,137,137
"11314",2015,0,0,55,55
"11314",2017,0,0,132,132
"11314",2018,0,0,98,98
"11314",2019,0,0,8,8
"11314",2020,0,0,45,45
"11315",2014,0,0,137,137
"11315",2016,0,0,9,9
"11315",2017,0,0,33,33
"11315",2018,0,0,83,83
"11315",2019,0,0,52,52
"11315",2020,0,0,44,44
"11316",2015,0,0,55,55
"11316",2017,0,0,15,15
"11316",2018,0,0,45,45
"11316",2019,0,0,110,110
"11317",2015,0,0,55,55
"11317",2017,0,0,132,132
"11317",2018,0,0,45,45
"11317",2019,0,0,110,110
"11318",2014,0,0,137,137
"11318",2017,0,0,33,33
"11318",2018,0,0,98,98
"11318",2019,0,0,8,8
"11318",2020,0,0,44,44
"11319",2015,0,0,55,55
"11319",2017,0,0,99,99
"11319",2018,0,0,83,83
"11319",2019,0,0,99,99
"11319",2020,0,0,45,45
"11320",2015,0,0,55,55
"11320",2017,0,0,132,132
"11320",2018,0,0,45,45
"11320",2019,0,0,110,110
"11321",2015,0,0,55,55
"11321",2017,0,0,132,132
"11321",2018,0,0,45,45
"11321",2019,0,0,45,45
"11321",2020,0,0,45,45
"11322",2014,0,0,137,137
"11322",2015,0,0,55,55
"11322",2017,0,0,95,95
"11322",2018,0,0,98,98
"11322",2019,0,0,52,52
"11322",2020,0,0,27,27
"11323",2015,0,0,55,55
"11323",2017,0,0,132,132
"11323",2018,0,0,45,45
"11323",2019,0,0,110,110
"11324",2014,0,0,137,137
"11324",2015,0,0,55,55
"11324",2017,0,0,103,103
"11324",2018,0,0,98,98
"11324",2019,0,0,35,35
"11324",2020,0,0,62,62
"11325",2015,0,0,55,55
"11325",2017,0,0,132,132
"11325",2018,0,0,45,45
"11325",2019,0,0,45,45
"11325",2020,0,0,45,45
"11327",2015,0,0,55,55
"11327",2017,0,0,132,132
"11327",2018,0,0,45,45
"11327",2019,0,0,110,110
"11328",2015,0,0,55,55
"11328",2017,0,0,132,132
"11328",2018,0,0,45,45
"11328",2019,0,0,110,110
"11330",2014,0,0,137,137
"11330",2016,0,0,9,9
"11330",2017,0,0,33,33
"11330",2018,0,0,83,83
"11330",2019,0,0,52,52
"11330",2020,0,0,44,44
"11332",2014,0,0,137,137
"11332",2015,0,0,55,55
"11332",2017,0,0,115,115
"11332",2018,0,0,98,98
"11332",2019,0,0,8,8
"11332",2020,0,0,45,45
"11333",2015,0,0,55,55
"11333",2017,0,0,15,15
"11333",2018,0,0,45,45
"11333",2019,0,0,110,110
"11335",2015,0,0,55,55
"11335",2017,0,0,67,67
"11335",2018,0,0,45,45
"11335",2020,0,0,45,45
"11336",2017,0,0,15,15
"11337",2014,0,0,137,137
"11337",2015,0,0,55,55
"11337",2017,0,0,103,103
"11337",2018,0,0,98,98
"11337",2019,0,0,8,8
"11337",2020,0,0,45,45
"11338",2015,0,0,55,55
"11338",2017,0,0,15,15
"11338",2018,0,0,45,45
"11338",2019,0,0,110,110
"11339",2018,0,0,45,45
"11339",2019,0,0,17,17
"11339",2020,0,0,45,45
"11340",2018,0,0,45,45
"11340",2019,0,0,17,17
"11340",2020,0,0,45,45
"11341",2015,0,0,55,55
"11341",2017,0,0,132,132
"11341",2018,0,0,45,45
"11341",2019,0,0,110,110
"11342",2014,0,0,137,137
"11342",2016,0,0,9,9
"11342",2017,0,0,33,33
"11342",2018,0,0,83,83
"11342",2019,0,0,52,52
"11342",2020,0,0,44,44
"11344",2015,0,0,55,55
"11344",2017,0,0,132,132
"11344",2018,0,0,45,45
"11344",2019,0,0,110,110
"11345",2014,0,0,137,137
"11345",2015,0,0,55,55
"11345",2017,0,0,95,95
"11345",2018,0,0,98,98
"11345",2019,0,0,52,52
"11345",2020,0,0,27,27
"11346",2015,0,0,55,55
"11346",2017,0,0,15,15
"11346",2018,0,0,45,45
"11346",2019,0,0,110,110
"11347",2015,0,0,55,55
"11347",2017,0,0,132,132
"11347",2018,0,0,45,45
"11347",2019,0,0,110,110
"11350",2015,0,0,55,55
"11350",2017,0,0,132,132
"11350",2018,0,0,45,45
"11350",2019,0,0,110,110
"11351",2014,0,0,137,137
"11351",2015,0,0,55,55
"11351",2017,0,0,132,132
"11351",2018,0,0,98,98
"11351",2019,0,0,8,8
"11351",2020,0,0,45,45
"11352",2015,0,0,55,55
"11352",2017,0,0,132,132
"11352",2018,0,0,45,45
"11352",2019,0,0,110,110
"11353",2014,0,0,137,137
"11353",2015,0,0,55,55
"11353",2017,0,0,103,103
"11353",2018,0,0,98,98
"11353",2019,0,0,35,35
"11353",2020,0,0,62,62
"11354",2014,0,0,137,137
"11354",2015,0,0,55,55
"11354",2017,0,0,132,132
"11354",2018,0,0,98,98
"11354",2019,0,0,8,8
"11354",2020,0,0,45,45
"11355",2015,0,0,55,55
"11355",2017,0,0,132,132
"11355",2018,0,0,45,45
"11355",2019,0,0,110,110
"11356",2018,0,0,45,45
"11356",2019,0,0,17,17
"11356",2020,0,0,45,45
"11357",2018,0,0,45,45
"11357",2019,0,0,17,17
"11357",2020,0,0,45,45
"11358",2015,0,0,55,55
"11358",2017,0,0,67,67
"11358",2018,0,0,45,45
"11358",2020,0,0,45,45
"11360",2014,0,0,137,137
"11360",2015,0,0,55,55
"11360",2017,0,0,103,103
"11360",2018,0,0,98,98
"11360",2019,0,0,35,35
"11360",2020,0,0,62,62
"11361",2018,0,0,45,45
"11361",2019,0,0,17,17
"11361",2020,0,0,45,45
"11362",2018,0,0,45,45
"11362",2019,0,0,17,17
"11363",2014,0,0,137,137
"11363",2015,0,0,55,55
"11363",2017,0,0,132,132
"11363",2018,0,0,98,98
"11363",2019,0,0,8,8
"11363",2020,0,0,45,45
"11364",2015,0,0,55,55
"11364",2017,0,0,132,132
"11364",2018,0,0,45,45
"11364",2019,0,0,110,110
"11366",2014,0,0,137,137
"11366",2015,0,0,55,55
"11366",2016,0,0,49,49
"11366",2017,0,0,112,112
"11366",2018,0,0,98,98
"11366",2019,0,0,143,143
"11366",2020,0,0,62,62
"11367",2018,0,0,45,45
"11367",2019,0,0,17,17
"11367",2020,0,0,45,45
"11368",2015,0,0,55,55
"11368",2017,0,0,99,99
"11368",2018,0,0,83,83
"11368",2019,0,0,99,99
"11368",2020,0,0,45,45
"11369",2014,0,0,137,137
"11369",2015,0,0,55,55
"11369",2017,0,0,86,86
"11369",2018,0,0,98,98
"11369",2019,0,0,44,44
"11369",2020,0,0,62,62
"11370",2014,0,0,137,137
"11370",2015,0,0,55,55
"11370",2017,0,0,86,86
"11370",2018,0,0,98,98
"11370",2019,0,0,17,17
"11370",2020,0,0,45,45
"11372",2015,0,0,55,55
"11372",2017,0,0,99,99
"11372",2018,0,0,83,83
"11372",2019,0,0,99,99
"11372",2020,0,0,45,45
"11373",2015,0,0,55,55
"11373",2017,0,0,67,67
"11373",2018,0,0,45,45
"11374",2014,0,0,137,137
"11374",2015,0,0,55,55
"11374",2017,0,0,132,132
"11374",2018,0,0,98,98
"11374",2019,0,0,8,8
"11374",2020,0,0,45,45
"11376",2015,0,0,55,55
"11376",2017,0,0,132,132
"11376",2018,0,0,45,45
"11376",2019,0,0,110,110
"11377",2015,0,0,55,55
"11377",2017,0,0,132,132
"11377",2018,0,0,45,45
"11377",2019,0,0,110,110
"11378",2014,0,0,137,137
"11378",2015,0,0,55,55
"11378",2017,0,0,132,132
"11378",2018,0,0,98,98
"11378",2019,0,0,8,8
"11378",2020,0,0,45,45
"11379",2014,0,0,137,137
"11379",2015,0,0,55,55
"11379",2017,0,0,95,95
"11379",2018,0,0,98,98
"11379",2019,0,0,52,52
"11379",2020,0,0,27,27
"11380",2017,0,0,15,15
"11381",2014,0,0,137,137
"11381",2015,0,0,55,55
"11381",2017,0,0,67,67
"11381",2018,0,0,98,98
"11381",2020,0,0,45,45
"11382",2018,0,0,45,45
"11382",2019,0,0,17,17
"11382",2020,0,0,45,45
"11383",2018,0,0,45,45
"11383",2019,0,0,17,17
"11383",2020,0,0,45,45
"11384",2014,0,0,137,137
"11384",2015,0,0,55,55
"11384",2017,0,0,67,67
"11384",2018,0,0,98,98
"11384",2020,0,0,45,45
"11385",2018,0,0,45,45
"11385",2019,0,0,17,17
"11385",2020,0,0,45,45
"11386",2014,0,0,137,137
"11386",2015,0,0,55,55
"11386",2017,0,0,67,67
"11386",2018,0,0,98,98
"11386",2020,0,0,45,45
"11387",2014,0,0,137,137
"11387",2015,0,0,55,55
"11387",2017,0,0,132,132
"11387",2018,0,0,98,98
"11387",2019,0,0,8,8
"11387",2020,0,0,45,45
"11388",2014,0,0,137,137
"11388",2015,0,0,55,55
"11388",2017,0,0,132,132
"11388",2018,0,0,98,98
"11388",2019,0,0,8,8
"11388",2020,0,0,45,45
"11389",2015,0,0,55,55
"11389",2017,0,0,132,132
"11389",2018,0,0,45,45
"11389",2019,0,0,110,110
"11390",2014,0,0,137,137
"11390",2015,0,0,55,55
"11390",2017,0,0,115,115
"11390",2018,0,0,98,98
"11390",2019,0,0,8,8
"11390",2020,0,0,45,45
"11391",2015,0,0,55,55
"11391",2018,0,0,83,83
"11391",2019,0,0,17,17
"11391",2020,0,0,45,45
"11392",2014,0,0,137,137
"11392",2015,0,0,55,55
"11392",2017,0,0,132,132
"11392",2018,0,0,98,98
"11392",2019,0,0,8,8
"11392",2020,0,0,45,45
"11393",2014,0,0,137,137
"11393",2017,0,0,33,33
"11393",2018,0,0,98,98
"11393",2019,0,0,8,8
"11393",2020,0,0,44,44
"11394",2015,0,0,55,55
"11394",2017,0,0,132,132
"11394",2018,0,0,45,45
"11394",2019,0,0,110,110
"11395",2015,0,0,55,55
"11395",2017,0,0,99,99
"11395",2018,0,0,83,83
"11395",2019,0,0,99,99
"11395",2020,0,0,45,45
"11396",2014,0,0,137,137
"11396",2016,0,0,9,9
"11396",2017,0,0,33,33
"11396",2018,0,0,83,83
"11396",2019,0,0,52,52
"11396",2020,0,0,44,44
"11397",2014,0,0,137,137
"11397",2017,0,0,33,33
"11397",2018,0,0,98,98
"11397",2019,0,0,8,8
"11397",2020,0,0,44,44
"11398",2014,0,0,137,137
"11398",2015,0,0,55,55
"11398",2017,0,0,95,95
"11398",2018,0,0,98,98
"11398",2019,0,0,52,52
"11398",2020,0,0,27,27
"11399",2018,0,0,45,45
"11399",2019,0,0,17,17
"11399",2020,0,0,45,45
"11400",2017,0,0,15,15
"11401",2014,0,0,137,137
"11401",2015,0,0,55,55
"11401",2017,0,0,47,47
"11401",2018,0,0,98,98
"11401",2020,0,0,27,27
"11402",2015,0,0,55,55
"11402",2017,0,0,132,132
"11402",2018,0,0,45,45
"11402",2019,0,0,110,110
"11404",2018,0,0,45,45
"11404",2019,0,0,17,17
"11404",2020,0,0,45,45
"11405",2014,0,0,137,137
"11405",2015,0,0,55,55
"11405",2017,0,0,103,103
"11405",2018,0,0,98,98
"11405",2019,0,0,35,35
"11405",2020,0,0,62,62
"11406",2015,0,0,55,55
"11406",2017,0,0,132,132
"11406",2018,0,0,45,45
"11406",2019,0,0,110,110
"11407",2018,0,0,45,45
"11407",2019,0,0,17,17
"11407",2020,0,0,45,45
"11408",2015,0,0,55,55
"11408",2017,0,0,132,132
"11408",2018,0,0,45,45
"11408",2019,0,0,110,110
"11409",2014,0,0,137,137
"11409",2015,0,0,55,55
"11409",2017,0,0,132,132
"11409",2018,0,0,98,98
"11409",2019,0,0,8,8
"11409",2020,0,0,45,45
"11410",2015,0,0,55,55
"11410",2017,0,0,99,99
"11410",2018,0,0,83,83
"11410",2019,0,0,45,45
"11410",2020,0,0,45,45
"11411",2015,0,0,55,55
"11411",2017,0,0,99,99
"11411",2018,0,0,83,83
"11411",2019,0,0,99,99
"11411",2020,0,0,45,45
"11412",2015,0,0,55,55
"11412",2017,0,0,132,132
"11412",2018,0,0,45,45
"11412",2019,0,0,110,110
"11413",2015,0,0,55,55
"11413",2017,0,0,99,99
"11413",2018,0,0,83,83
"11413",2019,0,0,99,99
"11413",2020,0,0,45,45
"11414",2014,0,0,137,137
"11414",2015,0,0,55,55
"11414",2017,0,0,132,132
"11414",2018,0,0,98,98
"11414",2019,0,0,8,8
"11414",2020,0,0,45,45
"11415",2015,0,0,55,55
"11415",2017,0,0,132,132
"11415",2018,0,0,45,45
"11415",2019,0,0,110,110
"11416",2014,0,0,137,137
"11416",2016,0,0,9,9
"11416",2017,0,0,33,33
"11416",2018,0,0,83,83
"11416",2019,0,0,52,52
"11416",2020,0,0,44,44
"11417",2015,0,0,55,55
"11417",2018,0,0,45,45
"11417",2019,0,0,17,17
"11417",2020,0,0,45,45
"11418",2018,0,0,45,45
"11418",2019,0,0,17,17
"11418",2020,0,0,45,45
"11420",2015,0,0,55,55
"11420",2017,0,0,132,132
"11420",2018,0,0,45,45
"11420",2019,0,0,110,110
"11421",2014,0,0,137,137
"11421",2015,0,0,55,55
"11421",2017,0,0,132,132
"11421",2018,0,0,98,98
"11421",2019,0,0,8,8
"11421",2020,0,0,45,45
"11422",2014,0,0,137,137
"11422",2015,0,0,55,55
"11422",2017,0,0,103,103
"11422",2018,0,0,98,98
"11422",2019,0,0,8,8
"11422",2020,0,0,45,45
"11423",2015,0,0,55,55
"11423",2017,0,0,132,132
"11423",2018,0,0,45,45
"11423",2019,0,0,110,110
"11424",2015,0,0,55,55
"11424",2017,0,0,15,15
"11424",2018,0,0,45,45
"11424",2019,0,0,110,110
"11425",2015,0,0,55,55
"11425",2017,0,0,99,99
"11425",2018,0,0,83,83
"11425",2019,0,0,99,99
"11425",2020,0,0,45,45
"11426",2015,0,0,55,55
"11426",2017,0,0,99,99
"11426",2018,0,0,83,83
"11426",2019,0,0,99,99
"11426",2020,0,0,45,45
"11427",2015,0,0,55,55
"11427",2017,0,0,15,15
"11427",2018,0,0,45,45
"11427",2019,0,0,110,110
"11428",2018,0,0,45,45
"11428",2019,0,0,17,17
"11428",2020,0,0,45,45
"11429",2015,0,0,55,55
"11429",2018,0,0,83,83
"11429",2019,0,0,17,17
"11429",2020,0,0,45,45
"11430",2018,0,0,45,45
"11430",2019,0,0,17,17
"11431",2014,0,0,137,137
"11431",2015,0,0,55,55
"11431",2017,0,0,47,47
"11431",2018,0,0,98,98
"11431",2020,0,0,27,27
"11432",2018,0,0,45,45
"11432",2019,0,0,17,17
"11432",2020,0,0,45,45
"11433",2014,0,0,137,137
"11433",2016,0,0,9,9
"11433",2017,0,0,33,33
"11433",2018,0,0,83,83
"11433",2019,0,0,52,52
"11433",2020,0,0,44,44
"11434",2018,0,0,45,45
"11434",2019,0,0,17,17
"11434",2020,0,0,45,45
"11435",2014,0,0,137,137
"11435",2015,0,0,55,55
"11435",2017,0,0,115,115
"11435",2018,0,0,98,98
"11435",2019,0,0,8,8
"11435",2020,0,0,45,45
"11436",2014,0,0,137,137
"11436",2015,0,0,55,55
"11436",2017,0,0,95,95
"11436",2018,0,0,98,98
"11436",2019,0,0,52,52
"11436",2020,0,0,27,27
"11437",2018,0,0,45,45
"11437",2019,0,0,17,17
"11437",2020,0,0,45,45
"11438",2018,0,0,45,45
"11438",2019,0,0,17,17
"11438",2020,0,0,45,45
"11439",2018,0,0,45,45
"11439",2019,0,0,17,17
"11439",2020,0,0,45,45
"11440",2014,0,0,137,137
"11440",2015,0,0,55,55
"11440",2017,0,0,132,132
"11440",2018,0,0,98,98
"11440",2019,0,0,8,8
"11440",2020,0,0,45,45
"11441",2014,0,0,137,137
"11441",2015,0,0,55,55
"11441",2017,0,0,95,95
"11441",2018,0,0,98,98
"11441",2019,0,0,52,52
"11441",2020,0,0,27,27
"12002",2017,0,0,82,82
"12002",2018,0,0,7,7
"12002",2019,0,0,55,55
"12006",2017,0,0,82,82
"12006",2018,0,0,7,7
"12006",2019,0,0,69,69
"12006",2020,0,0,49,49
"12007",2017,0,0,7,7
"12011",2017,0,0,82,82
"12011",2018,0,0,7,7
"12011",2019,0,0,69,69
"12011",2020,0,0,49,49
"12013",2017,0,0,7,7
"12015",2017,0,0,82,82
"12015",2018,0,0,7,7
"12015",2019,0,0,69,69
"12015",2020,0,0,49,49
"12017",2017,0,0,82,82
"12017",2018,0,0,7,7
"12017",2019,0,0,55,55
"12018",2017,0,0,7,7
"12022",2017,0,0,82,82
"12022",2018,0,0,7,7
"12022",2019,0,0,55,55
"12028",2017,0,0,7,7
"12030",2017,0,0,7,7
"12036",2015,0,0,11,11
"12036",2017,0,0,7,7
"12036",2018,0,0,33,33
"12036",2019,0,0,14,14
"12036",2020,0,0,35,35
"12037",2017,0,0,89,89
"12038",2017,0,0,82,82
"12038",2018,0,0,7,7
"12038",2019,0,0,55,55
"12041",2017,0,0,82,82
"12041",2018,0,0,7,7
"12041",2019,0,0,69,69
"12041",2020,0,0,49,49
"12042",2017,0,0,89,89
"12045",2017,0,0,82,82
"12045",2018,0,0,7,7
"12045",2019,0,0,69,69
"12045",2020,0,0,49,49
"12046",2017,0,0,82,82
"12046",2018,0,0,7,7
"12046",2019,0,0,69,69
"12046",2020,0,0,49,49
"12048",2015,0,0,11,11
"12048",2017,0,0,7,7
"12048",2018,0,0,33,33
"12048",2019,0,0,14,14
"12048",2020,0,0,35,35
"12050",2017,0,0,82,82
"12050",2018,0,0,7,7
"12050",2019,0,0,69,69
"12050",2020,0,0,49,49
"12051",2015,0,0,11,11
"12051",2017,0,0,7,7
"12051",2018,0,0,33,33
"12051",2019,0,0,14,14
"12051",2020,0,0,35,35
"12053",2017,0,0,7,7
"12055",2015,0,0,11,11
"12055",2017,0,0,7,7
"12055",2018,0,0,33,33
"12055",2019,0,0,14,14
"12055",2020,0,0,35,35
"12057",2017,0,0,82,82
"12057",2018,0,0,7,7
"12057",2019,0,0,69,69
"12057",2020,0,0,28,28
"12058",2015,0,0,11,11
"12058",2017,0,0,7,7
"12058",2018,0,0,33,33
"12058",2019,0,0,14,14
"12058",2020,0,0,35,35
"12059",2017,0,0,82,82
"12059",2018,0,0,28,28
"12059",2019,0,0,20,20
"12059",2020,0,0,49,49
"12060",2017,0,0,82,82
"12060",2018,0,0,7,7
"12060",2019,0,0,69,69
"12060",2020,0,0,49,49
"12061",2015,0,0,11,11
"12061",2017,0,0,7,7
"12061",2018,0,0,33,33
"12061",2019,0,0,14,14
"12061",2020,0,0,35,35
"12062",2017,0,0,82,82
"12062",2018,0,0,7,7
"12062",2019,0,0,69,69
"12062",2020,0,0,49,49
"12063",2017,0,0,89,89
"12063",2018,0,0,7,7
"12063",2019,0,0,41,41
"12064",2015,0,0,11,11
"12064",2017,0,0,7,7
"12064",2018,0,0,33,33
"12064",2019,0,0,14,14
"12064",2020,0,0,35,35
"12065",2017,0,0,82,82
"12065",2018,0,0,7,7
"12065",2019,0,0,69,69
"12065",2020,0,0,49,49
"12067",2018,0,0,7,7
"12067",2020,0,0,21,21
"12070",2017,0,0,82,82
"12070",2018,0,0,7,7
"12070",2019,0,0,55,55
"12072",2017,0,0,82,82
"12072",2018,0,0,7,7
"12072",2019,0,0,55,55
"12073",2017,0,0,82,82
"12073",2018,0,0,7,7
"12073",2019,0,0,69,69
"12073",2020,0,0,49,49
"12074",2015,0,0,11,11
"12074",2017,0,0,7,7
"12074",2018,0,0,33,33
"12074",2019,0,0,14,14
"12074",2020,0,0,35,35
"12075",2017,0,0,82,82
"12075",2018,0,0,7,7
"12075",2019,0,0,69,69
"12075",2020,0,0,49,49
"12077",2017,0,0,89,89
"12077",2018,0,0,7,7
"12077",2020,0,0,21,21
"12078",2017,0,0,89,89
"12079",2015,0,0,11,11
"12079",2017,0,0,7,7
"12079",2018,0,0,33,33
"12079",2019,0,0,14,14
"12079",2020,0,0,35,35
"12082",2017,0,0,89,89
"12082",2018,0,0,7,7
"12082",2019,0,0,6,6
"12082",2020,0,0,42,42
"12083",2017,0,0,7,7
"12084",2017,0,0,82,82
"12084",2018,0,0,7,7
"12084",2019,0,0,55,55
"12085",2017,0,0,82,82
"12085",2018,0,0,7,7
"12085",2019,0,0,69,69
"12085",2020,0,0,28,28
"12086",2017,0,0,82,82
"12086",2018,0,0,7,7
"12086",2019,0,0,55,55
"12088",2015,0,0,11,11
"12088",2017,0,0,7,7
"12088",2018,0,0,33,33
"12088",2019,0,0,14,14
"12088",2020,0,0,35,35
"12089",2017,0,0,7,7
"12092",2017,0,0,82,82
"12092",2018,0,0,7,7
"12092",2019,0,0,69,69
"12092",2020,0,0,49,49
"12097",2017,0,0,7,7
"12098",2015,0,0,11,11
"12098",2017,0,0,7,7
"12098",2018,0,0,33,33
"12098",2019,0,0,14,14
"12098",2020,0,0,35,35
"12101",2017,0,0,7,7
"12103",2015,0,0,11,11
"12103",2017,0,0,7,7
"12103",2018,0,0,33,33
"12103",2019,0,0,14,14
"12103",2020,0,0,35,35
"12104",2017,0,0,7,7
"12113",2017,0,0,82,82
"12113",2018,0,0,7,7
"12113",2019,0,0,69,69
"12113",2020,0,0,49,49
"12115",2017,0,0,89,89
"12115",2018,0,0,7,7
"12115",2019,0,0,41,41
"12116",2015,0,0,11,11
"12116",2017,0,0,7,7
"12116",2018,0,0,33,33
"12116",2019,0,0,14,14
"12116",2020,0,0,35,35
"12118",2015,0,0,11,11
"12118",2017,0,0,7,7
"12118",2018,0,0,33,33
"12118",2019,0,0,14,14
"12118",2020,0,0,35,35
"12119",2015,0,0,11,11
"12119",2017,0,0,7,7
"12119",2018,0,0,33,33
"12119",2019,0,0,14,14
"12119",2020,0,0,35,35
"12122",2017,0,0,82,82
"12122",2018,0,0,7,7
"12122",2019,0,0,55,55
"12127",2017,0,0,82,82
"12127",2018,0,0,7,7
"12127",2019,0,0,69,69
"12127",2020,0,0,49,49
"12129",2017,0,0,82,82
"12129",2018,0,0,7,7
"12129",2019,0,0,69,69
"12129",2020,0,0,49,49
"12130",2017,0,0,7,7
"12139",2017,0,0,89,89
"12139",2018,0,0,7,7
"12139",2019,0,0,35,35
"12140",2017,0,0,14,14
"12144",2017,0,0,82,82
"12144",2018,0,0,7,7
"12144",2019,0,0,69,69
"12144",2020,0,0,49,49
"12145",2017,0,0,82,82
"12145",2018,0,0,7,7
"12145",2019,0,0,55,55
"12150",2017,0,0,7,7
"12150",2018,0,0,28,28
"12150",2019,0,0,20,20
"12151",2015,0,0,11,11
"12151",2017,0,0,7,7
"12151",2018,0,0,33,33
"12151",2019,0,0,14,14
"12151",2020,0,0,35,35
"12153",2017,0,0,82,82
"12153",2018,0,0,7,7
"12153",2019,0,0,55,55
"12156",2015,0,0,11,11
"12156",2017,0,0,7,7
"12156",2018,0,0,33,33
"12156",2019,0,0,14,14
"12156",2020,0,0,35,35
"12158",2017,0,0,7,7
"12160",2017,0,0,82,82
"12160",2018,0,0,7,7
"12160",2019,0,0,55,55
"12164",2015,0,0,11,11
"12164",2017,0,0,7,7
"12164",2018,0,0,33,33
"12164",2019,0,0,14,14
"12164",2020,0,0,35,35
"12166",2015,0,0,11,11
"12166",2017,0,0,7,7
"12166",2018,0,0,33,33
"12166",2019,0,0,14,14
"12166",2020,0,0,35,35
"12168",2017,0,0,89,89
"12168",2018,0,0,7,7
"12168",2019,0,0,41,41
"12169",2017,0,0,82,82
"12169",2018,0,0,7,7
"12169",2019,0,0,69,69
"12169",2020,0,0,49,49
"12172",2015,0,0,11,11
"12172",2017,0,0,7,7
"12172",2018,0,0,33,33
"12172",2019,0,0,14,14
"12172",2020,0,0,35,35
"12175",2017,0,0,7,7
"12178",2017,0,0,82,82
"12178",2018,0,0,7,7
"12178",2019,0,0,55,55
"12180",2017,0,0,82,82
"12180",2018,0,0,7,7
"12180",2019,0,0,55,55
"12184",2015,0,0,11,11
"12184",2017,0,0,7,7
"12184",2018,0,0,33,33
"12184",2019,0,0,14,14
"12184",2020,0,0,35,35
"12187",2015,0,0,11,11
"12187",2017,0,0,7,7
"12187",2018,0,0,33,33
"12187",2019,0,0,14,14
"12187",2020,0,0,35,35
"12188",2017,0,0,82,82
"12188",2018,0,0,7,7
"12188",2019,0,0,69,69
"12188",2020,0,0,49,49
"12189",2017,0,0,82,82
"12189",2018,0,0,7,7
"12189",2019,0,0,69,69
"12189",2020,0,0,49,49
"12194",2017,0,0,82,82
"12194",2018,0,0,7,7
"12194",2019,0,0,69,69
"12194",2020,0,0,49,49
"12197",2017,0,0,82,82
"12197",2018,0,0,7,7
"12197",2019,0,0,69,69
"12197",2020,0,0,49,49
"12198",2017,0,0,82,82
"12198",2018,0,0,28,28
"12198",2019,0,0,20,20
"12198",2020,0,0,49,49
"12200",2017,0,0,82,82
"12200",2018,0,0,7,7
"12200",2019,0,0,55,55
"12203",2017,0,0,89,89
"12203",2018,0,0,7,7
"12203",2019,0,0,41,41
"12204",2017,0,0,82,82
"12204",2018,0,0,7,7
"12204",2019,0,0,55,55
"12205",2017,0,0,7,7
"12205",2018,0,0,28,28
"12205",2019,0,0,20,20
"12207",2017,0,0,82,82
"12207",2018,0,0,7,7
"12207",2019,0,0,69,69
"12207",2020,0,0,49,49
"12209",2015,0,0,11,11
"12209",2017,0,0,7,7
"12209",2018,0,0,33,33
"12209",2019,0,0,14,14
"12209",2020,0,0,35,35
"12211",2017,0,0,82,82
"12211",2018,0,0,7,7
"12211",2019,0,0,55,55
"12212",2017,0,0,89,89
"12212",2018,0,0,7,7
"12212",2019,0,0,35,35
"12213",2017,0,0,82,82
"12213",2018,0,0,7,7
"12213",2019,0,0,69,69
"12213",2020,0,0,49,49
"12214",2015,0,0,11,11
"12214",2017,0,0,7,7
"12214",2018,0,0,33,33
"12214",2019,0,0,14,14
"12214",2020,0,0,35,35
"12216",2015,0,0,11,11
"12216",2017,0,0,7,7
"12216",2018,0,0,33,33
"12216",2019,0,0,14,14
"12216",2020,0,0,35,35
"12220",2017,0,0,89,89
"12220",2018,0,0,7,7
"12220",2019,0,0,41,41
"12223",2015,0,0,11,11
"12223",2017,0,0,7,7
"12223",2018,0,0,33,33
"12223",2019,0,0,14,14
"12223",2020,0,0,35,35
"12224",2015,0,0,11,11
"12224",2017,0,0,7,7
"12224",2018,0,0,33,33
"12224",2019,0,0,14,14
"12224",2020,0,0,35,35
"12225",2017,0,0,82,82
"12225",2018,0,0,7,7
"12225",2019,0,0,55,55
"12226",2015,0,0,11,11
"12226",2017,0,0,7,7
"12226",2018,0,0,33,33
"12226",2019,0,0,14,14
"12226",2020,0,0,35,35
"12229",2017,0,0,89,89
"12229",2018,0,0,7,7
"12229",2019,0,0,35,35
"12230",2017,0,0,82,82
"12230",2018,0,0,7,7
"12230",2019,0,0,69,69
"12230",2020,0,0,49,49
"12231",2017,0,0,82,82
"12231",2018,0,0,7,7
"12231",2019,0,0,6,6
"12231",2020,0,0,42,42
"12232",2017,0,0,89,89
"12232",2018,0,0,7,7
"12232",2019,0,0,41,41
"12234",2017,0,0,82,82
"12234",2018,0,0,7,7
"12234",2019,0,0,69,69
"12234",2020,0,0,28,28
"12235",2017,0,0,82,82
"12235",2018,0,0,7,7
"12235",2019,0,0,69,69
"12235",2020,0,0,28,28
"12236",2017,0,0,82,82
"12236",2018,0,0,7,7
"12236",2019,0,0,69,69
"12236",2020,0,0,49,49
"12238",2017,0,0,82,82
"12238",2018,0,0,7,7
"12238",2019,0,0,69,69
"12238",2020,0,0,49,49
"12240",2017,0,0,7,7
"12243",2017,0,0,82,82
"12243",2018,0,0,7,7
"12243",2019,0,0,55,55
"12244",2017,0,0,89,89
"12246",2017,0,0,7,7
"12250",2015,0,0,11,11
"12250",2017,0,0,7,7
"12250",2018,0,0,33,33
"12250",2019,0,0,14,14
"12250",2020,0,0,35,35
"12251",2017,0,0,82,82
"12251",2018,0,0,7,7
"12251",2019,0,0,55,55
"12253",2017,0,0,82,82
"12253",2018,0,0,7,7
"12253",2019,0,0,69,69
"12253",2020,0,0,49,49
"12255",2017,0,0,82,82
"12255",2018,0,0,7,7
"12255",2019,0,0,69,69
"12255",2020,0,0,49,49
"12256",2017,0,0,7,7
"12258",2017,0,0,82,82
"12258",2018,0,0,7,7
"12258",2019,0,0,69,69
"12258",2020,0,0,28,28
"12260",2017,0,0,89,89
"12260",2018,0,0,7,7
"12260",2019,0,0,6,6
"12260",2020,0,0,42,42
"12261",2017,0,0,7,7
"12262",2017,0,0,82,82
"12262",2018,0,0,7,7
"12262",2019,0,0,69,69
"12262",2020,0,0,49,49
"12263",2017,0,0,14,14
"12267",2017,0,0,82,82
"12267",2018,0,0,7,7
"12267",2019,0,0,69,69
"12267",2020,0,0,49,49
"12273",2015,0,0,11,11
"12273",2017,0,0,7,7
"12273",2018,0,0,33,33
"12273",2019,0,0,14,14
"12273",2020,0,0,35,35
"12276",2017,0,0,82,82
"12276",2018,0,0,7,7
"12276",2019,0,0,69,69
"12276",2020,0,0,28,28
"12277",2015,0,0,11,11
"12277",2017,0,0,7,7
"12277",2018,0,0,33,33
"12277",2019,0,0,14,14
"12277",2020,0,0,35,35
"12278",2017,0,0,82,82
"12278",2018,0,0,7,7
"12278",2019,0,0,69,69
"12278",2020,0,0,49,49
"12280",2015,0,0,11,11
"12280",2017,0,0,7,7
"12280",2018,0,0,33,33
"12280",2019,0,0,14,14
"12280",2020,0,0,35,35
"12282",2017,0,0,89,89
"12282",2018,0,0,7,7
"12282",2019,0,0,41,41
"12283",2017,0,0,82,82
"12283",2018,0,0,7,7
"12283",2019,0,0,69,69
"12283",2020,0,0,28,28
"12284",2017,0,0,82,82
"12284",2018,0,0,7,7
"12284",2019,0,0,55,55
"12287",2017,0,0,14,14
"12293",2017,0,0,82,82
"12293",2018,0,0,7,7
"12293",2019,0,0,55,55
"12295",2017,0,0,89,89
"12295",2018,0,0,7,7
"12295",2019,0,0,41,41
"12296",2017,0,0,82,82
"12296",2018,0,0,7,7
"12296",2019,0,0,55,55
"12299",2017,0,0,82,82
"12299",2018,0,0,7,7
"12299",2019,0,0,69,69
"12299",2020,0,0,49,49
"12305",2017,0,0,7,7
"12307",2017,0,0,82,82
"12307",2018,0,0,7,7
"12307",2019,0,0,69,69
"12307",2020,0,0,49,49
"13001",2015,0,73,73,146
"13001",2016,0,121,0,121
"13001",2017,0,0,7,7
"13001",2018,0,0,38,38
"13001",2019,0,36,0,36
"13002",2015,0,73,0,73
"13002",2016,0,121,0,121
"13002",2017,0,0,7,7
"13002",2018,0,0,38,38
"13002",2019,0,36,14,50
"13003",2015,0,73,73,146
"13003",2016,0,121,0,121
"13003",2017,0,0,48,48
"13003",2018,0,0,38,38
"13003",2019,0,36,36,72
"13003",2020,0,0,77,77
"13004",2015,0,73,0,73
"13004",2016,0,121,0,121
"13004",2017,0,0,115,115
"13004",2018,0,0,38,38
"13004",2019,0,36,79,115
"13004",2020,0,0,77,77
"13005",2015,0,73,0,73
"13005",2016,0,121,0,121
"13005",2017,0,0,7,7
"13005",2018,0,0,38,38
"13005",2019,0,36,14,50
"13006",2015,0,73,0,73
"13006",2016,0,121,0,121
"13006",2017,0,0,115,115
"13006",2018,0,0,38,38
"13006",2019,0,36,79,115
"13006",2020,0,0,77,77
"13007",2015,0,73,73,146
"13007",2016,0,121,0,121
"13007",2017,0,0,7,7
"13007",2018,0,0,38,38
"13007",2019,0,36,0,36
"13008",2015,0,73,73,146
"13008",2016,0,121,0,121
"13008",2017,0,0,48,48
"13008",2018,0,0,38,38
"13008",2019,0,36,36,72
"13008",2020,0,0,77,77
"13009",2015,0,73,73,146
"13009",2016,0,121,0,121
"13009",2017,0,0,48,48
"13009",2018,0,0,38,38
"13009",2019,0,36,36,72
"13009",2020,0,0,77,77
"13010",2015,0,73,0,73
"13010",2016,0,121,0,121
"13010",2017,0,0,115,115
"13010",2018,0,0,38,38
"13010",2019,0,36,79,115
"13010",2020,0,0,77,77
"13011",2015,0,73,0,73
"13011",2016,0,121,0,121
"13011",2017,0,0,115,115
"13011",2018,0,0,38,38
"13011",2019,0,36,79,115
"13011",2020,0,0,77,77
"13012",2015,0,73,73,146
"13012",2016,0,121,0,121
"13012",2017,0,0,7,7
"13012",2018,0,0,38,38
"13012",2019,0,36,0,36
"13013",2015,0,73,73,146
"13013",2016,0,121,0,121
"13013",2017,0,0,7,7
"13013",2018,0,0,38,38
"13013",2019,0,36,0,36
"13014",2015,0,73,73,146
"13014",2016,0,121,0,121
"13014",2017,0,0,7,7
"13014",2018,0,0,38,38
"13014",2019,0,36,0,36
"13014",2020,0,0,28,28
"13015",2015,0,73,73,146
"13015",2016,0,121,0,121
"13015",2017,0,0,7,7
"13015",2018,0,0,38,38
"13015",2019,0,36,0,36
"13016",2015,0,73,73,146
"13016",2016,0,121,0,121
"13016",2017,0,0,7,7
"13016",2018,0,0,38,38
"13016",2019,0,36,0,36
"13017",2015,0,73,0,73
"13017",2016,0,121,0,121
"13017",2017,0,0,115,115
"13017",2018,0,0,38,38
"13017",2019,0,36,79,115
"13017",2020,0,0,77,77
"13018",2015,0,73,0,73
"13018",2016,0,121,0,121
"13018",2017,0,0,115,115
"13018",2018,0,0,38,38
"13018",2019,0,36,79,115
"13018",2020,0,0,77,77
"13019",2015,0,73,73,146
"13019",2016,0,121,0,121
"13019",2017,0,0,7,7
"13019",2018,0,0,38,38
"13019",2019,0,36,0,36
"13020",2015,0,73,0,73
"13020",2016,0,121,0,121
"13020",2017,0,0,7,7
"13020",2018,0,0,38,38
"13020",2019,0,36,14,50
"13021",2015,0,73,0,73
"13021",2016,0,121,0,121
"13021",2017,0,0,115,115
"13021",2018,0,0,38,38
"13021",2019,0,36,79,115
"13021",2020,0,0,77,77
"13022",2015,0,73,0,73
"13022",2016,0,121,0,121
"13022",2017,0,0,115,115
"13022",2018,0,0,38,38
"13022",2019,0,36,79,115
"13022",2020,0,0,77,77
"13023",2015,0,73,0,73
"13023",2016,0,121,0,121
"13023",2017,0,0,115,115
"13023",2018,0,0,38,38
"13023",2019,0,36,79,115
"13023",2020,0,0,77,77
"13024",2015,0,73,0,73
"13024",2016,0,121,0,121
"13024",2017,0,0,115,115
"13024",2018,0,0,38,38
"13024",2019,0,36,79,115
"13024",2020,0,0,77,77
"13025",2015,0,73,73,146
"13025",2016,0,121,0,121
"13025",2017,0,0,7,7
"13025",2018,0,0,38,38
"13025",2019,0,36,0,36
"13026",2015,0,73,0,73
"13026",2016,0,121,0,121
"13026",2017,0,0,115,115
"13026",2018,0,0,38,38
"13026",2019,0,36,79,115
"13026",2020,0,0,77,77
"13027",2015,0,73,0,73
"13027",2016,0,121,0,121
"13027",2017,0,0,115,115
"13027",2018,0,0,38,38
"13027",2019,0,36,79,115
"13027",2020,0,0,77,77
"13028",2015,0,73,0,73
"13028",2016,0,121,0,121
"13028",2017,0,0,115,115
"13028",2018,0,0,38,38
"13028",2019,0,36,79,115
"13028",2020,0,0,77,77
"13029",2015,0,73,0,73
"13029",2016,0,121,0,121
"13029",2017,0,0,48,48
"13029",2018,0,0,38,38
"13029",2019,0,36,36,72
"13029",2020,0,0,77,77
"13030",2015,0,73,0,73
"13030",2016,0,121,0,121
"13030",2017,0,0,7,7
"13030",2018,0,0,38,38
"13030",2019,0,36,14,50
"13031",2015,0,73,0,73
"13031",2016,0,121,0,121
"13031",2017,0,0,115,115
"13031",2018,0,0,38,38
"13031",2019,0,36,79,115
"13031",2020,0,0,77,77
"13032",2015,0,73,73,146
"13032",2016,0,121,0,121
"13032",2017,0,0,7,7
"13032",2018,0,0,38,38
"13032",2019,0,36,0,36
"13033",2015,0,73,0,73
"13033",2016,0,121,0,121
"13033",2017,0,0,115,115
"13033",2018,0,0,38,38
"13033",2019,0,36,79,115
"13033",2020,0,0,77,77
"13034",2015,0,73,0,73
"13034",2016,0,121,0,121
"13034",2017,0,0,115,115
"13034",2018,0,0,38,38
"13034",2019,0,36,79,115
"13034",2020,0,0,77,77
"13035",2015,0,73,0,73
"13035",2016,0,121,0,121
"13035",2017,0,0,115,115
"13035",2018,0,0,38,38
"13035",2019,0,36,79,115
"13035",2020,0,0,77,77
"13036",2015,0,73,0,73
"13036",2016,0,121,0,121
"13036",2017,0,0,115,115
"13036",2018,0,0,38,38
"13036",2019,0,36,79,115
"13036",2020,0,0,77,77
"13037",2015,0,73,73,146
"13037",2016,0,121,0,121
"13037",2017,0,0,7,7
"13037",2018,0,0,38,38
"13037",2019,0,36,0,36
"13037",2020,0,0,28,28
"13038",2015,0,73,0,73
"13038",2016,0,121,0,121
"13038",2017,0,0,115,115
"13038",2018,0,0,38,38
"13038",2019,0,36,79,115
"13038",2020,0,0,77,77
"13039",2015,0,73,0,73
"13039",2016,0,121,0,121
"13039",2017,0,0,115,115
"13039",2018,0,0,38,38
"13039",2019,0,36,79,115
"13039",2020,0,0,77,77
"13040",2015,0,73,73,146
"13040",2016,0,121,0,121
"13040",2017,0,0,7,7
"13040",2018,0,0,38,38
"13040",2019,0,36,0,36
"13041",2015,0,73,73,146
"13041",2016,0,121,0,121
"13041",2017,0,0,7,7
"13041",2018,0,0,38,38
"13041",2019,0,36,0,36
"13042",2015,0,73,0,73
"13042",2016,0,121,0,121
"13042",2017,0,0,7,7
"13042",2018,0,0,38,38
"13042",2019,0,36,14,50
"13043",2015,0,73,0,73
"13043",2016,0,121,0,121
"13043",2017,0,0,115,115
"13043",2018,0,0,38,38
"13043",2019,0,36,79,115
"13043",2020,0,0,77,77
"13044",2015,0,73,0,73
"13044",2016,0,121,0,121
"13044",2017,0,0,48,48
"13044",2018,0,0,38,38
"13044",2019,0,36,36,72
"13044",2020,0,0,77,77
"13045",2015,0,73,0,73
"13045",2016,0,121,0,121
"13045",2017,0,0,115,115
"13045",2018,0,0,38,38
"13045",2019,0,36,79,115
"13045",2020,0,0,77,77
"13046",2015,0,73,73,146
"13046",2016,0,121,0,121
"13046",2017,0,0,7,7
"13046",2018,0,0,38,38
"13046",2019,0,36,0,36
"13047",2015,0,73,0,73
"13047",2016,0,121,0,121
"13047",2017,0,0,115,115
"13047",2018,0,0,38,38
"13047",2019,0,36,79,115
"13047",2020,0,0,77,77
"13048",2015,0,73,0,73
"13048",2016,0,121,0,121
"13048",2017,0,0,7,7
"13048",2018,0,0,38,38
"13048",2019,0,36,36,72
"13049",2015,0,73,73,146
"13049",2016,0,121,0,121
"13049",2017,0,0,48,48
"13049",2018,0,0,38,38
"13049",2019,0,36,36,72
"13049",2020,0,0,77,77
"13050",2015,0,73,73,146
"13050",2016,0,121,0,121
"13050",2017,0,0,48,48
"13050",2018,0,0,38,38
"13050",2019,0,36,36,72
"13050",2020,0,0,77,77
"13051",2015,0,73,73,146
"13051",2016,0,121,0,121
"13051",2017,0,0,7,7
"13051",2018,0,0,38,38
"13051",2019,0,36,0,36
"13051",2020,0,0,28,28
"13052",2015,0,73,0,73
"13052",2016,0,121,0,121
"13052",2017,0,0,115,115
"13052",2018,0,0,38,38
"13052",2019,0,36,79,115
"13052",2020,0,0,77,77
"13053",2015,0,73,0,73
"13053",2016,0,121,0,121
"13053",2017,0,0,115,115
"13053",2018,0,0,38,38
"13053",2019,0,36,79,115
"13053",2020,0,0,77,77
"13054",2015,0,73,0,73
"13054",2016,0,121,0,121
"13054",2017,0,0,115,115
"13054",2018,0,0,38,38
"13054",2019,0,36,79,115
"13054",2020,0,0,77,77
"13055",2015,0,73,0,73
"13055",2016,0,121,0,121
"13055",2017,0,0,7,7
"13055",2018,0,0,38,38
"13055",2019,0,36,14,50
"13056",2015,0,73,0,73
"13056",2016,0,121,0,121
"13056",2017,0,0,115,115
"13056",2018,0,0,38,38
"13056",2019,0,36,79,115
"13056",2020,0,0,77,77
"13057",2015,0,73,0,73
"13057",2016,0,121,0,121
"13057",2017,0,0,115,115
"13057",2018,0,0,38,38
"13057",2019,0,36,79,115
"13057",2020,0,0,77,77
"13058",2015,0,73,0,73
"13058",2016,0,121,0,121
"13058",2017,0,0,115,115
"13058",2018,0,0,38,38
"13058",2019,0,36,79,115
"13058",2020,0,0,77,77
"13059",2015,0,73,0,73
"13059",2016,0,121,0,121
"13059",2017,0,0,115,115
"13059",2018,0,0,38,38
"13059",2019,0,36,79,115
"13059",2020,0,0,77,77
"13060",2015,0,73,73,146
"13060",2016,0,121,0,121
"13060",2017,0,0,7,7
"13060",2018,0,0,38,38
"13060",2019,0,36,0,36
"13061",2015,0,73,0,73
"13061",2016,0,121,0,121
"13061",2017,0,0,115,115
"13061",2018,0,0,38,38
"13061",2019,0,36,79,115
"13061",2020,0,0,77,77
"13062",2015,0,73,73,146
"13062",2016,0,121,0,121
"13062",2017,0,0,7,7
"13062",2018,0,0,38,38
"13062",2019,0,36,0,36
"13063",2015,0,73,0,73
"13063",2016,0,121,0,121
"13063",2017,0,0,48,48
"13063",2018,0,0,38,38
"13063",2019,0,36,36,72
"13063",2020,0,0,77,77
"13064",2015,0,73,0,73
"13064",2016,0,121,0,121
"13064",2017,0,0,115,115
"13064",2018,0,0,38,38
"13064",2019,0,36,79,115
"13064",2020,0,0,77,77
"13065",2015,0,73,0,73
"13065",2016,0,121,0,121
"13065",2017,0,0,115,115
"13065",2018,0,0,38,38
"13065",2019,0,36,79,115
"13065",2020,0,0,77,77
"13066",2015,0,73,0,73
"13066",2016,0,121,0,121
"13066",2017,0,0,115,115
"13066",2018,0,0,38,38
"13066",2019,0,36,79,115
"13066",2020,0,0,77,77
"13067",2015,0,73,0,73
"13067",2016,0,121,0,121
"13067",2017,0,0,115,115
"13067",2018,0,0,38,38
"13067",2019,0,36,79,115
"13067",2020,0,0,77,77
"13068",2015,0,73,0,73
"13068",2016,0,121,0,121
"13068",2017,0,0,115,115
"13068",2018,0,0,38,38
"13068",2019,0,36,79,115
"13068",2020,0,0,77,77
"13069",2015,0,73,73,146
"13069",2016,0,121,0,121
"13069",2017,0,0,48,48
"13069",2018,0,0,38,38
"13069",2019,0,36,36,72
"13069",2020,0,0,77,77
"13070",2015,0,73,0,73
"13070",2016,0,121,0,121
"13070",2017,0,0,7,7
"13070",2018,0,0,38,38
"13070",2019,0,36,14,50
"13071",2015,0,73,73,146
"13071",2016,0,121,0,121
"13071",2017,0,0,7,7
"13071",2018,0,0,38,38
"13071",2019,0,36,0,36
"13072",2015,0,73,73,146
"13072",2016,0,121,0,121
"13072",2017,0,0,7,7
"13072",2018,0,0,38,38
"13072",2019,0,36,0,36
"13073",2015,0,73,0,73
"13073",2016,0,121,0,121
"13073",2017,0,0,7,7
"13073",2018,0,0,38,38
"13073",2019,0,36,14,50
"13074",2015,0,73,0,73
"13074",2016,0,121,0,121
"13074",2017,0,0,7,7
"13074",2018,0,0,38,38
"13074",2019,0,36,36,72
"13075",2015,0,73,0,73
"13075",2016,0,121,0,121
"13075",2017,0,0,7,7
"13075",2018,0,0,38,38
"13075",2019,0,36,14,50
"13076",2015,0,73,0,73
"13076",2016,0,121,0,121
"13076",2017,0,0,115,115
"13076",2018,0,0,38,38
"13076",2019,0,36,79,115
"13076",2020,0,0,77,77
"13077",2015,0,73,0,73
"13077",2016,0,121,0,121
"13077",2017,0,0,115,115
"13077",2018,0,0,38,38
"13077",2019,0,36,79,115
"13077",2020,0,0,77,77
"13078",2015,0,73,0,73
"13078",2016,0,121,0,121
"13078",2017,0,0,115,115
"13078",2018,0,0,38,38
"13078",2019,0,36,79,115
"13078",2020,0,0,77,77
"13079",2015,0,73,73,146
"13079",2016,0,121,0,121
"13079",2017,0,0,7,7
"13079",2018,0,0,38,38
"13079",2019,0,36,0,36
"13080",2015,0,73,73,146
"13080",2016,0,121,0,121
"13080",2017,0,0,48,48
"13080",2018,0,0,38,38
"13080",2019,0,36,36,72
"13080",2020,0,0,77,77
"13081",2015,0,73,73,146
"13081",2016,0,121,0,121
"13081",2017,0,0,7,7
"13081",2018,0,0,38,38
"13081",2019,0,36,0,36
"13081",2020,0,0,28,28
"13082",2015,0,73,73,146
"13082",2016,0,121,0,121
"13082",2017,0,0,48,48
"13082",2018,0,0,38,38
"13082",2019,0,36,36,72
"13082",2020,0,0,77,77
"13083",2015,0,73,0,73
"13083",2016,0,121,0,121
"13083",2017,0,0,115,115
"13083",2018,0,0,38,38
"13083",2019,0,36,79,115
"13083",2020,0,0,77,77
"13084",2015,0,73,0,73
"13084",2016,0,121,0,121
"13084",2017,0,0,115,115
"13084",2018,0,0,38,38
"13084",2019,0,36,79,115
"13084",2020,0,0,77,77
"13085",2015,0,73,0,73
"13085",2016,0,121,0,121
"13085",2017,0,0,7,7
"13085",2018,0,0,38,38
"13085",2019,0,36,14,50
"13086",2015,0,73,0,73
"13086",2016,0,121,0,121
"13086",2017,0,0,7,7
"13086",2018,0,0,38,38
"13086",2019,0,36,14,50
"13087",2015,0,73,73,146
"13087",2016,0,121,0,121
"13087",2017,0,0,7,7
"13087",2018,0,0,38,38
"13087",2019,0,36,0,36
"13088",2015,0,73,0,73
"13088",2016,0,121,0,121
"13088",2017,0,0,115,115
"13088",2018,0,0,38,38
"13088",2019,0,36,79,115
"13088",2020,0,0,77,77
"13089",2015,0,73,0,73
"13089",2016,0,121,0,121
"13089",2017,0,0,115,115
"13089",2018,0,0,38,38
"13089",2019,0,36,79,115
"13089",2020,0,0,77,77
"13090",2015,0,73,73,146
"13090",2016,0,121,0,121
"13090",2017,0,0,7,7
"13090",2018,0,0,38,38
"13090",2019,0,36,0,36
"13091",2015,0,73,73,146
"13091",2016,0,121,0,121
"13091",2017,0,0,7,7
"13091",2018,0,0,38,38
"13091",2019,0,36,0,36
"13092",2015,0,73,73,146
"13092",2016,0,121,0,121
"13092",2017,0,0,48,48
"13092",2018,0,0,38,38
"13092",2019,0,36,36,72
"13092",2020,0,0,77,77
"13093",2015,0,73,0,73
"13093",2016,0,121,0,121
"13093",2017,0,0,115,115
"13093",2018,0,0,38,38
"13093",2019,0,36,79,115
"13093",2020,0,0,77,77
"13094",2015,0,73,0,73
"13094",2016,0,121,0,121
"13094",2017,0,0,115,115
"13094",2018,0,0,38,38
"13094",2019,0,36,79,115
"13094",2020,0,0,77,77
"13095",2015,0,73,73,146
"13095",2016,0,121,0,121
"13095",2017,0,0,7,7
"13095",2018,0,0,38,38
"13095",2019,0,36,0,36
"13096",2015,0,73,0,73
"13096",2016,0,121,0,121
"13096",2017,0,0,115,115
"13096",2018,0,0,38,38
"13096",2019,0,36,79,115
"13096",2020,0,0,77,77
"13097",2015,0,73,0,73
"13097",2016,0,121,0,121
"13097",2017,0,0,115,115
"13097",2018,0,0,38,38
"13097",2019,0,36,79,115
"13097",2020,0,0,77,77
"13098",2015,0,73,0,73
"13098",2016,0,121,0,121
"13098",2017,0,0,115,115
"13098",2018,0,0,38,38
"13098",2019,0,36,79,115
"13098",2020,0,0,77,77
"13099",2015,0,73,0,73
"13099",2016,0,121,0,121
"13099",2017,0,0,115,115
"13099",2018,0,0,38,38
"13099",2019,0,36,79,115
"13099",2020,0,0,77,77
"13100",2015,0,73,0,73
"13100",2016,0,121,0,121
"13100",2017,0,0,115,115
"13100",2018,0,0,38,38
"13100",2019,0,36,79,115
"13100",2020,0,0,77,77
"13101",2015,0,73,73,146
"13101",2016,0,121,0,121
"13101",2017,0,0,7,7
"13101",2018,0,0,38,38
"13101",2019,0,36,0,36
"13102",2015,0,73,0,73
"13102",2016,0,121,0,121
"13102",2017,0,0,115,115
"13102",2018,0,0,38,38
"13102",2019,0,36,79,115
"13102",2020,0,0,77,77
"13103",2015,0,73,73,146
"13103",2016,0,121,0,121
"13103",2017,0,0,48,48
"13103",2018,0,0,38,38
"13103",2019,0,36,36,72
"13103",2020,0,0,77,77
"13104",2015,0,73,0,73
"13104",2016,0,121,0,121
"13104",2017,0,0,115,115
"13104",2018,0,0,38,38
"13104",2019,0,36,79,115
"13104",2020,0,0,77,77
"13105",2015,0,73,0,73
"13105",2016,0,121,0,121
"13105",2017,0,0,115,115
"13105",2018,0,0,38,38
"13105",2019,0,36,79,115
"13105",2020,0,0,77,77
"13106",2015,0,73,73,146
"13106",2016,0,121,0,121
"13106",2017,0,0,7,7
"13106",2018,0,0,38,38
"13106",2019,0,36,0,36
"13107",2015,0,73,73,146
"13107",2016,0,121,0,121
"13107",2017,0,0,7,7
"13107",2018,0,0,38,38
"13107",2019,0,36,0,36
"13108",2015,0,73,0,73
"13108",2016,0,121,0,121
"13108",2017,0,0,115,115
"13108",2018,0,0,38,38
"13108",2019,0,36,79,115
"13108",2020,0,0,77,77
"13109",2015,0,73,73,146
"13109",2016,0,121,0,121
"13109",2017,0,0,7,7
"13109",2018,0,0,38,38
"13109",2019,0,36,0,36
"13110",2015,0,73,73,146
"13110",2016,0,121,0,121
"13110",2017,0,0,7,7
"13110",2018,0,0,38,38
"13110",2019,0,36,0,36
"13111",2015,0,73,73,146
"13111",2016,0,121,0,121
"13111",2017,0,0,7,7
"13111",2018,0,0,38,38
"13111",2019,0,36,0,36
"13112",2015,0,73,73,146
"13112",2016,0,121,0,121
"13112",2017,0,0,7,7
"13112",2018,0,0,38,38
"13112",2019,0,36,0,36
"13113",2015,0,73,73,146
"13113",2016,0,121,0,121
"13113",2017,0,0,7,7
"13113",2018,0,0,38,38
"13113",2019,0,36,0,36
"13114",2015,0,73,73,146
"13114",2016,0,121,0,121
"13114",2017,0,0,7,7
"13114",2018,0,0,38,38
"13114",2019,0,36,0,36
"13115",2015,0,73,73,146
"13115",2016,0,121,0,121
"13115",2017,0,0,48,48
"13115",2018,0,0,38,38
"13115",2019,0,36,36,72
"13115",2020,0,0,77,77
"13116",2015,0,73,0,73
"13116",2016,0,121,0,121
"13116",2017,0,0,115,115
"13116",2018,0,0,38,38
"13116",2019,0,36,79,115
"13116",2020,0,0,77,77
"13117",2015,0,73,0,73
"13117",2016,0,121,0,121
"13117",2017,0,0,115,115
"13117",2018,0,0,38,38
"13117",2019,0,36,79,115
"13117",2020,0,0,77,77
"13118",2015,0,73,73,146
"13118",2016,0,121,0,121
"13118",2017,0,0,7,7
"13118",2018,0,0,38,38
"13118",2019,0,36,0,36
"13118",2020,0,0,28,28
"13119",2015,0,73,0,73
"13119",2016,0,121,0,121
"13119",2017,0,0,7,7
"13119",2018,0,0,38,38
"13119",2019,0,36,14,50
"14001",2017,0,0,146,146
"14001",2020,0,0,68,68
"14003",2017,0,0,321,321
"14003",2020,0,0,68,68
"14005",2017,0,0,321,321
"14005",2020,0,0,68,68
"14006",2017,0,0,146,146
"14006",2020,0,0,68,68
"14007",2017,0,0,321,321
"14007",2020,0,0,68,68
"14009",2017,0,0,178,178
"14009",2020,0,0,68,68
"14011",2017,0,0,321,321
"14011",2020,0,0,68,68
"14012",2017,0,0,321,321
"14012",2020,0,0,68,68
"14014",2017,0,0,178,178
"14014",2020,0,0,68,68
"14015",2017,0,0,178,178
"14015",2020,0,0,68,68
"14016",2017,0,0,146,146
"14016",2020,0,0,68,68
"14019",2017,0,0,321,321
"14019",2020,0,0,68,68
"14020",2017,0,0,321,321
"14020",2020,0,0,68,68
"14021",2017,0,0,321,321
"14021",2020,0,0,68,68
"14022",2017,0,0,321,321
"14022",2020,0,0,68,68
"14023",2017,0,0,321,321
"14023",2020,0,0,68,68
"14024",2017,0,0,146,146
"14024",2020,0,0,68,68
"14025",2017,0,0,321,321
"14025",2020,0,0,68,68
"14026",2017,0,0,321,321
"14026",2020,0,0,68,68
"14027",2017,0,0,146,146
"14027",2020,0,0,68,68
"14030",2017,0,0,178,178
"14030",2020,0,0,68,68
"14032",2017,0,0,146,146
"14032",2020,0,0,68,68
"14033",2017,0,0,146,146
"14033",2020,0,0,68,68
"14034",2017,0,0,146,146
"14034",2020,0,0,68,68
"14035",2017,0,0,321,321
"14035",2020,0,0,68,68
"14036",2017,0,0,178,178
"14036",2020,0,0,68,68
"14037",2017,0,0,146,146
"14037",2020,0,0,68,68
"14038",2017,0,0,321,321
"14038",2020,0,0,68,68
"14039",2017,0,0,146,146
"14039",2020,0,0,68,68
"14040",2017,0,0,321,321
"14040",2020,0,0,68,68
"14041",2017,0,0,146,146
"14041",2020,0,0,68,68
"14042",2017,0,0,146,146
"14042",2020,0,0,68,68
"14043",2017,0,0,321,321
"14043",2020,0,0,68,68
"14044",2017,0,0,321,321
"14044",2020,0,0,68,68
"14045",2017,0,0,321,321
"14045",2020,0,0,68,68
"14046",2017,0,0,178,178
"14046",2020,0,0,68,68
"14047",2017,0,0,321,321
"14047",2020,0,0,68,68
"14049",2017,0,0,321,321
"14049",2020,0,0,68,68
"14050",2017,0,0,321,321
"14050",2020,0,0,68,68
"14053",2017,0,0,321,321
"14053",2020,0,0,68,68
"14054",2017,0,0,321,321
"14055",2017,0,0,146,146
"14055",2020,0,0,68,68
"14057",2017,0,0,321,321
"14057",2020,0,0,68,68
"14059",2017,0,0,146,146
"14059",2020,0,0,68,68
"14060",2017,0,0,146,146
"14060",2020,0,0,68,68
"14061",2017,0,0,178,178
"14062",2017,0,0,321,321
"14062",2020,0,0,68,68
"14063",2017,0,0,321,321
"14063",2020,0,0,68,68
"14064",2017,0,0,321,321
"14064",2020,0,0,68,68
"14066",2017,0,0,321,321
"14066",2020,0,0,68,68
"14068",2017,0,0,146,146
"14068",2020,0,0,68,68
"14069",2017,0,0,146,146
"14069",2020,0,0,68,68
"14070",2017,0,0,321,321
"14070",2020,0,0,68,68
"14076",2017,0,0,146,146
"14076",2020,0,0,68,68
"14077",2017,0,0,146,146
"14077",2020,0,0,68,68
"14078",2017,0,0,321,321
"14078",2020,0,0,68,68
"14079",2017,0,0,146,146
"14079",2020,0,0,68,68
"14080",2017,0,0,146,146
"14080",2020,0,0,68,68
"14082",2017,0,0,146,146
"14082",2020,0,0,68,68
"14083",2017,0,0,146,146
"14083",2020,0,0,68,68
"14084",2017,0,0,146,146
"14084",2020,0,0,68,68
"14085",2017,0,0,146,146
"14085",2020,0,0,68,68
"14086",2017,0,0,146,146
"14086",2020,0,0,68,68
"14087",2017,0,0,146,146
"14087",2020,0,0,68,68
"14088",2017,0,0,178,178
"14088",2020,0,0,68,68
"14089",2017,0,0,146,146
"14089",2020,0,0,68,68
"14090",2017,0,0,146,146
"14090",2020,0,0,68,68
"14091",2017,0,0,146,146
"14091",2020,0,0,68,68
"14092",2017,0,0,178,178
"14092",2020,0,0,68,68
"14093",2017,0,0,146,146
"14093",2020,0,0,68,68
"14096",2017,0,0,178,178
"14097",2017,0,0,178,178
"14097",2020,0,0,68,68
"14098",2017,0,0,178,178
"14098",2020,0,0,68,68
"14100",2017,0,0,146,146
"14100",2020,0,0,68,68
"14101",2017,0,0,146,146
"14101",2020,0,0,68,68
"14102",2017,0,0,146,146
"14102",2020,0,0,68,68
"14103",2017,0,0,321,321
"14103",2020,0,0,68,68
"14104",2017,0,0,146,146
"14104",2020,0,0,68,68
"14106",2017,0,0,178,178
"14106",2020,0,0,68,68
"14107",2017,0,0,321,321
"14107",2020,0,0,68,68
"14110",2017,0,0,321,321
"14110",2020,0,0,68,68
"14111",2017,0,0,321,321
"14111",2020,0,0,68,68
"14116",2017,0,0,321,321
"14116",2020,0,0,68,68
"14117",2017,0,0,321,321
"14117",2020,0,0,68,68
"14118",2017,0,0,146,146
"14118",2020,0,0,68,68
"14119",2017,0,0,178,178
"14119",2020,0,0,68,68
"14120",2017,0,0,321,321
"14120",2020,0,0,68,68
"14121",2017,0,0,321,321
"14121",2020,0,0,68,68
"14122",2017,0,0,146,146
"14122",2020,0,0,68,68
"14123",2017,0,0,321,321
"14123",2020,0,0,68,68
"14124",2017,0,0,321,321
"14124",2020,0,0,68,68
"14125",2017,0,0,146,146
"14125",2020,0,0,68,68
"14126",2017,0,0,321,321
"14126",2020,0,0,68,68
"14127",2017,0,0,321,321
"14130",2017,0,0,321,321
"14130",2020,0,0,68,68
"14131",2017,0,0,146,146
"14131",2020,0,0,68,68
"14132",2017,0,0,321,321
"14132",2020,0,0,68,68
"14134",2017,0,0,321,321
"14134",2020,0,0,68,68
"14135",2017,0,0,321,321
"14135",2020,0,0,68,68
"14136",2017,0,0,321,321
"14136",2020,0,0,68,68
"14137",2017,0,0,178,178
"14137",2020,0,0,68,68
"14138",2017,0,0,321,321
"14138",2020,0,0,68,68
"14140",2017,0,0,321,321
"14140",2020,0,0,68,68
"14141",2017,0,0,321,321
"14141",2020,0,0,68,68
"14143",2017,0,0,321,321
"14143",2020,0,0,68,68
"14145",2017,0,0,178,178
"14145",2020,0,0,68,68
"14146",2017,0,0,146,146
"14146",2020,0,0,68,68
"14147",2017,0,0,146,146
"14147",2020,0,0,68,68
"14149",2017,0,0,321,321
"14149",2020,0,0,68,68
"14150",2017,0,0,146,146
"14150",2020,0,0,68,68
"14159",2017,0,0,321,321
"14159",2020,0,0,68,68
"14160",2017,0,0,178,178
"14160",2020,0,0,68,68
"14161",2017,0,0,146,146
"14161",2020,0,0,68,68
"14162",2017,0,0,146,146
"14162",2020,0,0,68,68
"14163",2017,0,0,321,321
"14163",2020,0,0,68,68
"14165",2017,0,0,321,321
"14165",2020,0,0,68,68
"14166",2017,0,0,146,146
"14166",2020,0,0,68,68
"14167",2017,0,0,146,146
"14167",2020,0,0,68,68
"14168",2017,0,0,321,321
"14168",2020,0,0,68,68
"14169",2017,0,0,321,321
"14169",2020,0,0,68,68
"14171",2017,0,0,146,146
"14171",2020,0,0,68,68
"14172",2017,0,0,321,321
"14172",2020,0,0,68,68
"14173",2017,0,0,321,321
"14173",2020,0,0,68,68
"14174",2017,0,0,146,146
"14174",2020,0,0,68,68
"14175",2017,0,0,321,321
"14175",2020,0,0,68,68
"14177",2017,0,0,146,146
"14177",2020,0,0,68,68
"14179",2017,0,0,146,146
"14179",2020,0,0,68,68
"14180",2017,0,0,146,146
"14180",2020,0,0,68,68
"14181",2017,0,0,146,146
"14181",2020,0,0,68,68
"14182",2017,0,0,321,321
"14182",2020,0,0,68,68
"14183",2017,0,0,146,146
"14183",2020,0,0,68,68
"14184",2017,0,0,321,321
"14184",2020,0,0,68,68
"14190",2017,0,0,321,321
"14190",2020,0,0,68,68
"14191",2017,0,0,321,321
"14191",2020,0,0,68,68
"14193",2017,0,0,146,146
"14193",2020,0,0,68,68
"14194",2017,0,0,146,146
"14194",2020,0,0,68,68
"14195",2017,0,0,146,146
"14195",2020,0,0,68,68
"14196",2017,0,0,321,321
"14196",2020,0,0,68,68
"14197",2017,0,0,178,178
"14197",2020,0,0,68,68
"14198",2017,0,0,321,321
"14198",2020,0,0,68,68
"14200",2017,0,0,321,321
"14200",2020,0,0,68,68
"14202",2017,0,0,146,146
"14202",2020,0,0,68,68
"14203",2017,0,0,321,321
"14203",2020,0,0,68,68
"14204",2017,0,0,321,321
"14204",2020,0,0,68,68
"14205",2017,0,0,321,321
"14205",2020,0,0,68,68
"14206",2017,0,0,321,321
"14206",2020,0,0,68,68
"14207",2017,0,0,146,146
"14207",2020,0,0,68,68
"14209",2017,0,0,321,321
"14209",2020,0,0,68,68
"14211",2017,0,0,146,146
"14211",2020,0,0,68,68
"14214",2017,0,0,321,321
"14214",2020,0,0,68,68
"14215",2017,0,0,146,146
"14215",2020,0,0,68,68
"14216",2017,0,0,321,321
"14216",2020,0,0,68,68
"14218",2017,0,0,321,321
"14218",2020,0,0,68,68
"14220",2017,0,0,146,146
"14220",2020,0,0,68,68
"14221",2017,0,0,146,146
"14221",2020,0,0,68,68
"14223",2017,0,0,146,146
"14223",2020,0,0,68,68
"14224",2017,0,0,321,321
"14224",2020,0,0,68,68
"14225",2017,0,0,321,321
"14225",2020,0,0,68,68
"14226",2017,0,0,146,146
"14226",2020,0,0,68,68
"14227",2017,0,0,321,321
"14227",2020,0,0,68,68
"14228",2017,0,0,178,178
"14228",2020,0,0,68,68
"14229",2017,0,0,321,321
"14229",2020,0,0,68,68
"14230",2017,0,0,146,146
"14230",2020,0,0,68,68
"14231",2017,0,0,321,321
"14231",2020,0,0,68,68
"14232",2017,0,0,321,321
"14232",2020,0,0,68,68
"14236",2017,0,0,321,321
"14236",2020,0,0,68,68
"14237",2017,0,0,321,321
"14237",2020,0,0,68,68
"14238",2017,0,0,146,146
"14238",2020,0,0,68,68
"14239",2017,0,0,321,321
"14239",2020,0,0,68,68
"14240",2017,0,0,321,321
"14240",2020,0,0,68,68
"14241",2017,0,0,146,146
"14241",2020,0,0,68,68
"14242",2017,0,0,146,146
"14242",2020,0,0,68,68
"14243",2017,0,0,146,146
"14243",2020,0,0,68,68
"14244",2017,0,0,321,321
"14244",2020,0,0,68,68
"14245",2017,0,0,321,321
"14245",2020,0,0,68,68
"14246",2017,0,0,178,178
"14246",2020,0,0,68,68
"14248",2017,0,0,146,146
"14248",2020,0,0,68,68
"14249",2017,0,0,146,146
"14249",2020,0,0,68,68
"14250",2017,0,0,321,321
"14250",2020,0,0,68,68
"14251",2017,0,0,146,146
"14251",2020,0,0,68,68
"14252",2017,0,0,321,321
"14252",2020,0,0,68,68
"14254",2017,0,0,146,146
"14254",2020,0,0,68,68
"14256",2017,0,0,321,321
"14256",2020,0,0,68,68
"14257",2017,0,0,146,146
"14257",2020,0,0,68,68
"14258",2017,0,0,321,321
"14258",2020,0,0,68,68
"14260",2017,0,0,146,146
"14260",2020,0,0,68,68
"14261",2017,0,0,146,146
"14261",2020,0,0,68,68
"14266",2017,0,0,146,146
"14266",2020,0,0,68,68
"14269",2017,0,0,146,146
"14269",2020,0,0,68,68
"14270",2017,0,0,146,146
"14270",2020,0,0,68,68
"14271",2017,0,0,146,146
"14271",2020,0,0,68,68
"14272",2017,0,0,321,321
"14272",2020,0,0,68,68
"14273",2017,0,0,146,146
"14273",2020,0,0,68,68
"14274",2017,0,0,146,146
"14274",2020,0,0,68,68
"14275",2017,0,0,321,321
"14275",2020,0,0,68,68
"14276",2017,0,0,178,178
"14276",2020,0,0,68,68
"14277",2017,0,0,146,146
"14277",2020,0,0,68,68
"14278",2017,0,0,321,321
"14278",2020,0,0,68,68
"14280",2017,0,0,146,146
"14280",2020,0,0,68,68
"14281",2017,0,0,321,321
"14281",2020,0,0,68,68
"14282",2017,0,0,321,321
"14282",2020,0,0,68,68
"14283",2017,0,0,321,321
"14283",2020,0,0,68,68
"14284",2017,0,0,178,178
"14284",2020,0,0,68,68
"14285",2017,0,0,146,146
"14285",2020,0,0,68,68
"14286",2017,0,0,146,146
"14286",2020,0,0,68,68
"14287",2017,0,0,321,321
"14287",2020,0,0,68,68
"14288",2017,0,0,321,321
"14288",2020,0,0,68,68
"14289",2017,0,0,321,321
"14289",2020,0,0,68,68
"14290",2017,0,0,146,146
"14290",2020,0,0,68,68
"14291",2017,0,0,146,146
"14291",2020,0,0,68,68
"14293",2017,0,0,146,146
"14293",2020,0,0,68,68
"14297",2017,0,0,146,146
"14297",2020,0,0,68,68
"14298",2017,0,0,321,321
"14298",2020,0,0,68,68
"14299",2017,0,0,146,146
"14299",2020,0,0,68,68
"14300",2017,0,0,321,321
"14300",2020,0,0,68,68
"14301",2017,0,0,146,146
"14301",2020,0,0,68,68
"14302",2017,0,0,146,146
"14302",2020,0,0,68,68
"14303",2017,0,0,146,146
"14303",2020,0,0,68,68
"14304",2017,0,0,146,146
"14304",2020,0,0,68,68
"14305",2017,0,0,146,146
"14305",2020,0,0,68,68
"14306",2017,0,0,321,321
"14306",2020,0,0,68,68
"14308",2017,0,0,321,321
"14308",2020,0,0,68,68
"14309",2017,0,0,146,146
"14309",2020,0,0,68,68
"14310",2017,0,0,321,321
"14310",2020,0,0,68,68
"14311",2017,0,0,146,146
"14311",2020,0,0,68,68
"14312",2017,0,0,321,321
"14312",2020,0,0,68,68
"14316",2017,0,0,321,321
"14316",2020,0,0,68,68
"14318",2017,0,0,321,321
"14318",2020,0,0,68,68
"14319",2017,0,0,178,178
"14319",2020,0,0,68,68
"14320",2017,0,0,146,146
"14320",2020,0,0,68,68
"14322",2017,0,0,321,321
"14322",2020,0,0,68,68
"14325",2017,0,0,146,146
"14325",2020,0,0,68,68
"14326",2017,0,0,146,146
"14326",2020,0,0,68,68
"14327",2017,0,0,146,146
"14327",2020,0,0,68,68
"14328",2017,0,0,146,146
"14328",2020,0,0,68,68
"14329",2017,0,0,321,321
"14329",2020,0,0,68,68
"14332",2017,0,0,178,178
"14332",2020,0,0,68,68
"14333",2017,0,0,146,146
"14333",2020,0,0,68,68
"14334",2017,0,0,146,146
"14334",2020,0,0,68,68
"14335",2017,0,0,321,321
"14335",2020,0,0,68,68
"14336",2017,0,0,321,321
"14336",2020,0,0,68,68
"14337",2017,0,0,321,321
"14337",2020,0,0,68,68
"14338",2017,0,0,146,146
"14338",2020,0,0,68,68
"14341",2017,0,0,146,146
"14341",2020,0,0,68,68
"14342",2017,0,0,321,321
"14342",2020,0,0,68,68
"14343",2017,0,0,146,146
"14343",2020,0,0,68,68
"14344",2017,0,0,321,321
"14344",2020,0,0,68,68
"14345",2017,0,0,321,321
"14345",2020,0,0,68,68
"14346",2017,0,0,321,321
"14346",2020,0,0,68,68
"14347",2017,0,0,178,178
"14348",2017,0,0,321,321
"14348",2020,0,0,68,68
"14349",2017,0,0,146,146
"14349",2020,0,0,68,68
"14352",2017,0,0,321,321
"14353",2017,0,0,146,146
"14353",2020,0,0,68,68
"14354",2017,0,0,321,321
"14354",2020,0,0,68,68
"14355",2017,0,0,321,321
"14355",2020,0,0,68,68
"14357",2017,0,0,178,178
"14358",2017,0,0,321,321
"14358",2020,0,0,68,68
"14360",2017,0,0,178,178
"14360",2020,0,0,68,68
"14362",2017,0,0,321,321
"14362",2020,0,0,68,68
"14364",2017,0,0,321,321
"14364",2020,0,0,68,68
"14365",2017,0,0,178,178
"14365",2020,0,0,68,68
"14366",2017,0,0,146,146
"14366",2020,0,0,68,68
"14367",2017,0,0,321,321
"14367",2020,0,0,68,68
"14368",2017,0,0,321,321
"14368",2020,0,0,68,68
"14369",2017,0,0,321,321
"14369",2020,0,0,68,68
"14370",2017,0,0,321,321
"14370",2020,0,0,68,68
"14371",2017,0,0,146,146
"14371",2020,0,0,68,68
"14374",2017,0,0,321,321
"14374",2020,0,0,68,68
"14375",2017,0,0,178,178
"14375",2020,0,0,68,68
"14377",2017,0,0,321,321
"14377",2020,0,0,68,68
"14378",2017,0,0,321,321
"14378",2020,0,0,68,68
"14379",2017,0,0,146,146
"14379",2020,0,0,68,68
"14380",2017,0,0,321,321
"14380",2020,0,0,68,68
"14381",2017,0,0,321,321
"14381",2020,0,0,68,68
"14383",2017,0,0,146,146
"14383",2020,0,0,68,68
"14384",2017,0,0,178,178
"14384",2020,0,0,68,68
"14385",2017,0,0,321,321
"14385",2020,0,0,68,68
"14389",2017,0,0,178,178
"14389",2020,0,0,68,68
"14390",2017,0,0,146,146
"14390",2020,0,0,68,68
"14391",2017,0,0,321,321
"14391",2020,0,0,68,68
"14393",2017,0,0,146,146
"14393",2020,0,0,68,68
"14394",2017,0,0,321,321
"14394",2020,0,0,68,68
"14396",2017,0,0,146,146
"14396",2020,0,0,68,68
"14397",2017,0,0,321,321
"14397",2020,0,0,68,68
"14398",2017,0,0,146,146
"14398",2020,0,0,68,68
"14399",2017,0,0,146,146
"14399",2020,0,0,68,68
"14400",2017,0,0,321,321
"14400",2020,0,0,68,68
"14401",2017,0,0,321,321
"14401",2020,0,0,68,68
"14402",2017,0,0,321,321
"14402",2020,0,0,68,68
"14403",2017,0,0,146,146
"14403",2020,0,0,68,68
"14404",2017,0,0,146,146
"14404",2020,0,0,68,68
"14405",2017,0,0,178,178
"14405",2020,0,0,68,68
"14406",2017,0,0,321,321
"14406",2020,0,0,68,68
"14407",2017,0,0,178,178
"14407",2020,0,0,68,68
"14408",2017,0,0,146,146
"14408",2020,0,0,68,68
"14409",2017,0,0,321,321
"14409",2020,0,0,68,68
"14410",2017,0,0,321,321
"14410",2020,0,0,68,68
"14411",2017,0,0,146,146
"14411",2020,0,0,68,68
"14412",2017,0,0,146,146
"14412",2020,0,0,68,68
"14419",2017,0,0,146,146
"14419",2020,0,0,68,68
"14421",2017,0,0,146,146
"14421",2020,0,0,68,68
"14424",2017,0,0,321,321
"14425",2017,0,0,321,321
"14425",2020,0,0,68,68
"14426",2017,0,0,146,146
"14426",2020,0,0,68,68
"14427",2017,0,0,146,146
"14427",2020,0,0,68,68
"14430",2017,0,0,321,321
"14430",2020,0,0,68,68
"14431",2017,0,0,321,321
"14431",2020,0,0,68,68
"14435",2017,0,0,321,321
"14435",2020,0,0,68,68
"14436",2017,0,0,321,321
"14436",2020,0,0,68,68
"14437",2017,0,0,146,146
"14437",2020,0,0,68,68
"14438",2017,0,0,146,146
"14438",2020,0,0,68,68
"14439",2017,0,0,321,321
"14439",2020,0,0,68,68
"14445",2017,0,0,321,321
"14445",2020,0,0,68,68
"14446",2017,0,0,146,146
"14446",2020,0,0,68,68
"14448",2017,0,0,321,321
"14448",2020,0,0,68,68
"14449",2017,0,0,321,321
"14449",2020,0,0,68,68
"14452",2017,0,0,321,321
"14452",2020,0,0,68,68
"14453",2017,0,0,321,321
"14453",2020,0,0,68,68
"14454",2017,0,0,146,146
"14454",2020,0,0,68,68
"14455",2017,0,0,146,146
"14455",2020,0,0,68,68
"14456",2017,0,0,321,321
"14456",2020,0,0,68,68
"14457",2017,0,0,321,321
"14457",2020,0,0,68,68
"14458",2017,0,0,146,146
"14458",2020,0,0,68,68
"14460",2017,0,0,146,146
"14460",2020,0,0,68,68
"14461",2017,0,0,146,146
"14461",2020,0,0,68,68
"14465",2017,0,0,321,321
"14465",2020,0,0,68,68
"14466",2017,0,0,146,146
"14466",2020,0,0,68,68
"14467",2017,0,0,321,321
"14467",2020,0,0,68,68
"14468",2017,0,0,321,321
"14468",2020,0,0,68,68
"14469",2017,0,0,321,321
"14469",2020,0,0,68,68
"14473",2017,0,0,321,321
"14473",2020,0,0,68,68
"14474",2017,0,0,321,321
"14474",2020,0,0,68,68
"14475",2017,0,0,178,178
"14475",2020,0,0,68,68
"14476",2017,0,0,321,321
"14476",2020,0,0,68,68
"14478",2017,0,0,146,146
"14478",2020,0,0,68,68
"14480",2017,0,0,321,321
"14480",2020,0,0,68,68
"14482",2017,0,0,321,321
"14482",2020,0,0,68,68
"14483",2017,0,0,146,146
"14483",2020,0,0,68,68
"14484",2017,0,0,146,146
"14484",2020,0,0,68,68
"14486",2017,0,0,321,321
"14486",2020,0,0,68,68
"14487",2017,0,0,146,146
"14487",2020,0,0,68,68
"14488",2017,0,0,146,146
"14488",2020,0,0,68,68
"14491",2017,0,0,178,178
"14491",2020,0,0,68,68
"14492",2017,0,0,146,146
"14492",2020,0,0,68,68
"14494",2017,0,0,321,321
"14494",2020,0,0,68,68
"14495",2017,0,0,146,146
"14495",2020,0,0,68,68
"14496",2017,0,0,146,146
"14496",2020,0,0,68,68
"14497",2017,0,0,321,321
"14497",2020,0,0,68,68
"14498",2017,0,0,321,321
"14498",2020,0,0,68,68
"14499",2017,0,0,321,321
"14499",2020,0,0,68,68
"14500",2017,0,0,146,146
"14500",2020,0,0,68,68
"14501",2017,0,0,146,146
"14501",2020,0,0,68,68
"14502",2017,0,0,146,146
"14502",2020,0,0,68,68
"14504",2017,0,0,146,146
"14504",2020,0,0,68,68
"14506",2017,0,0,321,321
"14506",2020,0,0,68,68
"14509",2017,0,0,178,178
"14509",2020,0,0,68,68
"14510",2017,0,0,146,146
"14510",2020,0,0,68,68
"14511",2017,0,0,321,321
"14512",2017,0,0,146,146
"14512",2020,0,0,68,68
"14514",2017,0,0,146,146
"14514",2020,0,0,68,68
"14515",2017,0,0,321,321
"14515",2020,0,0,68,68
"14516",2017,0,0,178,178
"14516",2020,0,0,68,68
"14519",2017,0,0,146,146
"14519",2020,0,0,68,68
"14520",2017,0,0,146,146
"14520",2020,0,0,68,68
"14522",2017,0,0,146,146
"14522",2020,0,0,68,68
"14524",2017,0,0,321,321
"14524",2020,0,0,68,68
"14527",2017,0,0,321,321
"14527",2020,0,0,68,68
"14528",2017,0,0,146,146
"14528",2020,0,0,68,68
"14529",2017,0,0,321,321
"14529",2020,0,0,68,68
"14530",2017,0,0,146,146
"14530",2020,0,0,68,68
"14531",2017,0,0,146,146
"14531",2020,0,0,68,68
"14533",2017,0,0,321,321
"14533",2020,0,0,68,68
"14534",2017,0,0,146,146
"14534",2020,0,0,68,68
"14535",2017,0,0,321,321
"14535",2020,0,0,68,68
"14536",2017,0,0,146,146
"14536",2020,0,0,68,68
"14538",2017,0,0,178,178
"14538",2020,0,0,68,68
"14540",2017,0,0,146,146
"14540",2020,0,0,68,68
"14541",2017,0,0,321,321
"14541",2020,0,0,68,68
"14542",2017,0,0,321,321
"14542",2020,0,0,68,68
"14543",2017,0,0,178,178
"14543",2020,0,0,68,68
"14546",2017,0,0,321,321
"14546",2020,0,0,68,68
"14547",2017,0,0,321,321
"14547",2020,0,0,68,68
"14550",2017,0,0,321,321
"14550",2020,0,0,68,68
"14552",2017,0,0,321,321
"14552",2020,0,0,68,68
"14554",2017,0,0,178,178
"14554",2020,0,0,68,68
"14555",2017,0,0,146,146
"14555",2020,0,0,68,68
"14556",2017,0,0,146,146
"14556",2020,0,0,68,68
"14557",2017,0,0,146,146
"14557",2020,0,0,68,68
"14558",2017,0,0,146,146
"14558",2020,0,0,68,68
"14559",2017,0,0,321,321
"14562",2017,0,0,321,321
"14562",2020,0,0,68,68
"14563",2017,0,0,146,146
"14563",2020,0,0,68,68
"14565",2017,0,0,321,321
"14565",2020,0,0,68,68
"14566",2017,0,0,178,178
"14566",2020,0,0,68,68
"14569",2017,0,0,321,321
"14569",2020,0,0,68,68
"14570",2017,0,0,146,146
"14570",2020,0,0,68,68
"14571",2017,0,0,146,146
"14571",2020,0,0,68,68
"14572",2017,0,0,146,146
"14572",2020,0,0,68,68
"14574",2017,0,0,146,146
"14574",2020,0,0,68,68
"14575",2017,0,0,146,146
"14575",2020,0,0,68,68
"14576",2017,0,0,321,321
"14576",2020,0,0,68,68
"14578",2017,0,0,146,146
"14578",2020,0,0,68,68
"14579",2017,0,0,178,178
"14579",2020,0,0,68,68
"14582",2017,0,0,146,146
"14582",2020,0,0,68,68
"14586",2017,0,0,321,321
"14586",2020,0,0,68,68
"14587",2017,0,0,178,178
"14587",2020,0,0,68,68
"14588",2017,0,0,146,146
"14588",2020,0,0,68,68
"14589",2017,0,0,178,178
"14589",2020,0,0,68,68
"14590",2017,0,0,321,321
"14590",2020,0,0,68,68
"14591",2017,0,0,321,321
"14591",2020,0,0,68,68
"14592",2017,0,0,146,146
"14592",2020,0,0,68,68
"14593",2017,0,0,146,146
"14593",2020,0,0,68,68
"14595",2017,0,0,146,146
"14595",2020,0,0,68,68
"14598",2017,0,0,321,321
"14598",2020,0,0,68,68
"14601",2017,0,0,146,146
"14601",2020,0,0,68,68
"14602",2017,0,0,146,146
"14602",2020,0,0,68,68
"14603",2017,0,0,146,146
"14603",2020,0,0,68,68
"14605",2017,0,0,321,321
"14605",2020,0,0,68,68
"14606",2017,0,0,321,321
"14606",2020,0,0,68,68
"14607",2017,0,0,321,321
"14607",2020,0,0,68,68
"14609",2017,0,0,321,321
"14609",2020,0,0,68,68
"14610",2017,0,0,178,178
"14610",2020,0,0,68,68
"14613",2017,0,0,321,321
"14613",2020,0,0,68,68
"14614",2017,0,0,321,321
"14614",2020,0,0,68,68
"14619",2017,0,0,321,321
"14620",2017,0,0,146,146
"14620",2020,0,0,68,68
"14621",2017,0,0,146,146
"14621",2020,0,0,68,68
"14622",2017,0,0,321,321
"14622",2020,0,0,68,68
"14623",2017,0,0,146,146
"14623",2020,0,0,68,68
"14625",2017,0,0,146,146
"14625",2020,0,0,68,68
"14626",2017,0,0,146,146
"14626",2020,0,0,68,68
"14627",2017,0,0,178,178
"14627",2020,0,0,68,68
"14630",2017,0,0,321,321
"14630",2020,0,0,68,68
"14635",2017,0,0,146,146
"14635",2020,0,0,68,68
"14637",2017,0,0,321,321
"14637",2020,0,0,68,68
"14639",2017,0,0,321,321
"14639",2020,0,0,68,68
"14640",2017,0,0,321,321
"14640",2020,0,0,68,68
"14643",2017,0,0,321,321
"14643",2020,0,0,68,68
"14644",2017,0,0,146,146
"14644",2020,0,0,68,68
"14645",2017,0,0,146,146
"14645",2020,0,0,68,68
"14646",2017,0,0,321,321
"14646",2020,0,0,68,68
"14648",2017,0,0,146,146
"14648",2020,0,0,68,68
"14649",2017,0,0,178,178
"14649",2020,0,0,68,68
"14650",2017,0,0,321,321
"14651",2017,0,0,321,321
"14651",2020,0,0,68,68
"14652",2017,0,0,321,321
"14652",2020,0,0,68,68
"14654",2017,0,0,321,321
"14654",2020,0,0,68,68
"14656",2017,0,0,146,146
"14656",2020,0,0,68,68
"14657",2017,0,0,321,321
"14657",2020,0,0,68,68
"14658",2017,0,0,321,321
"14659",2017,0,0,321,321
"14659",2020,0,0,68,68
"14660",2017,0,0,146,146
"14660",2020,0,0,68,68
"14661",2017,0,0,321,321
"14661",2020,0,0,68,68
"14663",2017,0,0,321,321
"14663",2020,0,0,68,68
"14664",2017,0,0,321,321
"14664",2020,0,0,68,68
"14665",2017,0,0,178,178
"14665",2020,0,0,68,68
"14666",2017,0,0,178,178
"14666",2020,0,0,68,68
"14667",2017,0,0,321,321
"14667",2020,0,0,68,68
"14668",2017,0,0,321,321
"14668",2020,0,0,68,68
"14669",2017,0,0,321,321
"14669",2020,0,0,68,68
"14672",2017,0,0,321,321
"14672",2020,0,0,68,68
"14674",2017,0,0,321,321
"14674",2020,0,0,68,68
"14675",2017,0,0,178,178
"14675",2020,0,0,68,68
"14676",2017,0,0,321,321
"14676",2020,0,0,68,68
"14677",2017,0,0,321,321
"14677",2020,0,0,68,68
"14678",2017,0,0,321,321
"14678",2020,0,0,68,68
"14679",2017,0,0,321,321
"14679",2020,0,0,68,68
"14680",2017,0,0,321,321
"14680",2020,0,0,68,68
"14681",2017,0,0,321,321
"14681",2020,0,0,68,68
"14682",2017,0,0,146,146
"14682",2020,0,0,68,68
"14684",2017,0,0,178,178
"14684",2020,0,0,68,68
"14685",2017,0,0,321,321
"14685",2020,0,0,68,68
"14687",2017,0,0,146,146
"14687",2020,0,0,68,68
"14689",2017,0,0,146,146
"14689",2020,0,0,68,68
"14692",2017,0,0,321,321
"14692",2020,0,0,68,68
"14694",2017,0,0,146,146
"14694",2020,0,0,68,68
"14698",2017,0,0,178,178
"14698",2020,0,0,68,68
"14699",2017,0,0,146,146
"14699",2020,0,0,68,68
"14700",2017,0,0,321,321
"14700",2020,0,0,68,68
"14701",2017,0,0,146,146
"14701",2020,0,0,68,68
"14705",2017,0,0,321,321
"14705",2020,0,0,68,68
"14706",2017,0,0,146,146
"14706",2020,0,0,68,68
"14707",2017,0,0,146,146
"14707",2020,0,0,68,68
"14708",2017,0,0,321,321
"14708",2020,0,0,68,68
"14709",2017,0,0,321,321
"14709",2020,0,0,68,68
"14710",2017,0,0,146,146
"14710",2020,0,0,68,68
"14711",2017,0,0,321,321
"14711",2020,0,0,68,68
"14712",2017,0,0,321,321
"14712",2020,0,0,68,68
"14713",2017,0,0,146,146
"14713",2020,0,0,68,68
"14714",2017,0,0,321,321
"14714",2020,0,0,68,68
"14715",2017,0,0,146,146
"14715",2020,0,0,68,68
"14716",2017,0,0,321,321
"14716",2020,0,0,68,68
"14719",2017,0,0,178,178
"14719",2020,0,0,68,68
"14720",2017,0,0,178,178
"14720",2020,0,0,68,68
"14721",2017,0,0,146,146
"14721",2020,0,0,68,68
"14723",2017,0,0,146,146
"14723",2020,0,0,68,68
"14724",2017,0,0,321,321
"14724",2020,0,0,68,68
"14726",2017,0,0,178,178
"14728",2017,0,0,321,321
"14728",2020,0,0,68,68
"14731",2017,0,0,146,146
"14731",2020,0,0,68,68
"14732",2017,0,0,321,321
"14732",2020,0,0,68,68
"14733",2017,0,0,321,321
"14733",2020,0,0,68,68
"14734",2017,0,0,321,321
"14734",2020,0,0,68,68
"14735",2017,0,0,321,321
"14735",2020,0,0,68,68
"14737",2017,0,0,321,321
"14737",2020,0,0,68,68
"14738",2017,0,0,178,178
"14738",2020,0,0,68,68
"14739",2017,0,0,321,321
"14739",2020,0,0,68,68
"14740",2017,0,0,146,146
"14740",2020,0,0,68,68
"14741",2017,0,0,146,146
"14741",2020,0,0,68,68
"14742",2017,0,0,321,321
"14742",2020,0,0,68,68
"14743",2017,0,0,321,321
"14743",2020,0,0,68,68
"14744",2017,0,0,321,321
"14744",2020,0,0,68,68
"14745",2017,0,0,321,321
"14745",2020,0,0,68,68
"14747",2017,0,0,146,146
"14747",2020,0,0,68,68
"14748",2017,0,0,146,146
"14748",2020,0,0,68,68
"14751",2017,0,0,321,321
"14751",2020,0,0,68,68
"14752",2017,0,0,178,178
"14752",2020,0,0,68,68
"14753",2017,0,0,178,178
"14753",2020,0,0,68,68
"14754",2017,0,0,146,146
"14754",2020,0,0,68,68
"14755",2017,0,0,146,146
"14755",2020,0,0,68,68
"14756",2017,0,0,146,146
"14756",2020,0,0,68,68
"14758",2017,0,0,178,178
"14758",2020,0,0,68,68
"14759",2017,0,0,321,321
"14759",2020,0,0,68,68
"14760",2017,0,0,178,178
"14760",2020,0,0,68,68
"14761",2017,0,0,321,321
"14761",2020,0,0,68,68
"14762",2017,0,0,178,178
"14764",2017,0,0,146,146
"14764",2020,0,0,68,68
"15001",2019,0,0,34,34
"15001",2020,0,0,13,13
"15002",2017,0,0,38,38
"15002",2019,0,0,34,34
"15002",2020,0,0,13,13
"15003",2019,0,0,34,34
"15004",2017,0,0,38,38
"15004",2019,0,0,34,34
"15004",2020,0,0,13,13
"15005",2017,0,0,38,38
"15005",2019,0,0,34,34
"15005",2020,0,0,13,13
"15006",2019,0,0,34,34
"15007",2017,0,0,38,38
"15007",2019,0,0,34,34
"15007",2020,0,0,13,13
"15008",2019,0,0,34,34
"15009",2019,0,0,34,34
"15010",2019,0,0,34,34
"15011",2019,0,0,34,34
"15011",2020,0,0,7,7
"15012",2019,0,0,34,34
"15013",2019,0,0,34,34
"15013",2020,0,0,13,13
"15014",2019,0,0,34,34
"15014",2020,0,0,7,7
"15015",2019,0,0,34,34
"15016",2019,0,0,34,34
"15016",2020,0,0,7,7
"15017",2019,0,0,34,34
"15017",2020,0,0,7,7
"15018",2019,0,0,34,34
"15019",2019,0,0,34,34
"15020",2019,0,0,34,34
"15021",2018,0,0,39,39
"15021",2019,0,0,47,47
"15021",2020,0,0,14,14
"15022",2019,0,0,34,34
"15022",2020,0,0,13,13
"15024",2019,0,0,34,34
"15025",2019,0,0,34,34
"15025",2020,0,0,7,7
"15026",2019,0,0,34,34
"15026",2020,0,0,7,7
"15027",2018,0,0,39,39
"15027",2019,0,0,47,47
"15027",2020,0,0,14,14
"15028",2019,0,0,34,34
"15028",2020,0,0,7,7
"15029",2018,0,0,39,39
"15029",2019,0,0,47,47
"15029",2020,0,0,14,14
"15030",2018,0,0,39,39
"15030",2019,0,0,47,47
"15030",2020,0,0,14,14
"15032",2017,0,0,38,38
"15032",2019,0,0,34,34
"15032",2020,0,0,13,13
"15033",2017,0,0,38,38
"15033",2019,0,0,34,34
"15033",2020,0,0,7,7
"15034",2017,0,0,38,38
"15034",2019,0,0,34,34
"15034",2020,0,0,13,13
"15036",2019,0,0,34,34
"15037",2019,0,0,34,34
"15038",2019,0,0,34,34
"15040",2019,0,0,34,34
"15041",2019,0,0,34,34
"15041",2020,0,0,13,13
"15042",2017,0,0,38,38
"15042",2019,0,0,34,34
"15042",2020,0,0,13,13
"15043",2019,0,0,34,34
"15043",2020,0,0,13,13
"15045",2017,0,0,38,38
"15045",2019,0,0,34,34
"15045",2020,0,0,13,13
"15046",2019,0,0,34,34
"15048",2017,0,0,38,38
"15048",2019,0,0,34,34
"15048",2020,0,0,13,13
"15049",2019,0,0,34,34
"15050",2019,0,0,34,34
"15051",2017,0,0,38,38
"15051",2019,0,0,34,34
"15051",2020,0,0,13,13
"15052",2019,0,0,34,34
"15053",2019,0,0,34,34
"15053",2020,0,0,13,13
"15054",2019,0,0,34,34
"15055",2017,0,0,38,38
"15055",2019,0,0,34,34
"15055",2020,0,0,13,13
"15056",2019,0,0,34,34
"15056",2020,0,0,7,7
"15057",2019,0,0,34,34
"15057",2020,0,0,7,7
"15058",2019,0,0,34,34
"15058",2020,0,0,7,7
"15059",2017,0,0,38,38
"15059",2019,0,0,34,34
"15059",2020,0,0,13,13
"15060",2017,0,0,38,38
"15060",2019,0,0,34,34
"15060",2020,0,0,13,13
"15061",2019,0,0,34,34
"15063",2019,0,0,34,34
"15064",2019,0,0,34,34
"15065",2017,0,0,38,38
"15065",2019,0,0,34,34
"15065",2020,0,0,13,13
"15066",2019,0,0,34,34
"15067",2019,0,0,34,34
"15069",2019,0,0,34,34
"15069",2020,0,0,13,13
"15070",2019,0,0,34,34
"15070",2020,0,0,7,7
"15072",2019,0,0,34,34
"15072",2020,0,0,7,7
"15073",2017,0,0,38,38
"15073",2019,0,0,34,34
"15073",2020,0,0,13,13
"15074",2019,0,0,34,34
"15074",2020,0,0,7,7
"15075",2019,0,0,34,34
"15075",2020,0,0,7,7
"15076",2019,0,0,34,34
"15077",2017,0,0,38,38
"15077",2019,0,0,34,34
"15077",2020,0,0,7,7
"15078",2017,0,0,38,38
"15078",2019,0,0,34,34
"15078",2020,0,0,13,13
"15079",2019,0,0,34,34
"15080",2019,0,0,34,34
"15080",2020,0,0,13,13
"15081",2019,0,0,34,34
"15081",2020,0,0,7,7
"15082",2018,0,0,39,39
"15082",2019,0,0,47,47
"15082",2020,0,0,14,14
"15083",2019,0,0,34,34
"15083",2020,0,0,7,7
"15084",2018,0,0,39,39
"15084",2019,0,0,47,47
"15084",2020,0,0,14,14
"15085",2019,0,0,34,34
"15086",2019,0,0,34,34
"15086",2020,0,0,7,7
"15087",2019,0,0,34,34
"15088",2019,0,0,34,34
"15088",2020,0,0,7,7
"15089",2019,0,0,34,34
"15090",2019,0,0,34,34
"15091",2019,0,0,34,34
"15092",2019,0,0,34,34
"15093",2018,0,0,39,39
"15093",2019,0,0,47,47
"15093",2020,0,0,14,14
"15094",2019,0,0,34,34
"15094",2020,0,0,7,7
"15095",2019,0,0,34,34
"15095",2020,0,0,7,7
"15096",2019,0,0,34,34
"15096",2020,0,0,7,7
"15097",2017,0,0,38,38
"15097",2019,0,0,34,34
"15097",2020,0,0,13,13
"15098",2019,0,0,34,34
"15098",2020,0,0,13,13
"15100",2019,0,0,34,34
"15100",2020,0,0,13,13
"15101",2019,0,0,34,34
"15102",2019,0,0,34,34
"15103",2018,0,0,39,39
"15103",2019,0,0,47,47
"15103",2020,0,0,14,14
"15104",2018,0,0,39,39
"15104",2019,0,0,47,47
"15104",2020,0,0,14,14
"15105",2019,0,0,34,34
"15105",2020,0,0,13,13
"15106",2017,0,0,38,38
"15106",2019,0,0,34,34
"15106",2020,0,0,13,13
"15107",2017,0,0,38,38
"15107",2019,0,0,34,34
"15107",2020,0,0,13,13
"15108",2017,0,0,38,38
"15108",2019,0,0,34,34
"15108",2020,0,0,13,13
"15110",2019,0,0,34,34
"15111",2019,0,0,34,34
"15112",2019,0,0,34,34
"15112",2020,0,0,7,7
"15113",2019,0,0,34,34
"15114",2019,0,0,34,34
"15116",2019,0,0,34,34
"15117",2019,0,0,34,34
"15118",2019,0,0,34,34
"15118",2020,0,0,7,7
"15119",2019,0,0,34,34
"15119",2020,0,0,13,13
"15120",2019,0,0,34,34
"15121",2017,0,0,38,38
"15121",2019,0,0,34,34
"15121",2020,0,0,13,13
"15122",2018,0,0,39,39
"15122",2019,0,0,47,47
"15122",2020,0,0,14,14
"15123",2019,0,0,34,34
"15124",2019,0,0,34,34
"15125",2017,0,0,38,38
"15125",2019,0,0,34,34
"15125",2020,0,0,13,13
"15126",2019,0,0,34,34
"15126",2020,0,0,13,13
"15127",2019,0,0,34,34
"15127",2020,0,0,13,13
"15128",2019,0,0,34,34
"15129",2019,0,0,34,34
"15130",2017,0,0,38,38
"15130",2019,0,0,34,34
"15130",2020,0,0,13,13
"15131",2019,0,0,34,34
"15132",2019,0,0,34,34
"15133",2018,0,0,39,39
"15133",2019,0,0,47,47
"15133",2020,0,0,14,14
"15134",2018,0,0,39,39
"15134",2019,0,0,47,47
"15134",2020,0,0,14,14
"15135",2019,0,0,34,34
"15135",2020,0,0,7,7
"15137",2019,0,0,34,34
"15138",2019,0,0,34,34
"15139",2019,0,0,34,34
"15139",2020,0,0,7,7
"15140",2019,0,0,34,34
"15140",2020,0,0,7,7
"15141",2019,0,0,34,34
"15142",2017,0,0,38,38
"15142",2019,0,0,34,34
"15142",2020,0,0,13,13
"15143",2019,0,0,34,34
"15143",2020,0,0,7,7
"15144",2019,0,0,34,34
"15144",2020,0,0,7,7
"15146",2019,0,0,34,34
"15146",2020,0,0,7,7
"15147",2019,0,0,34,34
"15148",2019,0,0,34,34
"15148",2020,0,0,13,13
"15149",2019,0,0,34,34
"15149",2020,0,0,7,7
"15151",2019,0,0,34,34
"15151",2020,0,0,13,13
"15152",2017,0,0,38,38
"15152",2019,0,0,34,34
"15152",2020,0,0,7,7
"15153",2019,0,0,34,34
"15154",2019,0,0,34,34
"15154",2020,0,0,7,7
"15155",2019,0,0,34,34
"15156",2019,0,0,34,34
"15157",2018,0,0,39,39
"15157",2019,0,0,47,47
"15157",2020,0,0,14,14
"15158",2017,0,0,38,38
"15158",2019,0,0,34,34
"15158",2020,0,0,13,13
"15159",2019,0,0,34,34
"15159",2020,0,0,7,7
"15160",2019,0,0,34,34
"15160",2020,0,0,7,7
"15161",2019,0,0,34,34
"15161",2020,0,0,13,13
"15162",2019,0,0,34,34
"15163",2019,0,0,34,34
"15164",2017,0,0,38,38
"15164",2019,0,0,34,34
"15164",2020,0,0,13,13
"15165",2019,0,0,34,34
"15165",2020,0,0,7,7
"15166",2019,0,0,34,34
"15167",2018,0,0,39,39
"15167",2019,0,0,47,47
"15167",2020,0,0,14,14
"15168",2017,0,0,38,38
"15168",2019,0,0,34,34
"15168",2020,0,0,13,13
"15169",2019,0,0,34,34
"15170",2019,0,0,34,34
"15172",2018,0,0,39,39
"15172",2019,0,0,47,47
"15172",2020,0,0,14,14
"15173",2019,0,0,34,34
"15174",2019,0,0,34,34
"15175",2019,0,0,34,34
"15175",2020,0,0,7,7
"15176",2019,0,0,34,34
"15176",2020,0,0,7,7
"15178",2019,0,0,34,34
"15178",2020,0,0,7,7
"15179",2019,0,0,34,34
"15179",2020,0,0,7,7
"15180",2019,0,0,34,34
"15180",2020,0,0,7,7
"15181",2018,0,0,39,39
"15181",2019,0,0,47,47
"15181",2020,0,0,14,14
"15182",2019,0,0,34,34
"15182",2020,0,0,7,7
"15183",2019,0,0,34,34
"15183",2020,0,0,7,7
"15184",2018,0,0,39,39
"15184",2019,0,0,47,47
"15184",2020,0,0,14,14
"15185",2019,0,0,34,34
"15186",2019,0,0,34,34
"15187",2017,0,0,38,38
"15187",2019,0,0,34,34
"15187",2020,0,0,13,13
"15188",2017,0,0,38,38
"15188",2019,0,0,34,34
"15188",2020,0,0,13,13
"15189",2019,0,0,34,34
"15189",2020,0,0,7,7
"15190",2019,0,0,34,34
"15191",2019,0,0,34,34
"15191",2020,0,0,7,7
"15192",2019,0,0,34,34
"15192",2020,0,0,7,7
"15194",2018,0,0,39,39
"15194",2019,0,0,47,47
"15194",2020,0,0,14,14
"15196",2019,0,0,34,34
"15198",2017,0,0,38,38
"15198",2019,0,0,34,34
"15198",2020,0,0,7,7
"15199",2017,0,0,38,38
"15199",2019,0,0,34,34
"15199",2020,0,0,13,13
"15200",2019,0,0,34,34
"15200",2020,0,0,7,7
"15201",2019,0,0,34,34
"15201",2020,0,0,7,7
"15202",2019,0,0,34,34
"15203",2019,0,0,34,34
"15203",2020,0,0,13,13
"15204",2019,0,0,34,34
"15204",2020,0,0,7,7
"15205",2019,0,0,34,34
"15206",2019,0,0,34,34
"15207",2017,0,0,38,38
"15207",2019,0,0,34,34
"15207",2020,0,0,13,13
"15208",2019,0,0,34,34
"15209",2017,0,0,38,38
"15209",2019,0,0,34,34
"15209",2020,0,0,13,13
"15211",2019,0,0,34,34
"15211",2020,0,0,7,7
"15212",2018,0,0,39,39
"15212",2019,0,0,47,47
"15212",2020,0,0,14,14
"15213",2019,0,0,34,34
"15214",2019,0,0,34,34
"15215",2019,0,0,34,34
"15215",2020,0,0,7,7
"15216",2017,0,0,38,38
"15216",2019,0,0,34,34
"15216",2020,0,0,13,13
"15217",2019,0,0,34,34
"15217",2020,0,0,7,7
"15218",2019,0,0,34,34
"15219",2019,0,0,34,34
"15220",2019,0,0,34,34
"15221",2019,0,0,34,34
"15221",2020,0,0,7,7
"15222",2018,0,0,39,39
"15222",2019,0,0,47,47
"15222",2020,0,0,14,14
"15223",2019,0,0,34,34
"15224",2019,0,0,34,34
"15224",2020,0,0,7,7
"15225",2019,0,0,34,34
"15226",2018,0,0,39,39
"15226",2019,0,0,47,47
"15226",2020,0,0,14,14
"15228",2019,0,0,34,34
"15228",2020,0,0,7,7
"15229",2017,0,0,38,38
"15229",2019,0,0,34,34
"15229",2020,0,0,13,13
"15230",2019,0,0,34,34
"15231",2019,0,0,34,34
"15231",2020,0,0,13,13
"15232",2017,0,0,38,38
"15232",2019,0,0,34,34
"15232",2020,0,0,13,13
"15233",2019,0,0,34,34
"15233",2020,0,0,7,7
"15234",2019,0,0,34,34
"15235",2017,0,0,38,38
"15235",2019,0,0,34,34
"15235",2020,0,0,13,13
"15236",2019,0,0,34,34
"15236",2020,0,0,7,7
"15237",2017,0,0,38,38
"15237",2019,0,0,34,34
"15237",2020,0,0,13,13
"15238",2019,0,0,34,34
"15238",2020,0,0,7,7
"15240",2019,0,0,34,34
"15241",2017,0,0,38,38
"15241",2019,0,0,34,34
"15241",2020,0,0,13,13
"15242",2018,0,0,39,39
"15242",2019,0,0,47,47
"15242",2020,0,0,14,14
"15243",2019,0,0,34,34
"15244",2017,0,0,38,38
"15244",2019,0,0,34,34
"15244",2020,0,0,13,13
"15245",2017,0,0,38,38
"15245",2019,0,0,34,34
"15245",2020,0,0,13,13
"15246",2019,0,0,34,34
"15247",2019,0,0,34,34
"15247",2020,0,0,13,13
"15248",2019,0,0,34,34
"15248",2020,0,0,13,13
"15249",2019,0,0,34,34
"15250",2019,0,0,34,34
"15251",2017,0,0,38,38
"15251",2019,0,0,34,34
"15251",2020,0,0,13,13
"15252",2019,0,0,34,34
"15252",2020,0,0,7,7
"15253",2019,0,0,34,34
"15254",2019,0,0,34,34
"15255",2019,0,0,34,34
"15255",2020,0,0,7,7
"15256",2019,0,0,34,34
"15256",2020,0,0,13,13
"15257",2019,0,0,34,34
"15258",2019,0,0,34,34
"15258",2020,0,0,7,7
"15259",2017,0,0,38,38
"15259",2019,0,0,34,34
"15259",2020,0,0,13,13
"15260",2018,0,0,39,39
"15260",2019,0,0,47,47
"15260",2020,0,0,14,14
"15261",2019,0,0,34,34
"15262",2017,0,0,38,38
"15262",2019,0,0,34,34
"15262",2020,0,0,13,13
"15263",2019,0,0,34,34
"15263",2020,0,0,13,13
"15264",2018,0,0,39,39
"15264",2019,0,0,47,47
"15264",2020,0,0,14,14
"15265",2019,0,0,34,34
"15266",2019,0,0,34,34
"15266",2020,0,0,7,7
"15267",2019,0,0,34,34
"15267",2020,0,0,7,7
"15268",2019,0,0,34,34
"15269",2019,0,0,34,34
"15269",2020,0,0,7,7
"16002",2019,0,0,69,69
"16005",2018,0,0,7,7
"16005",2019,0,0,7,7
"16007",2019,0,0,4,4
"16007",2020,0,0,28,28
"16008",2019,0,0,106,106
"16008",2020,0,0,32,32
"16009",2019,0,0,49,49
"16009",2020,0,0,32,32
"16011",2018,0,0,21,21
"16011",2019,0,0,28,28
"16015",2018,0,0,56,56
"16015",2019,0,0,7,7
"16016",2019,0,0,4,4
"16016",2020,0,0,4,4
"16019",2018,0,0,14,14
"16019",2019,0,0,20,20
"16023",2018,0,0,21,21
"16023",2019,0,0,85,85
"16023",2020,0,0,11,11
"16024",2018,0,0,21,21
"16024",2019,0,0,13,13
"16025",2018,0,0,7,7
"16026",2018,0,0,21,21
"16026",2019,0,0,28,28
"16028",2018,0,0,7,7
"16028",2019,0,0,2,2
"16030",2018,0,0,7,7
"16030",2019,0,0,2,2
"16031",2019,0,0,106,106
"16031",2020,0,0,32,32
"16035",2018,0,0,21,21
"16035",2019,0,0,43,43
"16035",2020,0,0,11,11
"16038",2018,0,0,7,7
"16038",2019,0,0,50,50
"16038",2020,0,0,53,53
"16039",2019,0,0,20,20
"16042",2016,0,0,33,33
"16042",2018,0,0,7,7
"16042",2019,0,0,7,7
"16044",2018,0,0,7,7
"16044",2019,0,0,50,50
"16044",2020,0,0,53,53
"16054",2018,0,0,7,7
"16054",2019,0,0,43,43
"16054",2020,0,0,53,53
"16059",2016,0,0,33,33
"16059",2018,0,0,7,7
"16059",2019,0,0,7,7
"16061",2018,0,0,6,6
"16061",2019,0,0,12,12
"16068",2018,0,0,14,14
"16068",2019,0,0,2,2
"16069",2019,0,0,106,106
"16069",2020,0,0,32,32
"16072",2018,0,0,4,4
"16072",2019,0,0,6,6
"16076",2018,0,0,7,7
"16076",2019,0,0,50,50
"16076",2020,0,0,39,39
"16078",2018,0,0,21,21
"16078",2019,0,0,28,28
"16079",2018,0,0,7,7
"16081",2019,0,0,106,106
"16081",2020,0,0,32,32
"16082",2018,0,0,4,4
"16082",2019,0,0,6,6
"16083",2016,0,0,33,33
"16083",2018,0,0,7,7
"16083",2019,0,0,7,7
"16085",2019,0,0,2,2
"16087",2018,0,0,7,7
"16087",2019,0,0,43,43
"16087",2020,0,0,39,39
"16095",2018,0,0,7,7
"16095",2019,0,0,50,50
"16095",2020,0,0,53,53
"16096",2019,0,0,2,2
"16098",2019,0,0,20,20
"16101",2018,0,0,56,56
"16101",2019,0,0,7,7
"16104",2019,0,0,69,69
"16105",2018,0,0,7,7
"16108",2019,0,0,106,106
"16108",2020,0,0,32,32
"16109",2019,0,0,21,21
"16110",2016,0,0,33,33
"16110",2018,0,0,7,7
"16110",2019,0,0,14,14
"16113",2018,0,0,56,56
"16113",2019,0,0,7,7
"16114",2018,0,0,21,21
"16114",2019,0,0,85,85
"16114",2020,0,0,11,11
"16119",2018,0,0,24,24
"16119",2019,0,0,12,12
"16120",2018,0,0,24,24
"16120",2019,0,0,12,12
"16127",2016,0,0,33,33
"16127",2018,0,0,7,7
"16127",2019,0,0,7,7
"16128",2019,0,0,4,4
"16128",2020,0,0,4,4
"16134",2019,0,0,49,49
"16134",2020,0,0,32,32
"16136",2016,0,0,33,33
"16136",2018,0,0,7,7
"16136",2019,0,0,14,14
"16138",2019,0,0,7,7
"16141",2016,0,0,33,33
"16141",2018,0,0,7,7
"16141",2019,0,0,14,14
"16142",2019,0,0,20,20
"16143",2017,0,0,7,7
"16143",2018,0,0,70,70
"16143",2019,0,0,28,28
"16143",2020,0,0,32,32
"16144",2019,0,0,106,106
"16144",2020,0,0,32,32
"16146",2018,0,0,3,3
"16146",2019,0,0,12,12
"16148",2018,0,0,7,7
"16148",2019,0,0,7,7
"16154",2018,0,0,21,21
"16154",2019,0,0,7,7
"16157",2018,0,0,7,7
"16157",2019,0,0,43,43
"16157",2020,0,0,39,39
"16160",2018,0,0,7,7
"16160",2019,0,0,2,2
"16164",2019,0,0,4,4
"16164",2020,0,0,4,4
"16165",2019,0,0,21,21
"16166",2019,0,0,98,98
"16168",2018,0,0,21,21
"16168",2019,0,0,13,13
"16169",2019,0,0,21,21
"16173",2016,0,0,33,33
"16173",2018,0,0,7,7
"16173",2019,0,0,14,14
"16183",2019,0,0,2,2
"16184",2018,0,0,21,21
"16184",2019,0,0,85,85
"16184",2020,0,0,11,11
"16185",2016,0,0,33,33
"16185",2018,0,0,7,7
"16185",2019,0,0,14,14
"16188",2019,0,0,2,2
"16189",2019,0,0,20,20
"16191",2016,0,0,33,33
"16191",2018,0,0,7,7
"16191",2019,0,0,14,14
"16192",2018,0,0,14,14
"16192",2019,0,0,2,2
"16195",2018,0,0,14,14
"16195",2019,0,0,2,2
"16196",2016,0,0,33,33
"16196",2018,0,0,7,7
"16196",2019,0,0,14,14
"16197",2016,0,0,33,33
"16197",2018,0,0,7,7
"16197",2019,0,0,7,7
"16198",2017,0,0,7,7
"16198",2018,0,0,70,70
"16198",2019,0,0,28,28
"16198",2020,0,0,32,32
"16200",2019,0,0,20,20
"16205",2019,0,0,49,49
"16205",2020,0,0,32,32
"16206",2019,0,0,106,106
"16206",2020,0,0,32,32
"16207",2018,0,0,7,7
"16207",2019,0,0,7,7
"16208",2019,0,0,21,21
"16210",2018,0,0,14,14
"16210",2019,0,0,20,20
"16212",2019,0,0,20,20
"16213",2019,0,0,2,2
"16218",2019,0,0,21,21
"16221",2018,0,0,7,7
"16221",2019,0,0,7,7
"16224",2018,0,0,7,7
"16224",2019,0,0,2,2
"16225",2019,0,0,2,2
"16226",2019,0,0,106,106
"16226",2020,0,0,32,32
"16229",2019,0,0,20,20
"16236",2018,0,0,56,56
"16236",2019,0,0,7,7
"16237",2018,0,0,14,14
"16237",2019,0,0,2,2
"16238",2019,0,0,106,106
"16238",2020,0,0,32,32
"16239",2019,0,0,2,2
"16241",2019,0,0,20,20
"16242",2018,0,0,7,7
"16242",2019,0,0,50,50
"16242",2020,0,0,39,39
"16244",2018,0,0,56,56
"16244",2019,0,0,7,7
"16245",2018,0,0,14,14
"16245",2019,0,0,2,2
"16255",2018,0,0,21,21
"16255",2019,0,0,43,43
"16255",2020,0,0,11,11
"16261",2019,0,0,2,2
"16263",2018,0,0,56,56
"16263",2019,0,0,7,7
"16264",2019,0,0,4,4
"16264",2020,0,0,4,4
"16268",2018,0,0,7,7
"16268",2019,0,0,50,50
"16268",2020,0,0,53,53
"16270",2019,0,0,49,49
"16270",2020,0,0,32,32
"16271",2017,0,0,7,7
"16271",2018,0,0,70,70
"16271",2019,0,0,113,113
"16271",2020,0,0,32,32
"16272",2019,0,0,20,20
"16273",2016,0,0,33,33
"16273",2018,0,0,7,7
"16273",2019,0,0,7,7
"16275",2019,0,0,21,21
"16276",2018,0,0,7,7
"16276",2019,0,0,2,2
"16286",2018,0,0,7,7
"16286",2019,0,0,7,7
"16287",2018,0,0,56,56
"16287",2019,0,0,7,7
"16289",2019,0,0,20,20
"16290",2019,0,0,2,2
"16291",2019,0,0,98,98
"16292",2019,0,0,69,69
"16293",2019,0,0,2,2
"16295",2018,0,0,21,21
"16295",2019,0,0,28,28
"16300",2018,0,0,14,14
"16300",2019,0,0,2,2
"16307",2018,0,0,14,14
"16307",2019,0,0,2,2
"16308",2018,0,0,14,14
"16308",2019,0,0,2,2
"16310",2018,0,0,7,7
"16310",2019,0,0,50,50
"16310",2020,0,0,39,39
"16312",2019,0,0,7,7
"16318",2018,0,0,21,21
"16318",2019,0,0,43,43
"16318",2020,0,0,11,11
"16320",2018,0,0,14,14
"16320",2019,0,0,20,20
"16321",2018,0,0,7,7
"16321",2019,0,0,50,50
"16321",2020,0,0,53,53
"16325",2018,0,0,21,21
"16325",2019,0,0,85,85
"16325",2020,0,0,11,11
"16326",2019,0,0,106,106
"16326",2020,0,0,32,32
"16329",2018,0,0,7,7
"16329",2019,0,0,50,50
"16329",2020,0,0,39,39
"16335",2019,0,0,69,69
"16336",2018,0,0,14,14
"16336",2019,0,0,2,2
"16339",2018,0,0,7,7
"16339",2019,0,0,7,7
"16341",2018,0,0,56,56
"16341",2019,0,0,7,7
"16345",2019,0,0,49,49
"16345",2020,0,0,32,32
"16356",2018,0,0,21,21
"16356",2019,0,0,43,43
"16356",2020,0,0,11,11
"16358",2019,0,0,7,7
"16361",2016,0,0,33,33
"16361",2018,0,0,7,7
"16361",2019,0,0,14,14
"16364",2019,0,0,20,20
"16370",2018,0,0,56,56
"16370",2019,0,0,7,7
"16373",2016,0,0,33,33
"16373",2018,0,0,7,7
"16373",2019,0,0,7,7
"16374",2018,0,0,70,70
"16374",2019,0,0,113,113
"16374",2020,0,0,32,32
"16375",2018,0,0,14,14
"16375",2019,0,0,2,2
"16377",2018,0,0,14,14
"16377",2019,0,0,2,2
"16378",2018,0,0,7,7
"16378",2019,0,0,27,27
"16378",2020,0,0,35,35
"16379",2019,0,0,2,2
"16380",2018,0,0,7,7
"16380",2019,0,0,2,2
"16381",2019,0,0,20,20
"16382",2017,0,0,7,7
"16382",2018,0,0,70,70
"16382",2019,0,0,113,113
"16382",2020,0,0,32,32
"16383",2018,0,0,21,21
"16383",2019,0,0,28,28
"16384",2018,0,0,7,7
"16389",2018,0,0,7,7
"16389",2019,0,0,43,43
"16389",2020,0,0,39,39
"16390",2016,0,0,33,33
"16390",2018,0,0,7,7
"16390",2019,0,0,14,14
"16392",2018,0,0,14,14
"16392",2019,0,0,2,2
"16393",2018,0,0,21,21
"16393",2019,0,0,28,28
"16396",2018,0,0,21,21
"16396",2019,0,0,43,43
"16396",2020,0,0,11,11
"16397",2018,0,0,7,7
"16397",2019,0,0,7,7
"16398",2019,0,0,106,106
"16398",2020,0,0,32,32
"16400",2019,0,0,106,106
"16400",2020,0,0,32,32
"16401",2019,0,0,106,106
"16401",2020,0,0,32,32
"16403",2018,0,0,7,7
"16403",2019,0,0,43,43
"16403",2020,0,0,39,39
"16404",2018,0,0,7,7
"16404",2019,0,0,43,43
"16404",2020,0,0,53,53
"16409",2016,0,0,33,33
"16409",2018,0,0,7,7
"16409",2019,0,0,7,7
"16412",2018,0,0,21,21
"16412",2019,0,0,28,28
"16413",2019,0,0,20,20
"16414",2019,0,0,106,106
"16414",2020,0,0,32,32
"16415",2019,0,0,106,106
"16415",2020,0,0,32,32
"16416",2019,0,0,2,2
"16418",2017,0,0,7,7
"16418",2018,0,0,70,70
"16418",2019,0,0,113,113
"16418",2020,0,0,32,32
"16419",2019,0,0,106,106
"16419",2020,0,0,32,32
"16420",2017,0,0,7,7
"16420",2018,0,0,70,70
"16420",2019,0,0,113,113
"16420",2020,0,0,32,32
"16423",2019,0,0,106,106
"16423",2020,0,0,32,32
"17002",2017,0,0,6,6
"17002",2018,0,0,35,35
"17002",2019,0,0,35,35
"17002",2020,0,0,14,14
"17003",2015,0,0,56,56
"17005",2017,0,0,6,6
"17005",2018,0,0,35,35
"17005",2019,0,0,35,35
"17005",2020,0,0,14,14
"17006",2017,0,0,6,6
"17006",2018,0,0,35,35
"17006",2019,0,0,35,35
"17006",2020,0,0,14,14
"17007",2015,0,0,56,56
"17008",2015,0,0,56,56
"17009",2015,0,0,56,56
"17010",2015,0,0,56,56
"17011",2017,0,0,6,6
"17011",2019,0,0,31,31
"17012",2017,0,0,6,6
"17012",2019,0,0,7,7
"17012",2020,0,0,7,7
"17013",2017,0,0,6,6
"17013",2019,0,0,7,7
"17013",2020,0,0,7,7
"17015",2019,0,0,26,26
"17016",2017,0,0,6,6
"17016",2018,0,0,7,7
"17016",2019,0,0,34,34
"17017",2017,0,0,6,6
"17017",2019,0,0,31,31
"17018",2017,0,0,6,6
"17018",2019,0,0,31,31
"17020",2017,0,0,6,6
"17020",2018,0,0,7,7
"17020",2019,0,0,34,34
"17021",2019,0,0,26,26
"17022",2017,0,0,6,6
"17022",2019,0,0,7,7
"17023",2017,0,0,6,6
"17023",2019,0,0,21,21
"17024",2017,0,0,6,6
"17024",2019,0,0,7,7
"17024",2020,0,0,7,7
"17025",2017,0,0,6,6
"17025",2019,0,0,7,7
"17026",2017,0,0,6,6
"17026",2019,0,0,21,21
"17027",2017,0,0,6,6
"17027",2018,0,0,35,35
"17027",2019,0,0,35,35
"17027",2020,0,0,14,14
"17028",2015,0,0,56,56
"17029",2017,0,0,6,6
"17029",2019,0,0,21,21
"17030",2019,0,0,26,26
"17031",2017,0,0,6,6
"17031",2019,0,0,21,21
"17032",2015,0,0,56,56
"17032",2017,0,0,6,6
"17032",2019,0,0,31,31
"17034",2019,0,0,69,69
"17035",2017,0,0,6,6
"17035",2018,0,0,21,21
"17035",2019,0,0,56,56
"17035",2020,0,0,40,40
"17036",2017,0,0,6,6
"17036",2019,0,0,31,31
"17037",2017,0,0,6,6
"17037",2019,0,0,21,21
"17038",2015,0,0,17,17
"17038",2017,0,0,14,14
"17038",2020,0,0,9,9
"17039",2017,0,0,6,6
"17039",2018,0,0,35,35
"17039",2019,0,0,35,35
"17039",2020,0,0,14,14
"17041",2015,0,0,40,40
"17041",2020,0,0,77,77
"17042",2017,0,0,6,6
"17042",2019,0,0,21,21
"17043",2015,0,0,40,40
"17043",2020,0,0,77,77
"17044",2017,0,0,6,6
"17044",2018,0,0,35,35
"17044",2019,0,0,35,35
"17044",2020,0,0,14,14
"17045",2019,0,0,31,31
"17046",2017,0,0,6,6
"17046",2019,0,0,31,31
"17047",2017,0,0,6,6
"17047",2018,0,0,35,35
"17047",2019,0,0,35,35
"17047",2020,0,0,14,14
"17048",2017,0,0,6,6
"17048",2019,0,0,21,21
"17049",2017,0,0,6,6
"17049",2019,0,0,7,7
"17049",2020,0,0,7,7
"17050",2018,0,0,14,14
"17050",2019,0,0,26,26
"17052",2019,0,0,69,69
"17053",2017,0,0,6,6
"17053",2019,0,0,31,31
"17054",2015,0,0,17,17
"17054",2017,0,0,14,14
"17054",2020,0,0,9,9
"17055",2015,0,0,17,17
"17055",2017,0,0,14,14
"17056",2017,0,0,6,6
"17056",2018,0,0,14,14
"17056",2019,0,0,31,31
"17057",2015,0,0,56,56
"17058",2019,0,0,31,31
"17059",2015,0,0,56,56
"17060",2019,0,0,26,26
"17061",2017,0,0,6,6
"17061",2018,0,0,35,35
"17061",2019,0,0,35,35
"17061",2020,0,0,14,14
"17062",2017,0,0,6,6
"17062",2018,0,0,21,21
"17062",2019,0,0,56,56
"17062",2020,0,0,40,40
"17063",2017,0,0,6,6
"17063",2019,0,0,40,40
"17063",2020,0,0,7,7
"17064",2019,0,0,26,26
"17065",2017,0,0,6,6
"17065",2019,0,0,31,31
"17066",2017,0,0,6,6
"17066",2018,0,0,35,35
"17066",2019,0,0,35,35
"17066",2020,0,0,14,14
"17067",2017,0,0,6,6
"17067",2019,0,0,21,21
"17068",2019,0,0,26,26
"17069",2017,0,0,6,6
"17069",2019,0,0,31,31
"17070",2017,0,0,6,6
"17070",2019,0,0,31,31
"17071",2017,0,0,6,6
"17071",2019,0,0,7,7
"17072",2017,0,0,6,6
"17072",2019,0,0,31,31
"17073",2017,0,0,6,6
"17073",2019,0,0,31,31
"17074",2015,0,0,17,17
"17074",2017,0,0,14,14
"17074",2020,0,0,9,9
"17075",2017,0,0,6,6
"17075",2019,0,0,31,31
"17076",2015,0,0,7,7
"17076",2017,0,0,5,5
"17076",2018,0,0,7,7
"17076",2019,0,0,7,7
"17077",2015,0,0,17,17
"17077",2017,0,0,14,14
"17077",2020,0,0,9,9
"17078",2017,0,0,6,6
"17078",2018,0,0,35,35
"17078",2019,0,0,35,35
"17078",2020,0,0,14,14
"17079",2019,0,0,26,26
"17080",2015,0,0,56,56
"17082",2017,0,0,6,6
"17082",2018,0,0,35,35
"17082",2019,0,0,35,35
"17082",2020,0,0,14,14
"17083",2019,0,0,31,31
"17084",2019,0,0,26,26
"17085",2017,0,0,6,6
"17085",2019,0,0,31,31
"17086",2017,0,0,6,6
"17086",2019,0,0,31,31
"17087",2017,0,0,6,6
"17087",2019,0,0,7,7
"17087",2020,0,0,7,7
"17089",2017,0,0,6,6
"17089",2019,0,0,31,31
"17091",2015,0,0,56,56
"17092",2018,0,0,35,35
"17092",2019,0,0,35,35
"17092",2020,0,0,14,14
"17094",2015,0,0,56,56
"17094",2017,0,0,6,6
"17094",2019,0,0,31,31
"17095",2017,0,0,6,6
"17095",2018,0,0,35,35
"17095",2019,0,0,35,35
"17095",2020,0,0,14,14
"17096",2017,0,0,6,6
"17096",2018,0,0,35,35
"17096",2019,0,0,35,35
"17096",2020,0,0,14,14
"17097",2019,0,0,26,26
"17098",2019,0,0,26,26
"17099",2019,0,0,35,35
"17099",2020,0,0,14,14
"17100",2017,0,0,6,6
"17100",2019,0,0,31,31
"17101",2017,0,0,6,6
"17101",2019,0,0,7,7
"17101",2020,0,0,7,7
"17102",2019,0,0,31,31
"17104",2017,0,0,6,6
"17104",2019,0,0,35,35
"17104",2020,0,0,14,14
"17105",2015,0,0,49,49
"17105",2017,0,0,41,41
"17105",2018,0,0,21,21
"17105",2019,0,0,71,71
"17105",2020,0,0,60,60
"17106",2015,0,0,7,7
"17106",2017,0,0,5,5
"17106",2018,0,0,7,7
"17106",2019,0,0,7,7
"17107",2015,0,0,56,56
"17107",2017,0,0,6,6
"17107",2019,0,0,31,31
"17108",2017,0,0,6,6
"17108",2018,0,0,35,35
"17108",2019,0,0,35,35
"17108",2020,0,0,14,14
"17109",2015,0,0,56,56
"17110",2015,0,0,17,17
"17110",2017,0,0,14,14
"17110",2020,0,0,9,9
"17111",2017,0,0,6,6
"17111",2018,0,0,35,35
"17111",2019,0,0,35,35
"17111",2020,0,0,14,14
"17112",2019,0,0,36,36
"17113",2015,0,0,17,17
"17113",2017,0,0,14,14
"17114",2015,0,0,40,40
"17114",2017,0,0,6,6
"17114",2019,0,0,7,7
"17114",2020,0,0,7,7
"17115",2017,0,0,6,6
"17115",2018,0,0,35,35
"17115",2019,0,0,35,35
"17115",2020,0,0,14,14
"17116",2018,0,0,14,14
"17116",2019,0,0,26,26
"17117",2015,0,0,78,78
"17117",2017,0,0,6,6
"17117",2018,0,0,21,21
"17117",2019,0,0,42,42
"17117",2020,0,0,40,40
"17118",2015,0,0,17,17
"17118",2017,0,0,14,14
"17118",2020,0,0,9,9
"17119",2019,0,0,26,26
"17120",2019,0,0,26,26
"17122",2017,0,0,6,6
"17122",2018,0,0,7,7
"17122",2019,0,0,31,31
"17124",2017,0,0,6,6
"17124",2019,0,0,7,7
"17124",2020,0,0,7,7
"17125",2017,0,0,6,6
"17125",2019,0,0,7,7
"17125",2020,0,0,7,7
"17126",2017,0,0,6,6
"17126",2019,0,0,21,21
"17127",2015,0,0,40,40
"17127",2020,0,0,77,77
"17128",2017,0,0,6,6
"17128",2018,0,0,14,14
"17128",2019,0,0,31,31
"17129",2019,0,0,69,69
"17130",2018,0,0,35,35
"17130",2019,0,0,35,35
"17130",2020,0,0,14,14
"17131",2019,0,0,26,26
"17132",2015,0,0,40,40
"17132",2020,0,0,77,77
"17133",2019,0,0,26,26
"17134",2017,0,0,6,6
"17134",2019,0,0,31,31
"17135",2017,0,0,6,6
"17135",2019,0,0,21,21
"17136",2015,0,0,56,56
"17137",2015,0,0,40,40
"17137",2020,0,0,77,77
"17138",2017,0,0,6,6
"17138",2019,0,0,7,7
"17138",2020,0,0,7,7
"17139",2015,0,0,40,40
"17139",2020,0,0,77,77
"17141",2017,0,0,6,6
"17141",2019,0,0,31,31
"17142",2015,0,0,56,56
"17143",2017,0,0,6,6
"17143",2019,0,0,31,31
"17145",2017,0,0,6,6
"17145",2018,0,0,7,7
"17145",2019,0,0,31,31
"17146",2019,0,0,31,31
"17147",2017,0,0,6,6
"17147",2019,0,0,31,31
"17148",2017,0,0,6,6
"17148",2019,0,0,31,31
"17149",2015,0,0,78,78
"17149",2017,0,0,6,6
"17149",2018,0,0,21,21
"17149",2019,0,0,42,42
"17149",2020,0,0,40,40
"17150",2017,0,0,6,6
"17150",2019,0,0,7,7
"17150",2020,0,0,7,7
"17151",2019,0,0,26,26
"17152",2019,0,0,26,26
"17153",2015,0,0,56,56
"17154",2019,0,0,31,31
"17155",2019,0,0,26,26
"17156",2017,0,0,6,6
"17156",2018,0,0,35,35
"17156",2019,0,0,35,35
"17156",2020,0,0,14,14
"17157",2017,0,0,6,6
"17157",2019,0,0,31,31
"17158",2015,0,0,56,56
"17159",2017,0,0,6,6
"17159",2018,0,0,35,35
"17159",2019,0,0,35,35
"17159",2020,0,0,14,14
"17160",2019,0,0,26,26
"17162",2015,0,0,49,49
"17162",2017,0,0,6,6
"17162",2018,0,0,21,21
"17162",2019,0,0,56,56
"17162",2020,0,0,40,40
"17163",2017,0,0,6,6
"17163",2018,0,0,35,35
"17163",2019,0,0,35,35
"17163",2020,0,0,14,14
"17164",2017,0,0,6,6
"17164",2019,0,0,31,31
"17165",2017,0,0,6,6
"17165",2019,0,0,7,7
"17166",2015,0,0,56,56
"17167",2015,0,0,17,17
"17167",2017,0,0,14,14
"17168",2017,0,0,6,6
"17168",2019,0,0,31,31
"17171",2017,0,0,6,6
"17171",2019,0,0,31,31
"17172",2019,0,0,26,26
"17173",2015,0,0,17,17
"17173",2017,0,0,14,14
"17174",2017,0,0,6,6
"17174",2019,0,0,31,31
"17175",2017,0,0,6,6
"17175",2018,0,0,7,7
"17175",2019,0,0,34,34
"17176",2017,0,0,6,6
"17176",2019,0,0,7,7
"17177",2017,0,0,6,6
"17177",2019,0,0,7,7
"17178",2018,0,0,14,14
"17178",2019,0,0,26,26
"17179",2017,0,0,6,6
"17179",2018,0,0,14,14
"17179",2019,0,0,31,31
"17180",2017,0,0,6,6
"17180",2019,0,0,21,21
"17181",2017,0,0,6,6
"17181",2019,0,0,31,31
"17182",2015,0,0,40,40
"17182",2020,0,0,77,77
"17183",2019,0,0,26,26
"17184",2019,0,0,31,31
"17185",2019,0,0,31,31
"17186",2015,0,0,56,56
"17187",2017,0,0,6,6
"17187",2018,0,0,35,35
"17187",2019,0,0,35,35
"17187",2020,0,0,14,14
"17188",2017,0,0,6,6
"17188",2019,0,0,21,21
"17190",2015,0,0,56,56
"17191",2017,0,0,6,6
"17191",2018,0,0,35,35
"17191",2019,0,0,35,35
"17191",2020,0,0,14,14
"17192",2017,0,0,6,6
"17192",2018,0,0,7,7
"17192",2019,0,0,34,34
"17193",2015,0,0,56,56
"17194",2015,0,0,56,56
"17195",2017,0,0,6,6
"17195",2019,0,0,7,7
"17195",2020,0,0,7,7
"17196",2018,0,0,14,14
"17196",2019,0,0,26,26
"17197",2017,0,0,6,6
"17197",2018,0,0,35,35
"17197",2019,0,0,35,35
"17197",2020,0,0,14,14
"17198",2017,0,0,6,6
"17198",2019,0,0,31,31
"17199",2017,0,0,6,6
"17199",2018,0,0,35,35
"17199",2019,0,0,35,35
"17199",2020,0,0,14,14
"17200",2015,0,0,56,56
"17201",2015,0,0,40,40
"17201",2020,0,0,77,77
"17202",2017,0,0,6,6
"17202",2019,0,0,7,7
"17202",2020,0,0,7,7
"17203",2015,0,0,56,56
"17204",2017,0,0,6,6
"17204",2018,0,0,35,35
"17204",2019,0,0,35,35
"17204",2020,0,0,14,14
"17205",2017,0,0,6,6
"17205",2019,0,0,31,31
"17206",2017,0,0,6,6
"17206",2019,0,0,7,7
"17208",2015,0,0,56,56
"17209",2017,0,0,5,5
"17209",2018,0,0,7,7
"17209",2019,0,0,7,7
"17210",2019,0,0,26,26
"17211",2017,0,0,6,6
"17211",2019,0,0,7,7
"17211",2020,0,0,7,7
"17212",2017,0,0,6,6
"17212",2019,0,0,21,21
"17213",2017,0,0,6,6
"17213",2019,0,0,7,7
"17213",2020,0,0,7,7
"17214",2019,0,0,36,36
"17215",2017,0,0,6,6
"17215",2018,0,0,35,35
"17215",2019,0,0,35,35
"17215",2020,0,0,14,14
"17216",2017,0,0,6,6
"17216",2019,0,0,31,31
"17217",2017,0,0,6,6
"17217",2019,0,0,21,21
"17218",2015,0,0,56,56
"17219",2019,0,0,31,31
"17220",2017,0,0,6,6
"17220",2018,0,0,35,35
"17220",2019,0,0,35,35
"17220",2020,0,0,14,14
"17221",2015,0,0,40,40
"17221",2020,0,0,77,77
"17222",2015,0,0,56,56
"17223",2017,0,0,6,6
"17223",2019,0,0,21,21
"17224",2017,0,0,6,6
"17224",2019,0,0,21,21
"17225",2019,0,0,26,26
"17226",2017,0,0,6,6
"17226",2019,0,0,31,31
"17227",2017,0,0,6,6
"17227",2018,0,0,35,35
"17227",2019,0,0,35,35
"17227",2020,0,0,14,14
"17228",2019,0,0,26,26
"17229",2017,0,0,6,6
"17229",2018,0,0,35,35
"17229",2019,0,0,35,35
"17229",2020,0,0,14,14
"17230",2019,0,0,69,69
"17231",2017,0,0,6,6
"17231",2018,0,0,35,35
"17231",2019,0,0,35,35
"17231",2020,0,0,14,14
"17232",2019,0,0,26,26
"17233",2017,0,0,6,6
"17233",2018,0,0,35,35
"17233",2019,0,0,35,35
"17233",2020,0,0,14,14
"17234",2015,0,0,40,40
"17234",2020,0,0,77,77
"17235",2017,0,0,6,6
"17235",2019,0,0,21,21
"17236",2018,0,0,35,35
"17236",2019,0,0,35,35
"17236",2020,0,0,14,14
"17237",2017,0,0,6,6
"17237",2019,0,0,31,31
"17239",2017,0,0,6,6
"17239",2019,0,0,21,21
"17240",2018,0,0,35,35
"17240",2019,0,0,35,35
"17240",2020,0,0,14,14
"17241",2015,0,0,17,17
"17241",2017,0,0,14,14
"17241",2020,0,0,9,9
"17242",2017,0,0,6,6
"17242",2018,0,0,14,14
"17242",2019,0,0,31,31
"17243",2015,0,0,17,17
"17243",2019,0,0,35,35
"17243",2020,0,0,14,14
"17244",2019,0,0,26,26
"17245",2015,0,0,56,56
"17246",2017,0,0,6,6
"17246",2019,0,0,31,31
"17247",2019,0,0,26,26
"17248",2019,0,0,26,26
"17249",2017,0,0,6,6
"17249",2018,0,0,35,35
"17249",2019,0,0,35,35
"17249",2020,0,0,14,14
"17250",2017,0,0,6,6
"17250",2018,0,0,35,35
"17250",2019,0,0,35,35
"17250",2020,0,0,14,14
"17252",2017,0,0,6,6
"17252",2019,0,0,31,31
"17253",2017,0,0,6,6
"17253",2019,0,0,31,31
"17254",2017,0,0,6,6
"17254",2019,0,0,7,7
"17254",2020,0,0,7,7
"17255",2019,0,0,26,26
"17256",2017,0,0,6,6
"17256",2019,0,0,31,31
"17257",2015,0,0,35,35
"17257",2017,0,0,6,6
"17257",2018,0,0,21,21
"17257",2019,0,0,42,42
"17257",2020,0,0,40,40
"17258",2017,0,0,6,6
"17258",2018,0,0,35,35
"17258",2019,0,0,35,35
"17258",2020,0,0,14,14
"17259",2017,0,0,6,6
"17259",2018,0,0,35,35
"17259",2019,0,0,35,35
"17259",2020,0,0,14,14
"17260",2015,0,0,17,17
"17260",2017,0,0,14,14
"17260",2020,0,0,9,9
"17261",2017,0,0,6,6
"17261",2018,0,0,21,21
"17261",2019,0,0,56,56
"17261",2020,0,0,40,40
"17262",2019,0,0,31,31
"17263",2017,0,0,6,6
"17263",2018,0,0,35,35
"17263",2019,0,0,35,35
"17263",2020,0,0,14,14
"17264",2015,0,0,56,56
"17265",2019,0,0,26,26
"17266",2017,0,0,6,6
"17266",2019,0,0,7,7
"17266",2020,0,0,7,7
"17267",2015,0,0,56,56
"17268",2017,0,0,6,6
"17268",2019,0,0,7,7
"17268",2020,0,0,7,7
"17269",2015,0,0,17,17
"17269",2017,0,0,14,14
"17269",2020,0,0,9,9
"17270",2017,0,0,6,6
"17270",2018,0,0,35,35
"17270",2019,0,0,35,35
"17270",2020,0,0,14,14
"17271",2017,0,0,6,6
"17271",2019,0,0,7,7
"17271",2020,0,0,7,7
"17273",2017,0,0,6,6
"17273",2018,0,0,7,7
"17273",2019,0,0,31,31
"17274",2015,0,0,56,56
"17275",2019,0,0,36,36
"17276",2017,0,0,6,6
"17276",2018,0,0,35,35
"17276",2019,0,0,35,35
"17276",2020,0,0,14,14
"17277",2017,0,0,6,6
"17277",2019,0,0,7,7
"17277",2020,0,0,7,7
"17278",2019,0,0,26,26
"17279",2018,0,0,14,14
"17279",2019,0,0,26,26
"17280",2017,0,0,6,6
"17280",2019,0,0,31,31
"17281",2017,0,0,6,6
"17281",2018,0,0,35,35
"17281",2019,0,0,35,35
"17281",2020,0,0,14,14
"17282",2017,0,0,6,6
"17282",2018,0,0,35,35
"17282",2019,0,0,35,35
"17282",2020,0,0,14,14
"17283",2017,0,0,6,6
"17283",2018,0,0,35,35
"17283",2019,0,0,35,35
"17283",2020,0,0,14,14
"17284",2019,0,0,31,31
"17285",2017,0,0,6,6
"17285",2019,0,0,31,31
"17287",2017,0,0,6,6
"17287",2019,0,0,35,35
"17287",2020,0,0,14,14
"17288",2017,0,0,6,6
"17288",2019,0,0,7,7
"17288",2020,0,0,7,7
"17289",2017,0,0,6,6
"17289",2018,0,0,35,35
"17289",2019,0,0,35,35
"17289",2020,0,0,14,14
"17290",2017,0,0,6,6
"17290",2019,0,0,21,21
"17291",2015,0,0,56,56
"17292",2017,0,0,6,6
"17292",2019,0,0,7,7
"17292",2020,0,0,7,7
"17293",2015,0,0,56,56
"17294",2017,0,0,6,6
"17294",2019,0,0,7,7
"17294",2020,0,0,7,7
"17295",2017,0,0,6,6
"17295",2018,0,0,35,35
"17295",2019,0,0,35,35
"17295",2020,0,0,14,14
"17296",2019,0,0,26,26
"17298",2019,0,0,26,26
"17299",2017,0,0,6,6
"17299",2019,0,0,31,31
"17300",2015,0,0,56,56
"17301",2015,0,0,35,35
"17301",2017,0,0,6,6
"17301",2018,0,0,21,21
"17301",2019,0,0,56,56
"17301",2020,0,0,40,40
"17302",2017,0,0,6,6
"17302",2019,0,0,31,31
"17303",2015,0,0,56,56
"17304",2017,0,0,6,6
"17304",2019,0,0,31,31
"17305",2018,0,0,35,35
"17305",2019,0,0,35,35
"17305",2020,0,0,14,14
"17306",2019,0,0,26,26
"17307",2019,0,0,26,26
"17308",2019,0,0,31,31
"17310",2019,0,0,26,26
"17311",2019,0,0,26,26
"17312",2019,0,0,69,69
"17313",2017,0,0,6,6
"17313",2019,0,0,31,31
"17314",2017,0,0,6,6
"17314",2019,0,0,31,31
"17315",2015,0,0,56,56
"17316",2017,0,0,6,6
"17316",2018,0,0,35,35
"17316",2019,0,0,35,35
"17316",2020,0,0,14,14
"17317",2019,0,0,26,26
"17319",2017,0,0,6,6
"17319",2018,0,0,35,35
"17319",2019,0,0,35,35
"17319",2020,0,0,14,14
"17320",2017,0,0,6,6
"17320",2019,0,0,31,31
"17321",2017,0,0,6,6
"17321",2019,0,0,31,31
"17322",2015,0,0,56,56
"17324",2018,0,0,35,35
"17324",2019,0,0,35,35
"17324",2020,0,0,14,14
"17325",2019,0,0,69,69
"17326",2017,0,0,6,6
"17326",2018,0,0,7,7
"17326",2019,0,0,34,34
"17327",2015,0,0,40,40
"17327",2020,0,0,77,77
"17328",2019,0,0,26,26
"17329",2017,0,0,6,6
"17329",2019,0,0,31,31
"17330",2019,0,0,31,31
"17331",2018,0,0,14,14
"17331",2019,0,0,26,26
"17332",2017,0,0,6,6
"17332",2018,0,0,35,35
"17332",2019,0,0,35,35
"17332",2020,0,0,14,14
"17333",2019,0,0,69,69
"17334",2017,0,0,6,6
"17334",2019,0,0,7,7
"17334",2020,0,0,7,7
"17335",2019,0,0,69,69
"17336",2019,0,0,31,31
"17338",2015,0,0,40,40
"17338",2020,0,0,77,77
"17339",2017,0,0,6,6
"17339",2018,0,0,35,35
"17339",2019,0,0,35,35
"17339",2020,0,0,14,14
"17340",2015,0,0,56,56
"17341",2017,0,0,6,6
"17341",2018,0,0,35,35
"17341",2019,0,0,35,35
"17341",2020,0,0,14,14
"17342",2019,0,0,26,26
"17343",2017,0,0,6,6
"17343",2018,0,0,35,35
"17343",2019,0,0,35,35
"17343",2020,0,0,14,14
"17344",2017,0,0,6,6
"17344",2019,0,0,31,31
"17345",2017,0,0,6,6
"17345",2018,0,0,35,35
"17345",2019,0,0,35,35
"17345",2020,0,0,14,14
"17346",2019,0,0,31,31
"17347",2017,0,0,6,6
"17347",2019,0,0,7,7
"17347",2020,0,0,7,7
"17348",2019,0,0,31,31
"17349",2015,0,0,56,56
"17350",2017,0,0,6,6
"17350",2019,0,0,7,7
"17350",2020,0,0,7,7
"17351",2019,0,0,31,31
"17353",2017,0,0,6,6
"17353",2019,0,0,31,31
"17354",2017,0,0,6,6
"17354",2018,0,0,35,35
"17354",2019,0,0,35,35
"17354",2020,0,0,14,14
"17355",2017,0,0,6,6
"17355",2018,0,0,7,7
"17355",2019,0,0,34,34
"17356",2017,0,0,6,6
"17356",2019,0,0,7,7
"17356",2020,0,0,7,7
"17357",2017,0,0,6,6
"17357",2018,0,0,35,35
"17357",2019,0,0,35,35
"17357",2020,0,0,14,14
"17358",2015,0,0,78,78
"17358",2017,0,0,6,6
"17358",2018,0,0,21,21
"17358",2019,0,0,42,42
"17358",2020,0,0,40,40
"17359",2015,0,0,40,40
"17359",2017,0,0,6,6
"17359",2019,0,0,40,40
"17359",2020,0,0,7,7
"17361",2017,0,0,6,6
"17361",2019,0,0,7,7
"17361",2020,0,0,7,7
"17362",2018,0,0,35,35
"17362",2019,0,0,35,35
"17362",2020,0,0,14,14
"17363",2017,0,0,6,6
"17363",2018,0,0,35,35
"17363",2019,0,0,35,35
"17363",2020,0,0,14,14
"17364",2017,0,0,6,6
"17364",2018,0,0,7,7
"17364",2019,0,0,34,34
"17365",2015,0,0,17,17
"17365",2017,0,0,14,14
"17365",2020,0,0,9,9
"17366",2015,0,0,17,17
"17366",2017,0,0,14,14
"17367",2017,0,0,6,6
"17367",2019,0,0,7,7
"17372",2017,0,0,6,6
"17372",2018,0,0,35,35
"17372",2019,0,0,35,35
"17372",2020,0,0,14,14
"17373",2015,0,0,56,56
"17374",2017,0,0,6,6
"17374",2019,0,0,7,7
"17375",2017,0,0,6,6
"17375",2019,0,0,31,31
"17376",2015,0,0,56,56
"17377",2017,0,0,6,6
"17377",2019,0,0,21,21
"17378",2015,0,0,17,17
"17378",2017,0,0,14,14
"17378",2020,0,0,9,9
"17379",2018,0,0,14,14
"17379",2019,0,0,26,26
"17380",2019,0,0,26,26
"17381",2017,0,0,6,6
"17381",2019,0,0,7,7
"17381",2020,0,0,7,7
"17382",2015,0,0,40,40
"17382",2020,0,0,77,77
"17383",2017,0,0,6,6
"17383",2019,0,0,7,7
"17384",2017,0,0,6,6
"17384",2019,0,0,7,7
"17384",2020,0,0,7,7
"17386",2015,0,0,17,17
"17386",2017,0,0,14,14
"17386",2020,0,0,9,9
"17387",2017,0,0,6,6
"17387",2019,0,0,31,31
"17388",2018,0,0,14,14
"17388",2019,0,0,26,26
"17389",2019,0,0,31,31
"17390",2019,0,0,69,69
"17391",2015,0,0,56,56
"17393",2019,0,0,26,26
"17394",2015,0,0,40,40
"17394",2020,0,0,77,77
"17395",2017,0,0,6,6
"17395",2019,0,0,31,31
"17396",2015,0,0,56,56
"17397",2017,0,0,6,6
"17397",2019,0,0,31,31
"17398",2017,0,0,6,6
"17398",2018,0,0,14,14
"17398",2019,0,0,31,31
"17400",2017,0,0,6,6
"17400",2018,0,0,14,14
"17400",2019,0,0,31,31
"17401",2015,0,0,40,40
"17401",2020,0,0,77,77
"17402",2017,0,0,6,6
"17402",2018,0,0,35,35
"17402",2019,0,0,35,35
"17402",2020,0,0,14,14
"17403",2017,0,0,6,6
"17403",2018,0,0,35,35
"17403",2019,0,0,35,35
"17403",2020,0,0,14,14
"17404",2019,0,0,26,26
"17405",2019,0,0,69,69
"17406",2019,0,0,31,31
"17407",2015,0,0,56,56
"17408",2019,0,0,31,31
"17409",2019,0,0,26,26
"17410",2019,0,0,69,69
"17412",2017,0,0,6,6
"17412",2019,0,0,31,31
"17413",2017,0,0,6,6
"17413",2019,0,0,31,31
"17414",2015,0,0,56,56
"17415",2019,0,0,31,31
"17416",2015,0,0,106,106
"17416",2017,0,0,41,41
"17416",2018,0,0,21,21
"17416",2019,0,0,71,71
"17416",2020,0,0,60,60
"17417",2018,0,0,35,35
"17417",2019,0,0,35,35
"17417",2020,0,0,14,14
"17418",2017,0,0,6,6
"17418",2018,0,0,7,7
"17418",2019,0,0,31,31
"17420",2015,0,0,56,56
"17421",2019,0,0,26,26
"17422",2017,0,0,6,6
"17422",2019,0,0,21,21
"17423",2018,0,0,35,35
"17423",2019,0,0,35,35
"17423",2020,0,0,14,14
"17424",2019,0,0,69,69
"17425",2019,0,0,26,26
"17426",2017,0,0,6,6
"17426",2019,0,0,21,21
"17427",2017,0,0,6,6
"17427",2019,0,0,21,21
"17428",2017,0,0,6,6
"17428",2019,0,0,21,21
"17429",2017,0,0,6,6
"17429",2019,0,0,31,31
"17430",2018,0,0,35,35
"17430",2019,0,0,35,35
"17430",2020,0,0,14,14
"17431",2019,0,0,36,36
"17432",2019,0,0,69,69
"17433",2017,0,0,6,6
"17433",2018,0,0,35,35
"17433",2019,0,0,35,35
"17433",2020,0,0,14,14
"17434",2015,0,0,40,40
"17435",2017,0,0,6,6
"17435",2019,0,0,31,31
"17436",2017,0,0,6,6
"17436",2019,0,0,31,31
"17437",2019,0,0,69,69
"17438",2018,0,0,14,14
"17438",2019,0,0,26,26
"17439",2015,0,0,56,56
"17440",2017,0,0,6,6
"17440",2019,0,0,7,7
"17440",2020,0,0,7,7
"17441",2018,0,0,14,14
"17441",2019,0,0,26,26
"17442",2019,0,0,26,26
"17443",2015,0,0,56,56
"17444",2019,0,0,31,31
"17445",2019,0,0,26,26
"17446",2017,0,0,6,6
"17446",2019,0,0,21,21
"17447",2015,0,0,56,56
"17448",2017,0,0,6,6
"17448",2019,0,0,31,31
"17449",2017,0,0,6,6
"17449",2019,0,0,31,31
"17450",2017,0,0,6,6
"17450",2019,0,0,7,7
"17450",2020,0,0,7,7
"17451",2017,0,0,6,6
"17451",2019,0,0,21,21
"17452",2019,0,0,26,26
"17453",2019,0,0,31,31
"17454",2017,0,0,6,6
"17454",2018,0,0,35,35
"17454",2019,0,0,35,35
"17454",2020,0,0,14,14
"17455",2019,0,0,31,31
"17457",2017,0,0,6,6
"17457",2019,0,0,40,40
"17457",2020,0,0,7,7
"17458",2017,0,0,6,6
"17458",2018,0,0,35,35
"17458",2019,0,0,35,35
"17458",2020,0,0,14,14
"17459",2017,0,0,6,6
"17459",2019,0,0,7,7
"17460",2019,0,0,36,36
"17461",2019,0,0,26,26
"17462",2017,0,0,6,6
"17462",2019,0,0,31,31
"17463",2017,0,0,6,6
"17463",2019,0,0,31,31
"17464",2015,0,0,40,40
"17464",2020,0,0,77,77
"17465",2017,0,0,6,6
"17465",2019,0,0,7,7
"17465",2020,0,0,7,7
"17466",2015,0,0,56,56
"17467",2017,0,0,6,6
"17467",2019,0,0,7,7
"17467",2020,0,0,7,7
"17468",2017,0,0,6,6
"17468",2018,0,0,35,35
"17468",2019,0,0,35,35
"17468",2020,0,0,14,14
"17469",2018,0,0,14,14
"17469",2019,0,0,26,26
"17470",2017,0,0,6,6
"17470",2019,0,0,31,31
"17471",2017,0,0,6,6
"17471",2019,0,0,7,7
"17471",2020,0,0,7,7
"17472",2015,0,0,56,56
"17473",2017,0,0,6,6
"17473",2019,0,0,7,7
"17473",2020,0,0,7,7
"17474",2015,0,0,40,40
"17474",2020,0,0,77,77
"17476",2017,0,0,6,6
"17476",2018,0,0,35,35
"17476",2019,0,0,35,35
"17476",2020,0,0,14,14
"17477",2015,0,0,49,49
"17477",2017,0,0,6,6
"17477",2018,0,0,21,21
"17477",2019,0,0,56,56
"17477",2020,0,0,40,40
"17478",2015,0,0,78,78
"17478",2017,0,0,6,6
"17478",2018,0,0,21,21
"17478",2019,0,0,42,42
"17478",2020,0,0,40,40
"17479",2019,0,0,26,26
"17480",2015,0,0,56,56
"17481",2017,0,0,6,6
"17481",2019,0,0,7,7
"17481",2020,0,0,7,7
"17482",2015,0,0,56,56
"17483",2017,0,0,6,6
"17483",2019,0,0,31,31
"17484",2017,0,0,6,6
"17484",2019,0,0,31,31
"18001",2019,0,25,0,25
"18001",2020,0,0,43,43
"18002",2019,0,25,0,25
"18002",2020,0,0,51,51
"18003",2018,0,0,45,45
"18003",2019,0,25,0,25
"18003",2020,0,0,43,43
"18004",2018,0,0,15,15
"18004",2019,0,25,0,25
"18004",2020,0,0,43,43
"18005",2018,0,0,15,15
"18005",2019,0,25,0,25
"18005",2020,0,0,43,43
"18006",2019,0,25,0,25
"18007",2015,0,0,64,64
"18007",2018,0,0,15,15
"18007",2019,0,25,0,25
"18007",2020,0,0,43,43
"18008",2019,0,25,0,25
"18009",2019,0,25,0,25
"18009",2020,0,0,51,51
"18010",2018,0,0,15,15
"18010",2019,0,25,0,25
"18010",2020,0,0,58,58
"18011",2018,0,0,52,52
"18011",2019,0,25,0,25
"18011",2020,0,0,98,98
"18012",2015,0,0,101,101
"18012",2018,0,0,15,15
"18012",2019,0,25,0,25
"18012",2020,0,0,43,43
"18013",2019,0,25,0,25
"18014",2015,0,0,101,101
"18014",2018,0,0,52,52
"18014",2019,0,25,0,25
"18014",2020,0,0,73,73
"18015",2019,0,25,0,25
"18015",2020,0,0,43,43
"18016",2018,0,0,45,45
"18016",2019,0,25,0,25
"18016",2020,0,0,43,43
"18017",2019,0,25,0,25
"18018",2019,0,25,0,25
"18019",2015,0,0,37,37
"18019",2019,0,25,0,25
"18020",2015,0,0,101,101
"18020",2018,0,0,45,45
"18020",2019,0,25,95,120
"18020",2020,0,0,113,113
"18021",2019,0,25,0,25
"18022",2015,0,0,101,101
"18022",2018,0,0,52,52
"18022",2019,0,25,0,25
"18022",2020,0,0,73,73
"18023",2015,0,0,37,37
"18023",2019,0,25,0,25
"18024",2018,0,0,15,15
"18024",2019,0,25,0,25
"18024",2020,0,0,58,58
"18025",2015,0,0,101,101
"18025",2018,0,0,15,15
"18025",2019,0,25,0,25
"18025",2020,0,0,43,43
"18026",2015,0,0,101,101
"18026",2018,0,0,45,45
"18026",2019,0,25,95,120
"18026",2020,0,0,113,113
"18027",2019,0,25,0,25
"18028",2018,0,0,15,15
"18028",2019,0,25,0,25
"18028",2020,0,0,43,43
"18029",2019,0,25,0,25
"18030",2015,0,0,101,101
"18030",2018,0,0,52,52
"18030",2019,0,25,0,25
"18030",2020,0,0,73,73
"18031",2019,0,25,0,25
"18032",2015,0,0,101,101
"18032",2018,0,0,45,45
"18032",2019,0,25,95,120
"18032",2020,0,0,113,113
"18033",2019,0,25,0,25
"18034",2019,0,25,0,25
"18034",2020,0,0,51,51
"18035",2019,0,25,0,25
"18036",2018,0,0,8,8
"18036",2019,0,25,0,25
"18036",2020,0,0,51,51
"18037",2019,0,25,0,25
"18037",2020,0,0,43,43
"18038",2019,0,25,0,25
"18038",2020,0,0,51,51
"18039",2015,0,0,101,101
"18039",2018,0,0,15,15
"18039",2019,0,25,0,25
"18039",2020,0,0,43,43
"18040",2019,0,25,0,25
"18041",2019,0,25,0,25
"18041",2020,0,0,51,51
"18042",2019,0,25,0,25
"18042",2020,0,0,51,51
"18043",2018,0,0,15,15
"18043",2019,0,25,0,25
"18043",2020,0,0,56,56
"18044",2018,0,0,8,8
"18044",2019,0,25,0,25
"18044",2020,0,0,51,51
"18045",2019,0,25,0,25
"18046",2019,0,25,0,25
"18046",2020,0,0,51,51
"18047",2019,0,25,0,25
"18047",2020,0,0,51,51
"18048",2015,0,0,64,64
"18048",2018,0,0,15,15
"18048",2019,0,25,0,25
"18048",2020,0,0,43,43
"18049",2015,0,0,101,101
"18049",2018,0,0,45,45
"18049",2019,0,25,95,120
"18049",2020,0,0,113,113
"18050",2019,0,25,0,25
"18050",2020,0,0,43,43
"18051",2019,0,25,0,25
"18051",2020,0,0,43,43
"18052",2019,0,25,0,25
"18053",2015,0,0,101,101
"18053",2018,0,0,15,15
"18053",2019,0,25,0,25
"18053",2020,0,0,43,43
"18054",2019,0,25,0,25
"18055",2019,0,25,0,25
"18055",2020,0,0,51,51
"18056",2019,0,25,0,25
"18057",2018,0,0,15,15
"18057",2019,0,25,0,25
"18057",2020,0,0,58,58
"18058",2019,0,25,0,25
"18058",2020,0,0,51,51
"18059",2018,0,0,15,15
"18059",2019,0,25,0,25
"18059",2020,0,0,58,58
"18060",2019,0,25,0,25
"18061",2015,0,0,37,37
"18061",2019,0,25,0,25
"18062",2015,0,0,64,64
"18062",2018,0,0,15,15
"18062",2019,0,25,0,25
"18062",2020,0,0,43,43
"18063",2019,0,25,0,25
"18064",2018,0,0,23,23
"18064",2019,0,25,0,25
"18064",2020,0,0,56,56
"18065",2018,0,0,15,15
"18065",2019,0,25,0,25
"18065",2020,0,0,56,56
"18066",2019,0,25,0,25
"18066",2020,0,0,51,51
"18067",2018,0,0,52,52
"18067",2019,0,25,0,25
"18067",2020,0,0,98,98
"18068",2019,0,25,0,25
"18069",2019,0,25,0,25
"18069",2020,0,0,51,51
"18070",2018,0,0,52,52
"18070",2019,0,25,0,25
"18070",2020,0,0,98,98
"18071",2019,0,25,0,25
"18072",2019,0,25,0,25
"18073",2019,0,25,0,25
"18073",2020,0,0,51,51
"18074",2015,0,0,101,101
"18074",2018,0,0,15,15
"18074",2019,0,25,0,25
"18074",2020,0,0,43,43
"18075",2015,0,0,64,64
"18075",2018,0,0,15,15
"18075",2019,0,25,0,25
"18075",2020,0,0,43,43
"18076",2019,0,25,0,25
"18076",2020,0,0,51,51
"18077",2015,0,0,37,37
"18077",2019,0,25,0,25
"18078",2019,0,25,0,25
"18078",2020,0,0,51,51
"18079",2015,0,0,101,101
"18079",2018,0,0,15,15
"18079",2019,0,25,0,25
"18079",2020,0,0,43,43
"18080",2019,0,25,0,25
"18081",2019,0,25,0,25
"18082",2015,0,0,64,64
"18082",2018,0,0,15,15
"18082",2019,0,25,0,25
"18082",2020,0,0,43,43
"18083",2018,0,0,15,15
"18083",2019,0,25,0,25
"18083",2020,0,0,58,58
"18084",2018,0,0,52,52
"18084",2019,0,25,0,25
"18084",2020,0,0,98,98
"18085",2018,0,0,8,8
"18085",2019,0,25,0,25
"18085",2020,0,0,43,43
"18086",2019,0,25,0,25
"18086",2020,0,0,51,51
"18087",2019,0,25,0,25
"18088",2019,0,25,0,25
"18088",2020,0,0,43,43
"18089",2019,0,25,0,25
"18089",2020,0,0,51,51
"18090",2015,0,0,37,37
"18090",2019,0,25,0,25
"18091",2019,0,25,0,25
"18091",2020,0,0,51,51
"18092",2019,0,25,0,25
"18093",2019,0,25,0,25
"18093",2020,0,0,51,51
"18094",2015,0,0,101,101
"18094",2018,0,0,15,15
"18094",2019,0,25,0,25
"18094",2020,0,0,43,43
"18095",2019,0,25,0,25
"18096",2019,0,25,0,25
"18096",2020,0,0,43,43
"18097",2018,0,0,15,15
"18097",2019,0,25,0,25
"18097",2020,0,0,43,43
"18098",2015,0,0,101,101
"18098",2018,0,0,15,15
"18098",2019,0,25,0,25
"18098",2020,0,0,43,43
"18099",2015,0,0,101,101
"18099",2018,0,0,15,15
"18099",2019,0,25,0,25
"18099",2020,0,0,43,43
"18100",2019,0,25,0,25
"18100",2020,0,0,43,43
"18101",2015,0,0,64,64
"18101",2018,0,0,15,15
"18101",2019,0,25,0,25
"18101",2020,0,0,43,43
"18102",2019,0,25,0,25
"18103",2019,0,25,0,25
"18103",2020,0,0,43,43
"18104",2015,0,0,101,101
"18104",2018,0,0,15,15
"18104",2019,0,25,0,25
"18104",2020,0,0,43,43
"18105",2015,0,0,37,37
"18105",2019,0,25,0,25
"18106",2015,0,0,64,64
"18106",2018,0,0,15,15
"18106",2019,0,25,0,25
"18106",2020,0,0,43,43
"18107",2019,0,25,0,25
"18107",2020,0,0,51,51
"18108",2015,0,0,64,64
"18108",2018,0,0,15,15
"18108",2019,0,25,0,25
"18108",2020,0,0,43,43
"18109",2019,0,25,0,25
"18109",2020,0,0,51,51
"18110",2015,0,0,101,101
"18110",2018,0,0,15,15
"18110",2019,0,25,0,25
"18110",2020,0,0,43,43
"18111",2019,0,25,0,25
"18111",2020,0,0,43,43
"18112",2018,0,0,15,15
"18112",2019,0,25,0,25
"18112",2020,0,0,58,58
"18113",2019,0,25,0,25
"18114",2019,0,25,0,25
"18114",2020,0,0,51,51
"18115",2019,0,25,0,25
"18115",2020,0,0,43,43
"18116",2015,0,0,101,101
"18116",2018,0,0,15,15
"18116",2019,0,25,0,25
"18116",2020,0,0,43,43
"18117",2018,0,0,52,52
"18117",2019,0,25,0,25
"18117",2020,0,0,98,98
"18118",2015,0,0,64,64
"18118",2018,0,0,15,15
"18118",2019,0,25,0,25
"18118",2020,0,0,43,43
"18119",2019,0,25,0,25
"18120",2015,0,0,101,101
"18120",2018,0,0,15,15
"18120",2019,0,25,0,25
"18120",2020,0,0,43,43
"18121",2019,0,25,0,25
"18122",2019,0,25,0,25
"18122",2020,0,0,51,51
"18124",2019,0,25,0,25
"18124",2020,0,0,51,51
"18125",2015,0,0,101,101
"18125",2018,0,0,45,45
"18125",2019,0,25,95,120
"18125",2020,0,0,113,113
"18126",2019,0,25,0,25
"18127",2018,0,0,15,15
"18127",2019,0,25,0,25
"18127",2020,0,0,58,58
"18128",2018,0,0,8,8
"18128",2019,0,25,0,25
"18128",2020,0,0,51,51
"18129",2019,0,25,0,25
"18130",2019,0,25,0,25
"18130",2020,0,0,51,51
"18132",2015,0,0,101,101
"18132",2018,0,0,15,15
"18132",2019,0,25,0,25
"18132",2020,0,0,43,43
"18133",2019,0,25,0,25
"18133",2020,0,0,51,51
"18134",2018,0,0,8,8
"18134",2019,0,25,0,25
"18134",2020,0,0,51,51
"18135",2018,0,0,15,15
"18135",2019,0,25,0,25
"18135",2020,0,0,58,58
"18136",2019,0,25,0,25
"18136",2020,0,0,51,51
"18137",2018,0,0,15,15
"18137",2019,0,25,0,25
"18137",2020,0,0,58,58
"18138",2019,0,25,0,25
"18138",2020,0,0,43,43
"18139",2015,0,0,64,64
"18139",2018,0,0,15,15
"18139",2019,0,25,0,25
"18139",2020,0,0,43,43
"18140",2018,0,0,8,8
"18140",2019,0,25,0,25
"18140",2020,0,0,43,43
"18141",2019,0,25,0,25
"18141",2020,0,0,43,43
"18142",2019,0,25,0,25
"18143",2015,0,0,64,64
"18143",2018,0,0,15,15
"18143",2019,0,25,0,25
"18143",2020,0,0,43,43
"18144",2015,0,0,101,101
"18144",2018,0,0,15,15
"18144",2019,0,25,0,25
"18144",2020,0,0,43,43
"18145",2019,0,25,0,25
"18145",2020,0,0,43,43
"18146",2015,0,0,101,101
"18146",2018,0,0,15,15
"18146",2019,0,25,0,25
"18146",2020,0,0,43,43
"18147",2019,0,25,0,25
"18147",2020,0,0,43,43
"18148",2018,0,0,8,8
"18148",2019,0,25,0,25
"18148",2020,0,0,51,51
"18149",2019,0,25,0,25
"18149",2020,0,0,43,43
"18150",2019,0,25,0,25
"18150",2020,0,0,43,43
"18151",2015,0,0,37,37
"18151",2018,0,0,15,15
"18151",2019,0,25,0,25
"18151",2020,0,0,43,43
"18152",2018,0,0,15,15
"18152",2019,0,25,0,25
"18152",2020,0,0,58,58
"18153",2019,0,25,0,25
"18153",2020,0,0,51,51
"18154",2015,0,0,101,101
"18154",2018,0,0,15,15
"18154",2019,0,25,0,25
"18154",2020,0,0,43,43
"18155",2015,0,0,64,64
"18155",2018,0,0,15,15
"18155",2019,0,25,0,25
"18155",2020,0,0,43,43
"18156",2019,0,25,0,25
"18156",2020,0,0,43,43
"18157",2019,0,25,0,25
"18157",2020,0,0,43,43
"18158",2019,0,25,0,25
"18159",2019,0,25,0,25
"18159",2020,0,0,43,43
"18160",2019,0,25,0,25
"18161",2019,0,25,0,25
"18162",2019,0,25,0,25
"18162",2020,0,0,43,43
"18163",2019,0,25,0,25
"18163",2020,0,0,43,43
"18164",2015,0,0,101,101
"18164",2018,0,0,45,45
"18164",2019,0,25,95,120
"18164",2020,0,0,113,113
"18165",2019,0,25,0,25
"18165",2020,0,0,43,43
"18166",2019,0,25,0,25
"18167",2018,0,0,8,8
"18167",2019,0,25,0,25
"18167",2020,0,0,43,43
"18168",2019,0,25,0,25
"18168",2020,0,0,43,43
"18169",2019,0,25,0,25
"18169",2020,0,0,51,51
"18170",2019,0,25,0,25
"18170",2020,0,0,43,43
"18171",2019,0,25,0,25
"18171",2020,0,0,51,51
"18172",2019,0,25,0,25
"18172",2020,0,0,51,51
"18173",2019,0,25,0,25
"18174",2019,0,25,0,25
"18175",2019,0,25,0,25
"18176",2019,0,25,0,25
"18176",2020,0,0,43,43
"18177",2019,0,25,0,25
"18178",2019,0,25,0,25
"18178",2020,0,0,51,51
"18179",2018,0,0,15,15
"18179",2019,0,25,0,25
"18179",2020,0,0,43,43
"18180",2019,0,25,0,25
"18181",2019,0,25,0,25
"18181",2020,0,0,51,51
"18182",2018,0,0,15,15
"18182",2019,0,25,0,25
"18182",2020,0,0,58,58
"18183",2019,0,25,0,25
"18184",2015,0,0,101,101
"18184",2018,0,0,15,15
"18184",2019,0,25,0,25
"18184",2020,0,0,43,43
"18185",2019,0,25,0,25
"18185",2020,0,0,43,43
"18186",2019,0,25,0,25
"18186",2020,0,0,51,51
"18187",2018,0,0,15,15
"18187",2019,0,25,0,25
"18187",2020,0,0,56,56
"18188",2019,0,25,0,25
"18188",2020,0,0,51,51
"18189",2018,0,0,15,15
"18189",2019,0,25,0,25
"18189",2020,0,0,43,43
"18190",2019,0,25,0,25
"18190",2020,0,0,51,51
"18191",2019,0,25,0,25
"18192",2018,0,0,15,15
"18192",2019,0,25,0,25
"18192",2020,0,0,58,58
"18193",2018,0,0,15,15
"18193",2019,0,25,0,25
"18193",2020,0,0,58,58
"18194",2018,0,0,45,45
"18194",2019,0,25,0,25
"18194",2020,0,0,43,43
"18195",2019,0,25,0,25
"18196",2019,0,25,0,25
"18197",2019,0,25,0,25
"18198",2018,0,0,15,15
"18198",2019,0,25,0,25
"18198",2020,0,0,56,56
"18199",2018,0,0,15,15
"18199",2019,0,25,0,25
"18199",2020,0,0,58,58
"18200",2015,0,0,101,101
"18200",2018,0,0,15,15
"18200",2019,0,25,0,25
"18200",2020,0,0,43,43
"18201",2019,0,25,0,25
"18201",2020,0,0,51,51
"18202",2018,0,0,45,45
"18202",2019,0,25,0,25
"18202",2020,0,0,43,43
"18203",2019,0,25,0,25
"18203",2020,0,0,51,51
"18204",2019,0,25,0,25
"18205",2018,0,0,15,15
"18205",2019,0,25,0,25
"18205",2020,0,0,43,43
"18206",2018,0,0,15,15
"18206",2019,0,25,0,25
"18206",2020,0,0,43,43
"18207",2019,0,25,0,25
"18207",2020,0,0,51,51
"18208",2015,0,0,101,101
"18208",2018,0,0,52,52
"18208",2019,0,25,0,25
"18208",2020,0,0,73,73
"18209",2019,0,25,0,25
"18209",2020,0,0,51,51
"18210",2018,0,0,8,8
"18210",2019,0,25,0,25
"18210",2020,0,0,51,51
"18211",2018,0,0,15,15
"18211",2019,0,25,0,25
"18211",2020,0,0,43,43
"18212",2019,0,25,0,25
"18213",2019,0,25,0,25
"18214",2018,0,0,8,8
"18214",2019,0,25,0,25
"18214",2020,0,0,51,51
"18215",2015,0,0,64,64
"18215",2018,0,0,15,15
"18215",2019,0,25,0,25
"18215",2020,0,0,43,43
"18216",2018,0,0,15,15
"18216",2019,0,25,0,25
"18216",2020,0,0,56,56
"18217",2018,0,0,15,15
"18217",2019,0,25,0,25
"18217",2020,0,0,58,58
"18218",2019,0,25,0,25
"18219",2019,0,25,0,25
"18219",2020,0,0,43,43
"18220",2015,0,0,101,101
"18220",2018,0,0,15,15
"18220",2019,0,25,0,25
"18220",2020,0,0,43,43
"18221",2019,0,25,0,25
"18221",2020,0,0,51,51
"18223",2018,0,0,15,15
"18223",2019,0,25,0,25
"18223",2020,0,0,43,43
"18224",2015,0,0,101,101
"18224",2018,0,0,15,15
"18224",2019,0,25,0,25
"18224",2020,0,0,43,43
"18225",2018,0,0,15,15
"18225",2019,0,25,0,25
"18225",2020,0,0,58,58
"18226",2018,0,0,15,15
"18226",2019,0,25,0,25
"18226",2020,0,0,43,43
"18227",2019,0,25,0,25
"18227",2020,0,0,43,43
"18228",2019,0,25,0,25
"18228",2020,0,0,43,43
"18229",2019,0,25,0,25
"18229",2020,0,0,43,43
"18230",2018,0,0,15,15
"18230",2019,0,25,0,25
"18230",2020,0,0,58,58
"18231",2019,0,25,0,25
"18232",2018,0,0,15,15
"18232",2019,0,25,0,25
"18232",2020,0,0,56,56
"18233",2015,0,0,101,101
"18233",2018,0,0,15,15
"18233",2019,0,25,0,25
"18233",2020,0,0,43,43
"18234",2018,0,0,15,15
"18234",2019,0,25,0,25
"18234",2020,0,0,56,56
"18235",2018,0,0,45,45
"18235",2019,0,25,0,25
"18235",2020,0,0,43,43
"18236",2019,0,25,0,25
"18236",2020,0,0,51,51
"18237",2019,0,25,0,25
"18237",2020,0,0,43,43
"18238",2019,0,25,0,25
"18238",2020,0,0,51,51
"18240",2015,0,0,101,101
"18240",2018,0,0,15,15
"18240",2019,0,25,0,25
"18240",2020,0,0,43,43
"18241",2015,0,0,101,101
"18241",2018,0,0,15,15
"18241",2019,0,25,0,25
"18241",2020,0,0,43,43
"18242",2019,0,25,0,25
"18243",2015,0,0,101,101
"18243",2018,0,0,45,45
"18243",2019,0,25,95,120
"18243",2020,0,0,113,113
"18244",2018,0,0,15,15
"18244",2019,0,25,0,25
"18244",2020,0,0,58,58
"18245",2019,0,25,0,25
"18245",2020,0,0,51,51
"18246",2015,0,0,101,101
"18246",2018,0,0,52,52
"18246",2019,0,25,0,25
"18246",2020,0,0,73,73
"18247",2019,0,25,0,25
"18248",2019,0,25,0,25
"18249",2019,0,25,0,25
"18249",2020,0,0,43,43
"18250",2019,0,25,0,25
"18250",2020,0,0,51,51
"18251",2015,0,0,37,37
"18251",2019,0,25,0,25
"18252",2018,0,0,15,15
"18252",2019,0,25,0,25
"18252",2020,0,0,58,58
"18253",2018,0,0,45,45
"18253",2019,0,25,0,25
"18253",2020,0,0,43,43
"18254",2019,0,25,0,25
"18255",2019,0,25,0,25
"18255",2020,0,0,43,43
"18256",2015,0,0,101,101
"18256",2018,0,0,52,52
"18256",2019,0,25,0,25
"18256",2020,0,0,73,73
"18257",2015,0,0,101,101
"18257",2018,0,0,45,45
"18257",2019,0,25,95,120
"18257",2020,0,0,113,113
"18258",2015,0,0,101,101
"18258",2018,0,0,52,52
"18258",2019,0,25,0,25
"18258",2020,0,0,73,73
"18259",2015,0,0,101,101
"18259",2018,0,0,52,52
"18259",2019,0,25,0,25
"18259",2020,0,0,73,73
"18260",2019,0,25,0,25
"18261",2019,0,25,0,25
"18262",2015,0,0,101,101
"18262",2018,0,0,15,15
"18262",2019,0,25,0,25
"18262",2020,0,0,43,43
"18263",2019,0,25,0,25
"18263",2020,0,0,51,51
"18264",2018,0,0,52,52
"18264",2019,0,25,0,25
"18264",2020,0,0,98,98
"18265",2015,0,0,64,64
"18265",2018,0,0,15,15
"18265",2019,0,25,0,25
"18265",2020,0,0,43,43
"18266",2018,0,0,15,15
"18266",2019,0,25,0,25
"18266",2020,0,0,58,58
"18267",2019,0,25,0,25
"18268",2019,0,25,0,25
"18269",2015,0,0,101,101
"18269",2018,0,0,52,52
"18269",2019,0,25,0,25
"18269",2020,0,0,73,73
"18270",2019,0,25,0,25
"18270",2020,0,0,51,51
"18271",2018,0,0,15,15
"18271",2019,0,25,0,25
"18271",2020,0,0,43,43
"18272",2015,0,0,101,101
"18272",2018,0,0,15,15
"18272",2019,0,25,0,25
"18272",2020,0,0,43,43
"18273",2019,0,25,0,25
"18273",2020,0,0,51,51
"18274",2015,0,0,101,101
"18274",2018,0,0,45,45
"18274",2019,0,25,95,120
"18274",2020,0,0,113,113
"18275",2019,0,25,0,25
"18276",2019,0,25,0,25
"18277",2019,0,25,0,25
"18278",2019,0,25,0,25
"18278",2020,0,0,51,51
"18279",2018,0,0,8,8
"18279",2019,0,25,0,25
"18279",2020,0,0,43,43
"18280",2018,0,0,15,15
"18280",2019,0,25,0,25
"18280",2020,0,0,43,43
"18281",2019,0,25,0,25
"18281",2020,0,0,43,43
"18282",2019,0,25,0,25
"18283",2018,0,0,15,15
"18283",2019,0,25,0,25
"18283",2020,0,0,58,58
"18284",2018,0,0,52,52
"18284",2019,0,25,0,25
"18284",2020,0,0,98,98
"18285",2019,0,25,0,25
"18285",2020,0,0,51,51
"18286",2015,0,0,37,37
"18286",2019,0,25,0,25
"18287",2015,0,0,101,101
"18287",2018,0,0,15,15
"18287",2019,0,25,0,25
"18287",2020,0,0,43,43
"18288",2019,0,25,0,25
"18289",2019,0,25,0,25
"18290",2019,0,25,0,25
"18290",2020,0,0,43,43
"19001",2015,0,58,0,58
"19001",2019,0,17,51,68
"19001",2020,0,0,81,81
"19002",2015,0,58,0,58
"19002",2019,0,17,37,54
"19002",2020,0,0,74,74
"19003",2015,0,58,0,58
"19003",2019,0,17,63,80
"19003",2020,0,0,88,88
"19004",2015,0,58,0,58
"19004",2019,0,17,63,80
"19004",2020,0,0,81,81
"19005",2015,0,58,0,58
"19005",2019,0,17,63,80
"19005",2020,0,0,88,88
"19006",2015,0,58,0,58
"19006",2019,0,17,37,54
"19006",2020,0,0,74,74
"19007",2015,0,58,0,58
"19007",2019,0,17,37,54
"19007",2020,0,0,81,81
"19008",2015,0,58,0,58
"19008",2019,0,17,37,54
"19008",2020,0,0,74,74
"19009",2015,0,58,0,58
"19009",2019,0,17,70,87
"19009",2020,0,0,88,88
"19010",2015,0,58,0,58
"19010",2019,0,17,37,54
"19010",2020,0,0,74,74
"19011",2015,0,58,0,58
"19011",2019,0,17,63,80
"19011",2020,0,0,88,88
"19012",2015,0,58,0,58
"19012",2019,0,17,37,54
"19012",2020,0,0,81,81
"19013",2015,0,58,0,58
"19013",2019,0,17,63,80
"19013",2020,0,0,88,88
"19014",2015,0,58,0,58
"19014",2019,0,17,37,54
"19014",2020,0,0,74,74
"19015",2015,0,58,0,58
"19015",2019,0,17,63,80
"19015",2020,0,0,88,88
"19016",2015,0,58,0,58
"19016",2019,0,17,70,87
"19016",2020,0,0,88,88
"19017",2015,0,58,0,58
"19017",2019,0,17,37,54
"19017",2020,0,0,81,81
"19018",2015,0,58,0,58
"19018",2019,0,17,37,54
"19018",2020,0,0,74,74
"19019",2015,0,58,0,58
"19019",2019,0,17,37,54
"19019",2020,0,0,81,81
"19020",2015,0,58,0,58
"19020",2019,0,17,51,68
"19020",2020,0,0,81,81
"19021",2015,0,58,0,58
"19021",2019,0,17,37,54
"19021",2020,0,0,74,74
"19022",2015,0,58,0,58
"19022",2019,0,17,64,81
"19022",2020,0,0,88,88
"19023",2015,0,58,0,58
"19023",2019,0,17,63,80
"19023",2020,0,0,81,81
"19024",2015,0,58,0,58
"19024",2019,0,17,63,80
"19024",2020,0,0,88,88
"19025",2015,0,58,0,58
"19025",2019,0,17,64,81
"19025",2020,0,0,88,88
"19026",2015,0,58,0,58
"19026",2019,0,17,112,129
"19026",2020,0,0,81,81
"19027",2015,0,58,0,58
"19027",2019,0,17,37,54
"19027",2020,0,0,74,74
"19028",2015,0,58,0,58
"19028",2019,0,17,37,54
"19028",2020,0,0,74,74
"19029",2015,0,58,0,58
"19029",2019,0,17,112,129
"19029",2020,0,0,81,81
"19030",2015,0,58,0,58
"19030",2019,0,17,63,80
"19030",2020,0,0,88,88
"19031",2015,0,58,0,58
"19031",2019,0,17,63,80
"19031",2020,0,0,88,88
"19033",2015,0,58,0,58
"19033",2019,0,17,37,54
"19033",2020,0,0,81,81
"19034",2015,0,58,0,58
"19034",2019,0,17,37,54
"19034",2020,0,0,88,88
"19035",2015,0,58,0,58
"19035",2019,0,17,63,80
"19035",2020,0,0,88,88
"19036",2015,0,58,0,58
"19036",2019,0,17,37,54
"19036",2020,0,0,81,81
"19037",2015,0,58,0,58
"19037",2019,0,17,37,54
"19037",2020,0,0,81,81
"19038",2015,0,58,0,58
"19038",2019,0,17,56,73
"19038",2020,0,0,88,88
"19039",2015,0,58,0,58
"19039",2019,0,17,37,54
"19039",2020,0,0,74,74
"19040",2015,0,58,0,58
"19040",2019,0,17,37,54
"19040",2020,0,0,74,74
"19041",2015,0,58,0,58
"19041",2019,0,17,70,87
"19041",2020,0,0,88,88
"19042",2015,0,58,0,58
"19042",2019,0,17,63,80
"19042",2020,0,0,88,88
"19043",2015,0,58,0,58
"19043",2019,0,17,63,80
"19043",2020,0,0,88,88
"19044",2015,0,58,0,58
"19044",2019,0,17,112,129
"19044",2020,0,0,81,81
"19045",2015,0,58,0,58
"19045",2019,0,17,37,54
"19045",2020,0,0,88,88
"19046",2015,0,58,0,58
"19046",2019,0,17,37,54
"19046",2020,0,0,74,74
"19047",2015,0,58,0,58
"19047",2019,0,17,63,80
"19047",2020,0,0,88,88
"19048",2015,0,58,0,58
"19048",2019,0,17,63,80
"19048",2020,0,0,88,88
"19049",2015,0,58,0,58
"19049",2019,0,17,63,80
"19049",2020,0,0,88,88
"19050",2015,0,58,0,58
"19050",2019,0,17,112,129
"19050",2020,0,0,81,81
"19051",2015,0,58,0,58
"19051",2019,0,17,51,68
"19051",2020,0,0,81,81
"19052",2015,0,58,0,58
"19052",2019,0,17,37,54
"19052",2020,0,0,74,74
"19053",2015,0,58,0,58
"19053",2019,0,17,37,54
"19053",2020,0,0,74,74
"19054",2015,0,58,0,58
"19054",2019,0,17,37,54
"19054",2020,0,0,81,81
"19055",2015,0,58,0,58
"19055",2019,0,17,37,54
"19055",2020,0,0,74,74
"19056",2015,0,58,0,58
"19056",2019,0,17,37,54
"19056",2020,0,0,74,74
"19057",2015,0,58,0,58
"19057",2019,0,17,63,80
"19057",2020,0,0,81,81
"19058",2015,0,58,0,58
"19058",2019,0,17,37,54
"19058",2020,0,0,74,74
"19059",2015,0,58,0,58
"19059",2019,0,17,63,80
"19059",2020,0,0,88,88
"19060",2015,0,58,0,58
"19060",2019,0,17,51,68
"19060",2020,0,0,81,81
"19061",2015,0,58,0,58
"19061",2019,0,17,63,80
"19061",2020,0,0,88,88
"19062",2015,0,58,0,58
"19062",2019,0,17,70,87
"19062",2020,0,0,88,88
"19063",2015,0,58,0,58
"19063",2019,0,17,63,80
"19063",2020,0,0,81,81
"19064",2015,0,58,0,58
"19064",2019,0,17,37,54
"19064",2020,0,0,74,74
"19065",2015,0,58,0,58
"19065",2019,0,17,37,54
"19065",2020,0,0,74,74
"19066",2015,0,58,0,58
"19066",2019,0,17,63,80
"19066",2020,0,0,88,88
"19067",2015,0,58,0,58
"19067",2019,0,17,112,129
"19067",2020,0,0,81,81
"19068",2015,0,58,0,58
"19068",2019,0,17,63,80
"19068",2020,0,0,88,88
"19069",2015,0,58,0,58
"19069",2019,0,17,37,54
"19069",2020,0,0,88,88
"19070",2015,0,58,0,58
"19070",2019,0,17,37,54
"19070",2020,0,0,74,74
"19071",2015,0,58,0,58
"19071",2019,0,17,37,54
"19071",2020,0,0,74,74
"19072",2015,0,58,0,58
"19072",2019,0,17,63,80
"19072",2020,0,0,88,88
"19073",2015,0,58,0,58
"19073",2019,0,17,37,54
"19073",2020,0,0,74,74
"19074",2015,0,58,0,58
"19074",2019,0,17,20,37
"19074",2020,0,0,88,88
"19075",2015,0,58,0,58
"19075",2019,0,17,37,54
"19075",2020,0,0,74,74
"19076",2015,0,58,0,58
"19076",2019,0,17,37,54
"19076",2020,0,0,81,81
"19077",2015,0,58,0,58
"19077",2019,0,17,63,80
"19077",2020,0,0,81,81
"19078",2015,0,58,0,58
"19078",2019,0,17,63,80
"19078",2020,0,0,88,88
"19079",2015,0,58,0,58
"19079",2019,0,17,51,68
"19079",2020,0,0,81,81
"19080",2015,0,58,0,58
"19080",2019,0,17,37,54
"19080",2020,0,0,74,74
"19081",2015,0,58,0,58
"19081",2019,0,17,37,54
"19081",2020,0,0,74,74
"19082",2015,0,58,0,58
"19082",2019,0,17,56,73
"19082",2020,0,0,88,88
"19083",2015,0,58,0,58
"19083",2019,0,17,37,54
"19083",2020,0,0,74,74
"19084",2015,0,58,0,58
"19084",2019,0,17,112,129
"19084",2020,0,0,81,81
"19085",2015,0,58,0,58
"19085",2019,0,17,70,87
"19085",2020,0,0,88,88
"19086",2015,0,58,0,58
"19086",2019,0,17,37,54
"19086",2020,0,0,88,88
"19087",2015,0,58,0,58
"19087",2019,0,17,51,68
"19087",2020,0,0,81,81
"19088",2015,0,58,0,58
"19088",2019,0,17,70,87
"19088",2020,0,0,88,88
"19089",2015,0,58,0,58
"19089",2019,0,17,37,54
"19089",2020,0,0,74,74
"19090",2015,0,58,0,58
"19090",2019,0,17,37,54
"19090",2020,0,0,74,74
"19091",2015,0,58,0,58
"19091",2019,0,17,37,54
"19091",2020,0,0,74,74
"19093",2015,0,58,0,58
"19093",2019,0,17,63,80
"19093",2020,0,0,81,81
"19094",2015,0,58,0,58
"19094",2019,0,17,63,80
"19094",2020,0,0,88,88
"19095",2015,0,58,0,58
"19095",2019,0,17,37,54
"19095",2020,0,0,81,81
"19096",2015,0,58,0,58
"19096",2019,0,17,70,87
"19096",2020,0,0,88,88
"19097",2015,0,58,0,58
"19097",2019,0,17,37,54
"19097",2020,0,0,74,74
"19098",2015,0,58,0,58
"19098",2019,0,17,70,87
"19098",2020,0,0,81,81
"19099",2015,0,58,0,58
"19099",2019,0,17,63,80
"19099",2020,0,0,81,81
"19100",2015,0,58,0,58
"19100",2019,0,17,37,54
"19100",2020,0,0,81,81
"19101",2015,0,58,0,58
"19101",2019,0,17,56,73
"19101",2020,0,0,88,88
"19102",2015,0,58,0,58
"19102",2019,0,17,37,54
"19102",2020,0,0,74,74
"19103",2015,0,58,0,58
"19103",2019,0,17,37,54
"19103",2020,0,0,74,74
"19104",2015,0,58,0,58
"19104",2019,0,17,51,68
"19104",2020,0,0,81,81
"19105",2015,0,58,0,58
"19105",2019,0,17,63,80
"19105",2020,0,0,88,88
"19106",2015,0,58,0,58
"19106",2019,0,17,37,54
"19106",2020,0,0,74,74
"19107",2015,0,58,0,58
"19107",2019,0,17,63,80
"19107",2020,0,0,88,88
"19108",2015,0,58,0,58
"19108",2019,0,17,37,54
"19108",2020,0,0,74,74
"19109",2015,0,58,0,58
"19109",2019,0,17,63,80
"19109",2020,0,0,88,88
"19110",2015,0,58,0,58
"19110",2019,0,17,37,54
"19110",2020,0,0,74,74
"19111",2015,0,58,0,58
"19111",2019,0,17,37,54
"19111",2020,0,0,74,74
"19112",2015,0,58,0,58
"19112",2019,0,17,51,68
"19112",2020,0,0,81,81
"19113",2015,0,58,0,58
"19113",2019,0,17,37,54
"19113",2020,0,0,74,74
"19114",2015,0,58,0,58
"19114",2019,0,17,37,54
"19114",2020,0,0,74,74
"19115",2015,0,58,0,58
"19115",2019,0,17,112,129
"19115",2020,0,0,81,81
"19116",2015,0,58,0,58
"19116",2019,0,17,112,129
"19116",2020,0,0,81,81
"19117",2015,0,58,0,58
"19117",2019,0,17,63,80
"19117",2020,0,0,88,88
"19118",2015,0,58,0,58
"19118",2019,0,17,51,68
"19118",2020,0,0,81,81
"19119",2015,0,58,0,58
"19119",2019,0,17,112,129
"19119",2020,0,0,81,81
"19120",2015,0,58,0,58
"19120",2019,0,17,63,80
"19120",2020,0,0,88,88
"19121",2015,0,58,0,58
"19121",2019,0,17,63,80
"19121",2020,0,0,88,88
"19122",2015,0,58,0,58
"19122",2019,0,17,51,68
"19122",2020,0,0,81,81
"19123",2015,0,58,0,58
"19123",2019,0,17,63,80
"19123",2020,0,0,88,88
"19124",2015,0,58,0,58
"19124",2019,0,17,63,80
"19124",2020,0,0,88,88
"19125",2015,0,58,0,58
"19125",2019,0,17,37,54
"19125",2020,0,0,74,74
"19126",2015,0,58,0,58
"19126",2019,0,17,112,129
"19126",2020,0,0,81,81
"19128",2015,0,58,0,58
"19128",2019,0,17,37,54
"19128",2020,0,0,74,74
"19129",2015,0,58,0,58
"19129",2019,0,17,37,54
"19129",2020,0,0,81,81
"19130",2015,0,58,0,58
"19130",2019,0,17,37,54
"19130",2020,0,0,74,74
"19131",2015,0,58,0,58
"19131",2019,0,17,37,54
"19131",2020,0,0,81,81
"19132",2015,0,58,0,58
"19132",2019,0,17,63,80
"19132",2020,0,0,81,81
"19133",2015,0,58,0,58
"19133",2019,0,17,37,54
"19133",2020,0,0,88,88
"19134",2015,0,58,0,58
"19134",2019,0,17,37,54
"19134",2020,0,0,74,74
"19135",2015,0,58,0,58
"19135",2019,0,17,37,54
"19135",2020,0,0,74,74
"19136",2015,0,58,0,58
"19136",2019,0,17,37,54
"19136",2020,0,0,74,74
"19137",2015,0,58,0,58
"19137",2019,0,17,70,87
"19137",2020,0,0,88,88
"19138",2015,0,58,0,58
"19138",2019,0,17,112,129
"19138",2020,0,0,81,81
"19139",2015,0,58,0,58
"19139",2019,0,17,37,54
"19139",2020,0,0,74,74
"19140",2015,0,58,0,58
"19140",2019,0,17,37,54
"19140",2020,0,0,81,81
"19141",2015,0,58,0,58
"19141",2019,0,17,37,54
"19141",2020,0,0,74,74
"19142",2015,0,58,0,58
"19142",2019,0,17,37,54
"19142",2020,0,0,74,74
"19143",2015,0,58,0,58
"19143",2019,0,17,37,54
"19143",2020,0,0,74,74
"19144",2015,0,58,0,58
"19144",2019,0,17,64,81
"19144",2020,0,0,88,88
"19145",2015,0,58,0,58
"19145",2019,0,17,37,54
"19145",2020,0,0,74,74
"19146",2015,0,58,0,58
"19146",2019,0,17,70,87
"19146",2020,0,0,88,88
"19147",2015,0,58,0,58
"19147",2019,0,17,63,80
"19147",2020,0,0,81,81
"19148",2015,0,58,0,58
"19148",2019,0,17,37,54
"19148",2020,0,0,74,74
"19149",2015,0,58,0,58
"19149",2019,0,17,112,129
"19149",2020,0,0,81,81
"19150",2015,0,58,0,58
"19150",2019,0,17,63,80
"19150",2020,0,0,81,81
"19151",2015,0,58,0,58
"19151",2019,0,17,63,80
"19151",2020,0,0,88,88
"19152",2015,0,58,0,58
"19152",2019,0,17,112,129
"19152",2020,0,0,81,81
"19153",2015,0,58,0,58
"19153",2019,0,17,63,80
"19153",2020,0,0,88,88
"19154",2015,0,58,0,58
"19154",2019,0,17,63,80
"19154",2020,0,0,88,88
"19155",2015,0,58,0,58
"19155",2019,0,17,70,87
"19155",2020,0,0,88,88
"19156",2015,0,58,0,58
"19156",2019,0,17,63,80
"19156",2020,0,0,88,88
"19157",2015,0,58,0,58
"19157",2019,0,17,37,54
"19157",2020,0,0,74,74
"19158",2015,0,58,0,58
"19158",2019,0,17,70,87
"19158",2020,0,0,81,81
"19159",2015,0,58,0,58
"19159",2019,0,17,37,54
"19159",2020,0,0,74,74
"19160",2015,0,58,0,58
"19160",2019,0,17,37,54
"19160",2020,0,0,74,74
"19161",2015,0,58,0,58
"19161",2019,0,17,63,80
"19161",2020,0,0,88,88
"19162",2015,0,58,0,58
"19162",2019,0,17,63,80
"19162",2020,0,0,88,88
"19163",2015,0,58,0,58
"19163",2019,0,17,63,80
"19163",2020,0,0,81,81
"19164",2015,0,58,0,58
"19164",2019,0,17,37,54
"19164",2020,0,0,81,81
"19165",2015,0,58,0,58
"19165",2019,0,17,51,68
"19165",2020,0,0,81,81
"19166",2015,0,58,0,58
"19166",2019,0,17,51,68
"19166",2020,0,0,81,81
"19167",2015,0,58,0,58
"19167",2019,0,17,37,54
"19167",2020,0,0,74,74
"19168",2015,0,58,0,58
"19168",2019,0,17,51,68
"19168",2020,0,0,81,81
"19169",2015,0,58,0,58
"19169",2019,0,17,112,129
"19169",2020,0,0,81,81
"19170",2015,0,58,0,58
"19170",2019,0,17,112,129
"19170",2020,0,0,81,81
"19171",2015,0,58,0,58
"19171",2019,0,17,37,54
"19171",2020,0,0,81,81
"19172",2015,0,58,0,58
"19172",2019,0,17,51,68
"19172",2020,0,0,81,81
"19173",2015,0,58,0,58
"19173",2019,0,17,37,54
"19173",2020,0,0,74,74
"19174",2015,0,58,0,58
"19174",2019,0,17,37,54
"19174",2020,0,0,74,74
"19175",2015,0,58,0,58
"19175",2019,0,17,37,54
"19175",2020,0,0,74,74
"19176",2015,0,58,0,58
"19176",2019,0,17,37,54
"19176",2020,0,0,74,74
"19177",2015,0,58,0,58
"19177",2019,0,17,63,80
"19177",2020,0,0,88,88
"19178",2015,0,58,0,58
"19178",2019,0,17,63,80
"19178",2020,0,0,88,88
"19179",2015,0,58,0,58
"19179",2019,0,17,112,129
"19179",2020,0,0,81,81
"19180",2015,0,58,0,58
"19180",2019,0,17,37,54
"19180",2020,0,0,74,74
"19181",2015,0,58,0,58
"19181",2019,0,17,51,68
"19181",2020,0,0,81,81
"19182",2015,0,58,0,58
"19182",2019,0,17,63,80
"19182",2020,0,0,88,88
"19184",2015,0,58,0,58
"19184",2019,0,17,112,129
"19184",2020,0,0,81,81
"19186",2015,0,58,0,58
"19186",2019,0,17,37,54
"19186",2020,0,0,74,74
"19187",2015,0,58,0,58
"19187",2019,0,17,63,80
"19187",2020,0,0,88,88
"19188",2015,0,58,0,58
"19188",2019,0,17,63,80
"19188",2020,0,0,88,88
"19189",2015,0,58,0,58
"19189",2019,0,17,37,54
"19189",2020,0,0,88,88
"19190",2015,0,58,0,58
"19190",2019,0,17,37,54
"19190",2020,0,0,74,74
"19191",2015,0,58,0,58
"19191",2019,0,17,63,80
"19191",2020,0,0,88,88
"19192",2015,0,58,0,58
"19192",2019,0,17,37,54
"19192",2020,0,0,74,74
"19193",2015,0,58,0,58
"19193",2019,0,17,37,54
"19193",2020,0,0,88,88
"19194",2015,0,58,0,58
"19194",2019,0,17,56,73
"19194",2020,0,0,88,88
"19195",2015,0,58,0,58
"19195",2019,0,17,63,80
"19195",2020,0,0,88,88
"19196",2015,0,58,0,58
"19196",2019,0,17,63,80
"19196",2020,0,0,88,88
"19198",2015,0,58,0,58
"19198",2019,0,17,64,81
"19198",2020,0,0,88,88
"19199",2015,0,58,0,58
"19199",2019,0,17,37,54
"19199",2020,0,0,74,74
"19200",2015,0,58,0,58
"19200",2019,0,17,37,54
"19200",2020,0,0,74,74
"19201",2015,0,58,0,58
"19201",2019,0,17,37,54
"19201",2020,0,0,74,74
"19202",2015,0,58,0,58
"19202",2019,0,17,63,80
"19202",2020,0,0,88,88
"19203",2015,0,58,0,58
"19203",2019,0,17,56,73
"19203",2020,0,0,81,81
"19204",2015,0,58,0,58
"19204",2019,0,17,37,54
"19204",2020,0,0,74,74
"19205",2015,0,58,0,58
"19205",2019,0,17,37,54
"19205",2020,0,0,88,88
"19206",2015,0,58,0,58
"19206",2019,0,17,37,54
"19206",2020,0,0,74,74
"19207",2015,0,58,0,58
"19207",2019,0,17,63,80
"19207",2020,0,0,88,88
"19208",2015,0,58,0,58
"19208",2019,0,17,37,54
"19208",2020,0,0,74,74
"19209",2015,0,58,0,58
"19209",2019,0,17,37,54
"19209",2020,0,0,81,81
"19210",2015,0,58,0,58
"19210",2019,0,17,37,54
"19210",2020,0,0,74,74
"19211",2015,0,58,0,58
"19211",2019,0,17,63,80
"19211",2020,0,0,88,88
"19212",2015,0,58,0,58
"19212",2019,0,17,112,129
"19212",2020,0,0,81,81
"19213",2015,0,58,0,58
"19213",2019,0,17,37,54
"19213",2020,0,0,81,81
"19214",2015,0,58,0,58
"19214",2019,0,17,37,54
"19214",2020,0,0,88,88
"19215",2015,0,58,0,58
"19215",2019,0,17,37,54
"19215",2020,0,0,88,88
"19216",2015,0,58,0,58
"19216",2019,0,17,64,81
"19216",2020,0,0,88,88
"19217",2015,0,58,0,58
"19217",2019,0,17,112,129
"19217",2020,0,0,81,81
"19219",2015,0,58,0,58
"19219",2019,0,17,37,54
"19219",2020,0,0,74,74
"19220",2015,0,58,0,58
"19220",2019,0,17,37,54
"19220",2020,0,0,74,74
"19221",2015,0,58,0,58
"19221",2019,0,17,37,54
"19221",2020,0,0,74,74
"19222",2015,0,58,0,58
"19222",2019,0,17,37,54
"19222",2020,0,0,74,74
"19223",2015,0,58,0,58
"19223",2019,0,17,63,80
"19223",2020,0,0,88,88
"19225",2015,0,58,0,58
"19225",2019,0,17,37,54
"19225",2020,0,0,74,74
"19226",2015,0,58,0,58
"19226",2019,0,17,37,54
"19226",2020,0,0,81,81
"19227",2015,0,58,0,58
"19227",2019,0,17,56,73
"19227",2020,0,0,88,88
"19228",2015,0,58,0,58
"19228",2019,0,17,37,54
"19228",2020,0,0,74,74
"19229",2015,0,58,0,58
"19229",2019,0,17,63,80
"19229",2020,0,0,88,88
"19230",2015,0,58,0,58
"19230",2019,0,17,63,80
"19230",2020,0,0,88,88
"19231",2015,0,58,0,58
"19231",2019,0,17,37,54
"19231",2020,0,0,74,74
"19232",2015,0,58,0,58
"19232",2019,0,17,37,54
"19232",2020,0,0,74,74
"19233",2015,0,58,0,58
"19233",2019,0,17,37,54
"19233",2020,0,0,74,74
"19234",2015,0,58,0,58
"19234",2019,0,17,63,80
"19234",2020,0,0,88,88
"19235",2015,0,58,0,58
"19235",2019,0,17,37,54
"19235",2020,0,0,74,74
"19236",2015,0,58,0,58
"19236",2019,0,17,37,54
"19236",2020,0,0,74,74
"19237",2015,0,58,0,58
"19237",2019,0,17,37,54
"19237",2020,0,0,88,88
"19238",2015,0,58,0,58
"19238",2019,0,17,37,54
"19238",2020,0,0,74,74
"19239",2015,0,58,0,58
"19239",2019,0,17,63,80
"19239",2020,0,0,88,88
"19240",2015,0,58,0,58
"19240",2019,0,17,51,68
"19240",2020,0,0,81,81
"19241",2015,0,58,0,58
"19241",2019,0,17,37,54
"19241",2020,0,0,74,74
"19242",2015,0,58,0,58
"19242",2019,0,17,63,80
"19242",2020,0,0,88,88
"19243",2015,0,58,0,58
"19243",2019,0,17,63,80
"19243",2020,0,0,88,88
"19244",2015,0,58,0,58
"19244",2019,0,17,37,54
"19244",2020,0,0,74,74
"19245",2015,0,58,0,58
"19245",2019,0,17,37,54
"19245",2020,0,0,74,74
"19246",2015,0,58,0,58
"19246",2019,0,17,63,80
"19246",2020,0,0,88,88
"19247",2015,0,58,0,58
"19247",2019,0,17,37,54
"19247",2020,0,0,74,74
"19248",2015,0,58,0,58
"19248",2019,0,17,37,54
"19248",2020,0,0,81,81
"19249",2015,0,58,0,58
"19249",2019,0,17,37,54
"19249",2020,0,0,74,74
"19250",2015,0,58,0,58
"19250",2019,0,17,37,54
"19250",2020,0,0,81,81
"19251",2015,0,58,0,58
"19251",2019,0,17,70,87
"19251",2020,0,0,88,88
"19252",2015,0,58,0,58
"19252",2019,0,17,37,54
"19252",2020,0,0,74,74
"19253",2015,0,58,0,58
"19253",2019,0,17,63,80
"19253",2020,0,0,88,88
"19254",2015,0,58,0,58
"19254",2019,0,17,64,81
"19254",2020,0,0,88,88
"19255",2015,0,58,0,58
"19255",2019,0,17,37,54
"19255",2020,0,0,81,81
"19256",2015,0,58,0,58
"19256",2019,0,17,37,54
"19256",2020,0,0,74,74
"19257",2015,0,58,0,58
"19257",2019,0,17,63,80
"19257",2020,0,0,81,81
"19258",2015,0,58,0,58
"19258",2019,0,17,37,54
"19258",2020,0,0,74,74
"19259",2015,0,58,0,58
"19259",2019,0,17,37,54
"19259",2020,0,0,88,88
"19260",2015,0,58,0,58
"19260",2019,0,17,112,129
"19260",2020,0,0,81,81
"19261",2015,0,58,0,58
"19261",2019,0,17,37,54
"19261",2020,0,0,74,74
"19262",2015,0,58,0,58
"19262",2019,0,17,51,68
"19262",2020,0,0,81,81
"19263",2015,0,58,0,58
"19263",2019,0,17,37,54
"19263",2020,0,0,74,74
"19264",2015,0,58,0,58
"19264",2019,0,17,37,54
"19264",2020,0,0,74,74
"19265",2015,0,58,0,58
"19265",2019,0,17,37,54
"19265",2020,0,0,81,81
"19266",2015,0,58,0,58
"19266",2019,0,17,37,54
"19266",2020,0,0,74,74
"19268",2015,0,58,0,58
"19268",2019,0,17,37,54
"19268",2020,0,0,81,81
"19269",2015,0,58,0,58
"19269",2019,0,17,51,68
"19269",2020,0,0,81,81
"19270",2015,0,58,0,58
"19270",2019,0,17,63,80
"19270",2020,0,0,88,88
"19271",2015,0,58,0,58
"19271",2019,0,17,112,129
"19271",2020,0,0,81,81
"19272",2015,0,58,0,58
"19272",2019,0,17,56,73
"19272",2020,0,0,88,88
"19273",2015,0,58,0,58
"19273",2019,0,17,63,80
"19273",2020,0,0,81,81
"19274",2015,0,58,0,58
"19274",2019,0,17,63,80
"19274",2020,0,0,88,88
"19275",2015,0,58,0,58
"19275",2019,0,17,37,54
"19275",2020,0,0,74,74
"19276",2015,0,58,0,58
"19276",2019,0,17,37,54
"19276",2020,0,0,81,81
"19277",2015,0,58,0,58
"19277",2019,0,17,37,54
"19277",2020,0,0,74,74
"19278",2015,0,58,0,58
"19278",2019,0,17,63,80
"19278",2020,0,0,88,88
"19279",2015,0,58,0,58
"19279",2019,0,17,63,80
"19279",2020,0,0,88,88
"19280",2015,0,58,0,58
"19280",2019,0,17,112,129
"19280",2020,0,0,81,81
"19281",2015,0,58,0,58
"19281",2019,0,17,51,68
"19281",2020,0,0,81,81
"19283",2015,0,58,0,58
"19283",2019,0,17,37,54
"19283",2020,0,0,74,74
"19284",2015,0,58,0,58
"19284",2019,0,17,37,54
"19284",2020,0,0,81,81
"19285",2015,0,58,0,58
"19285",2019,0,17,63,80
"19285",2020,0,0,88,88
"19286",2015,0,58,0,58
"19286",2019,0,17,63,80
"19286",2020,0,0,88,88
"19287",2015,0,58,0,58
"19287",2019,0,17,37,54
"19287",2020,0,0,74,74
"19288",2015,0,58,0,58
"19288",2019,0,17,63,80
"19288",2020,0,0,88,88
"19289",2015,0,58,0,58
"19289",2019,0,17,63,80
"19289",2020,0,0,88,88
"22001",2016,0,0,36,36
"22001",2018,0,71,71,142
"22002",2016,0,0,36,36
"22002",2018,0,71,71,142
"22003",2016,0,0,36,36
"22003",2018,0,71,71,142
"22004",2016,0,0,36,36
"22004",2018,0,71,71,142
"22005",2016,0,0,36,36
"22005",2018,0,71,71,142
"22006",2016,0,0,36,36
"22006",2018,0,71,71,142
"22008",2016,0,0,36,36
"22008",2018,0,71,71,142
"22009",2016,0,0,36,36
"22009",2018,0,71,71,142
"22011",2016,0,0,36,36
"22011",2018,0,71,71,142
"22012",2016,0,0,36,36
"22012",2018,0,71,71,142
"22013",2016,0,0,36,36
"22013",2018,0,71,71,142
"22014",2016,0,0,36,36
"22014",2018,0,71,71,142
"22015",2016,0,0,36,36
"22015",2018,0,71,71,142
"22016",2016,0,0,36,36
"22016",2018,0,71,71,142
"22018",2016,0,0,36,36
"22018",2018,0,71,71,142
"22019",2016,0,0,36,36
"22019",2018,0,71,71,142
"22020",2016,0,0,36,36
"22020",2018,0,71,71,142
"22021",2016,0,0,36,36
"22021",2018,0,71,71,142
"22023",2016,0,0,36,36
"22023",2018,0,71,71,142
"22024",2016,0,0,36,36
"22024",2018,0,71,71,142
"22025",2016,0,0,36,36
"22025",2018,0,71,71,142
"22026",2016,0,0,36,36
"22026",2018,0,71,71,142
"22027",2016,0,0,36,36
"22027",2018,0,71,71,142
"22028",2016,0,0,36,36
"22028",2018,0,71,71,142
"22029",2016,0,0,36,36
"22029",2018,0,71,71,142
"22030",2016,0,0,36,36
"22030",2018,0,71,71,142
"22031",2016,0,0,36,36
"22031",2018,0,71,71,142
"22032",2016,0,0,36,36
"22032",2018,0,71,71,142
"22033",2016,0,0,36,36
"22033",2018,0,71,71,142
"22034",2016,0,0,36,36
"22034",2018,0,71,71,142
"22035",2016,0,0,36,36
"22035",2018,0,71,71,142
"22036",2016,0,0,36,36
"22036",2018,0,71,71,142
"22037",2016,0,0,36,36
"22037",2018,0,71,71,142
"22039",2016,0,0,36,36
"22039",2018,0,71,71,142
"22040",2016,0,0,36,36
"22040",2018,0,71,71,142
"22041",2016,0,0,36,36
"22041",2018,0,71,71,142
"22042",2016,0,0,36,36
"22042",2018,0,71,71,142
"22043",2016,0,0,36,36
"22043",2018,0,71,71,142
"22044",2016,0,0,36,36
"22044",2018,0,71,71,142
"22045",2016,0,0,36,36
"22045",2018,0,71,71,142
"22046",2016,0,0,36,36
"22046",2018,0,71,71,142
"22047",2016,0,0,36,36
"22047",2018,0,71,71,142
"22048",2016,0,0,36,36
"22048",2018,0,71,71,142
"22049",2016,0,0,36,36
"22049",2018,0,71,71,142
"22050",2016,0,0,36,36
"22050",2018,0,71,71,142
"22052",2016,0,0,36,36
"22052",2018,0,71,71,142
"22053",2016,0,0,36,36
"22053",2018,0,71,71,142
"22054",2016,0,0,36,36
"22054",2018,0,71,71,142
"22055",2016,0,0,36,36
"22055",2018,0,71,71,142
"22056",2016,0,0,36,36
"22056",2018,0,71,71,142
"22057",2016,0,0,36,36
"22057",2018,0,71,71,142
"22059",2016,0,0,36,36
"22059",2018,0,71,71,142
"22060",2016,0,0,36,36
"22060",2018,0,71,71,142
"22061",2016,0,0,36,36
"22061",2018,0,71,71,142
"22062",2016,0,0,36,36
"22062",2018,0,71,71,142
"22063",2016,0,0,36,36
"22063",2018,0,71,71,142
"22064",2016,0,0,36,36
"22064",2018,0,71,71,142
"22065",2016,0,0,36,36
"22065",2018,0,71,71,142
"22067",2016,0,0,36,36
"22067",2018,0,71,71,142
"22068",2016,0,0,36,36
"22068",2018,0,71,71,142
"22069",2016,0,0,36,36
"22069",2018,0,71,71,142
"22070",2016,0,0,36,36
"22070",2018,0,71,71,142
"22071",2016,0,0,36,36
"22071",2018,0,71,71,142
"22072",2016,0,0,36,36
"22072",2018,0,71,71,142
"22073",2016,0,0,36,36
"22073",2018,0,71,71,142
"22074",2016,0,0,36,36
"22074",2018,0,71,71,142
"22075",2016,0,0,36,36
"22075",2018,0,71,71,142
"22076",2016,0,0,36,36
"22076",2018,0,71,71,142
"22077",2016,0,0,36,36
"22077",2018,0,71,71,142
"22079",2016,0,0,36,36
"22079",2018,0,71,71,142
"22081",2016,0,0,36,36
"22081",2018,0,71,71,142
"22082",2016,0,0,36,36
"22082",2018,0,71,71,142
"22083",2016,0,0,36,36
"22083",2018,0,71,71,142
"22084",2016,0,0,36,36
"22084",2018,0,71,71,142
"22085",2016,0,0,36,36
"22085",2018,0,71,71,142
"22086",2016,0,0,36,36
"22086",2018,0,71,71,142
"22087",2016,0,0,36,36
"22087",2018,0,71,71,142
"22088",2016,0,0,36,36
"22088",2018,0,71,71,142
"22090",2016,0,0,36,36
"22090",2018,0,71,71,142
"22091",2016,0,0,36,36
"22091",2018,0,71,71,142
"22092",2016,0,0,36,36
"22092",2018,0,71,71,142
"22093",2016,0,0,36,36
"22093",2018,0,71,71,142
"22094",2016,0,0,36,36
"22094",2018,0,71,71,142
"22095",2016,0,0,36,36
"22095",2018,0,71,71,142
"22096",2016,0,0,36,36
"22096",2018,0,71,71,142
"22097",2016,0,0,36,36
"22097",2018,0,71,71,142
"22098",2016,0,0,36,36
"22098",2018,0,71,71,142
"22099",2016,0,0,36,36
"22099",2018,0,71,71,142
"22101",2016,0,0,36,36
"22101",2018,0,71,71,142
"22103",2016,0,0,36,36
"22103",2018,0,71,71,142
"22104",2016,0,0,36,36
"22104",2018,0,71,71,142
"22105",2016,0,0,36,36
"22105",2018,0,71,71,142
"22106",2016,0,0,36,36
"22106",2018,0,71,71,142
"22107",2016,0,0,36,36
"22107",2018,0,71,71,142
"22108",2016,0,0,36,36
"22108",2018,0,71,71,142
"22109",2016,0,0,36,36
"22109",2018,0,71,71,142
"22110",2016,0,0,36,36
"22110",2018,0,71,71,142
"22111",2016,0,0,36,36
"22111",2018,0,71,71,142
"22112",2016,0,0,36,36
"22112",2018,0,71,71,142
"22113",2016,0,0,36,36
"22113",2018,0,71,71,142
"22114",2016,0,0,36,36
"22114",2018,0,71,71,142
"22115",2016,0,0,36,36
"22115",2018,0,71,71,142
"22116",2016,0,0,36,36
"22116",2018,0,71,71,142
"22117",2016,0,0,36,36
"22117",2018,0,71,71,142
"22118",2016,0,0,36,36
"22118",2018,0,71,71,142
"22119",2016,0,0,36,36
"22119",2018,0,71,71,142
"22121",2016,0,0,36,36
"22121",2018,0,71,71,142
"22122",2016,0,0,36,36
"22122",2018,0,71,71,142
"22124",2016,0,0,36,36
"22124",2018,0,71,71,142
"22126",2016,0,0,36,36
"22126",2018,0,71,71,142
"22127",2016,0,0,36,36
"22127",2018,0,71,71,142
"22128",2016,0,0,36,36
"22128",2018,0,71,71,142
"22129",2016,0,0,36,36
"22129",2018,0,71,71,142
"22131",2016,0,0,36,36
"22131",2018,0,71,71,142
"22132",2016,0,0,36,36
"22132",2018,0,71,71,142
"22133",2016,0,0,36,36
"22133",2018,0,71,71,142
"22134",2016,0,0,36,36
"22134",2018,0,71,71,142
"22135",2016,0,0,36,36
"22135",2018,0,71,71,142
"22136",2016,0,0,36,36
"22136",2018,0,71,71,142
"22137",2016,0,0,36,36
"22137",2018,0,71,71,142
"22138",2016,0,0,36,36
"22138",2018,0,71,71,142
"22139",2016,0,0,36,36
"22139",2018,0,71,71,142
"22140",2016,0,0,36,36
"22140",2018,0,71,71,142
"22141",2016,0,0,36,36
"22141",2018,0,71,71,142
"22143",2016,0,0,36,36
"22143",2018,0,71,71,142
"22144",2016,0,0,36,36
"22144",2018,0,71,71,142
"22145",2016,0,0,36,36
"22145",2018,0,71,71,142
"22146",2016,0,0,36,36
"22146",2018,0,71,71,142
"22147",2016,0,0,36,36
"22147",2018,0,71,71,142
"22148",2016,0,0,36,36
"22148",2018,0,71,71,142
"22149",2016,0,0,36,36
"22149",2018,0,71,71,142
"22150",2016,0,0,36,36
"22150",2018,0,71,71,142
"22152",2016,0,0,36,36
"22152",2018,0,71,71,142
"22153",2016,0,0,36,36
"22153",2018,0,71,71,142
"22155",2016,0,0,36,36
"22155",2018,0,71,71,142
"22156",2016,0,0,36,36
"22156",2018,0,71,71,142
"22157",2016,0,0,36,36
"22157",2018,0,71,71,142
"22158",2016,0,0,36,36
"22158",2018,0,71,71,142
"22160",2016,0,0,36,36
"22160",2018,0,71,71,142
"22161",2016,0,0,36,36
"22161",2018,0,71,71,142
"22162",2016,0,0,36,36
"22162",2018,0,71,71,142
"22163",2016,0,0,36,36
"22163",2018,0,71,71,142
"22164",2016,0,0,36,36
"22164",2018,0,71,71,142
"22165",2016,0,0,36,36
"22165",2018,0,71,71,142
"22166",2016,0,0,36,36
"22166",2018,0,71,71,142
"22168",2016,0,0,36,36
"22168",2018,0,71,71,142
"22169",2016,0,0,36,36
"22169",2018,0,71,71,142
"22170",2016,0,0,36,36
"22170",2018,0,71,71,142
"22171",2016,0,0,36,36
"22171",2018,0,71,71,142
"22172",2016,0,0,36,36
"22172",2018,0,71,71,142
"22174",2016,0,0,36,36
"22174",2018,0,71,71,142
"22175",2016,0,0,36,36
"22175",2018,0,71,71,142
"22176",2016,0,0,36,36
"22176",2018,0,71,71,142
"22177",2016,0,0,36,36
"22177",2018,0,71,71,142
"22178",2016,0,0,36,36
"22178",2018,0,71,71,142
"22179",2016,0,0,36,36
"22179",2018,0,71,71,142
"22180",2016,0,0,36,36
"22180",2018,0,71,71,142
"22181",2016,0,0,36,36
"22181",2018,0,71,71,142
"22182",2016,0,0,36,36
"22182",2018,0,71,71,142
"22183",2016,0,0,36,36
"22183",2018,0,71,71,142
"22184",2016,0,0,36,36
"22184",2018,0,71,71,142
"22185",2016,0,0,36,36
"22185",2018,0,71,71,142
"22186",2016,0,0,36,36
"22186",2018,0,71,71,142
"22187",2016,0,0,36,36
"22187",2018,0,71,71,142
"22188",2016,0,0,36,36
"22188",2018,0,71,71,142
"22189",2016,0,0,36,36
"22189",2018,0,71,71,142
"22190",2016,0,0,36,36
"22190",2018,0,71,71,142
"22193",2016,0,0,36,36
"22193",2018,0,71,71,142
"22194",2016,0,0,36,36
"22194",2018,0,71,71,142
"22195",2016,0,0,36,36
"22195",2018,0,71,71,142
"22196",2016,0,0,36,36
"22196",2018,0,71,71,142
"22197",2016,0,0,36,36
"22197",2018,0,71,71,142
"22198",2016,0,0,36,36
"22198",2018,0,71,71,142
"22199",2016,0,0,36,36
"22199",2018,0,71,71,142
"22200",2016,0,0,36,36
"22200",2018,0,71,71,142
"22201",2016,0,0,36,36
"22201",2018,0,71,71,142
"22202",2016,0,0,36,36
"22202",2018,0,71,71,142
"22203",2016,0,0,36,36
"22203",2018,0,71,71,142
"22204",2016,0,0,36,36
"22204",2018,0,71,71,142
"22205",2016,0,0,36,36
"22205",2018,0,71,71,142
"22206",2016,0,0,36,36
"22206",2018,0,71,71,142
"22207",2016,0,0,36,36
"22207",2018,0,71,71,142
"22208",2016,0,0,36,36
"22208",2018,0,71,71,142
"22209",2016,0,0,36,36
"22209",2018,0,71,71,142
"22210",2016,0,0,36,36
"22210",2018,0,71,71,142
"22211",2016,0,0,36,36
"22211",2018,0,71,71,142
"22212",2016,0,0,36,36
"22212",2018,0,71,71,142
"22213",2016,0,0,36,36
"22213",2018,0,71,71,142
"22214",2016,0,0,36,36
"22214",2018,0,71,71,142
"22215",2016,0,0,36,36
"22215",2018,0,71,71,142
"22216",2016,0,0,36,36
"22216",2018,0,71,71,142
"22217",2016,0,0,36,36
"22217",2018,0,71,71,142
"22218",2016,0,0,36,36
"22218",2018,0,71,71,142
"22219",2016,0,0,36,36
"22219",2018,0,71,71,142
"22220",2016,0,0,36,36
"22220",2018,0,71,71,142
"22221",2016,0,0,36,36
"22221",2018,0,71,71,142
"22222",2016,0,0,36,36
"22222",2018,0,71,71,142
"22223",2016,0,0,36,36
"22223",2018,0,71,71,142
"22224",2016,0,0,36,36
"22224",2018,0,71,71,142
"22225",2016,0,0,36,36
"22225",2018,0,71,71,142
"22226",2016,0,0,36,36
"22226",2018,0,71,71,142
"22227",2016,0,0,36,36
"22227",2018,0,71,71,142
"22228",2016,0,0,36,36
"22228",2018,0,71,71,142
"22229",2016,0,0,36,36
"22229",2018,0,71,71,142
"22231",2016,0,0,36,36
"22231",2018,0,71,71,142
"22232",2016,0,0,36,36
"22232",2018,0,71,71,142
"22233",2016,0,0,36,36
"22233",2018,0,71,71,142
"22234",2016,0,0,36,36
"22234",2018,0,71,71,142
"22235",2016,0,0,36,36
"22235",2018,0,71,71,142
"22236",2016,0,0,36,36
"22236",2018,0,71,71,142
"22237",2016,0,0,36,36
"22237",2018,0,71,71,142
"22238",2016,0,0,36,36
"22238",2018,0,71,71,142
"22239",2016,0,0,36,36
"22239",2018,0,71,71,142
"22240",2016,0,0,36,36
"22240",2018,0,71,71,142
"22241",2016,0,0,36,36
"22241",2018,0,71,71,142
"22242",2016,0,0,36,36
"22242",2018,0,71,71,142
"22243",2016,0,0,36,36
"22243",2018,0,71,71,142
"22244",2016,0,0,36,36
"22244",2018,0,71,71,142
"22245",2016,0,0,36,36
"22245",2018,0,71,71,142
"22246",2016,0,0,36,36
"22246",2018,0,71,71,142
"22248",2016,0,0,36,36
"22248",2018,0,71,71,142
"22249",2016,0,0,36,36
"22249",2018,0,71,71,142
"22250",2016,0,0,36,36
"22250",2018,0,71,71,142
"22251",2016,0,0,36,36
"22251",2018,0,71,71,142
"22254",2016,0,0,36,36
"22254",2018,0,71,71,142
"22255",2016,0,0,36,36
"22255",2018,0,71,71,142
"22256",2016,0,0,36,36
"22256",2018,0,71,71,142
"22257",2016,0,0,36,36
"22257",2018,0,71,71,142
"22258",2016,0,0,36,36
"22258",2018,0,71,71,142
"22259",2016,0,0,36,36
"22259",2018,0,71,71,142
"22260",2016,0,0,36,36
"22260",2018,0,71,71,142
"22261",2016,0,0,36,36
"22261",2018,0,71,71,142
"22262",2016,0,0,36,36
"22262",2018,0,71,71,142
"22263",2016,0,0,36,36
"22263",2018,0,71,71,142
"22264",2016,0,0,36,36
"22264",2018,0,71,71,142
"22265",2016,0,0,36,36
"22265",2018,0,71,71,142
"22266",2016,0,0,36,36
"22266",2018,0,71,71,142
"22267",2016,0,0,36,36
"22267",2018,0,71,71,142
"22268",2016,0,0,36,36
"22268",2018,0,71,71,142
"22269",2016,0,0,36,36
"22269",2018,0,71,71,142
"22271",2016,0,0,36,36
"22271",2018,0,71,71,142
"22272",2016,0,0,36,36
"22272",2018,0,71,71,142
"22273",2016,0,0,36,36
"22273",2018,0,71,71,142
"22274",2016,0,0,36,36
"22274",2018,0,71,71,142
"22275",2016,0,0,36,36
"22275",2018,0,71,71,142
"22276",2016,0,0,36,36
"22276",2018,0,71,71,142
"22277",2016,0,0,36,36
"22277",2018,0,71,71,142
"22278",2016,0,0,36,36
"22278",2018,0,71,71,142
"22279",2016,0,0,36,36
"22279",2018,0,71,71,142
"22280",2016,0,0,36,36
"22280",2018,0,71,71,142
"22281",2016,0,0,36,36
"22281",2018,0,71,71,142
"22282",2016,0,0,36,36
"22282",2018,0,71,71,142
"22283",2016,0,0,36,36
"22283",2018,0,71,71,142
"22284",2016,0,0,36,36
"22284",2018,0,71,71,142
"22285",2016,0,0,36,36
"22285",2018,0,71,71,142
"22286",2016,0,0,36,36
"22286",2018,0,71,71,142
"22287",2016,0,0,36,36
"22287",2018,0,71,71,142
"22288",2016,0,0,36,36
"22288",2018,0,71,71,142
"22289",2016,0,0,36,36
"22289",2018,0,71,71,142
"22291",2016,0,0,36,36
"22291",2018,0,71,71,142
"22293",2016,0,0,36,36
"22293",2018,0,71,71,142
"22294",2016,0,0,36,36
"22294",2018,0,71,71,142
"22295",2016,0,0,36,36
"22295",2018,0,71,71,142
"22296",2016,0,0,36,36
"22296",2018,0,71,71,142
"22299",2016,0,0,36,36
"22299",2018,0,71,71,142
"22300",2016,0,0,36,36
"22300",2018,0,71,71,142
"22302",2016,0,0,36,36
"22302",2018,0,71,71,142
"22304",2016,0,0,36,36
"22304",2018,0,71,71,142
"22305",2016,0,0,36,36
"22305",2018,0,71,71,142
"22306",2016,0,0,36,36
"22306",2018,0,71,71,142
"22307",2016,0,0,36,36
"22307",2018,0,71,71,142
"22308",2016,0,0,36,36
"22308",2018,0,71,71,142
"22309",2016,0,0,36,36
"22309",2018,0,71,71,142
"22310",2016,0,0,36,36
"22310",2018,0,71,71,142
"22311",2016,0,0,36,36
"22311",2018,0,71,71,142
"22312",2016,0,0,36,36
"22312",2018,0,71,71,142
"22313",2016,0,0,36,36
"22313",2018,0,71,71,142
"22314",2016,0,0,36,36
"22314",2018,0,71,71,142
"22315",2016,0,0,36,36
"22315",2018,0,71,71,142
"22316",2016,0,0,36,36
"22316",2018,0,71,71,142
"22317",2016,0,0,36,36
"22317",2018,0,71,71,142
"22318",2016,0,0,36,36
"22318",2018,0,71,71,142
"22319",2016,0,0,36,36
"22319",2018,0,71,71,142
"22320",2016,0,0,36,36
"22320",2018,0,71,71,142
"22321",2016,0,0,36,36
"22321",2018,0,71,71,142
"22322",2016,0,0,36,36
"22322",2018,0,71,71,142
"22323",2016,0,0,36,36
"22323",2018,0,71,71,142
"22324",2016,0,0,36,36
"22324",2018,0,71,71,142
"22325",2016,0,0,36,36
"22325",2018,0,71,71,142
"22326",2016,0,0,36,36
"22326",2018,0,71,71,142
"22327",2016,0,0,36,36
"22327",2018,0,71,71,142
"22328",2016,0,0,36,36
"22328",2018,0,71,71,142
"22330",2016,0,0,36,36
"22330",2018,0,71,71,142
"22331",2016,0,0,36,36
"22331",2018,0,71,71,142
"22332",2016,0,0,36,36
"22332",2018,0,71,71,142
"22333",2016,0,0,36,36
"22333",2018,0,71,71,142
"22334",2016,0,0,36,36
"22334",2018,0,71,71,142
"22335",2016,0,0,36,36
"22335",2018,0,71,71,142
"22337",2016,0,0,36,36
"22337",2018,0,71,71,142
"22338",2016,0,0,36,36
"22338",2018,0,71,71,142
"22339",2016,0,0,36,36
"22339",2018,0,71,71,142
"22340",2016,0,0,36,36
"22340",2018,0,71,71,142
"22341",2016,0,0,36,36
"22341",2018,0,71,71,142
"22342",2016,0,0,36,36
"22342",2018,0,71,71,142
"22343",2016,0,0,36,36
"22343",2018,0,71,71,142
"22344",2016,0,0,36,36
"22344",2018,0,71,71,142
"22345",2016,0,0,36,36
"22345",2018,0,71,71,142
"22346",2016,0,0,36,36
"22346",2018,0,71,71,142
"22347",2016,0,0,36,36
"22347",2018,0,71,71,142
"22348",2016,0,0,36,36
"22348",2018,0,71,71,142
"22349",2016,0,0,36,36
"22349",2018,0,71,71,142
"22350",2016,0,0,36,36
"22350",2018,0,71,71,142
"22351",2016,0,0,36,36
"22351",2018,0,71,71,142
"22352",2016,0,0,36,36
"22352",2018,0,71,71,142
"22353",2016,0,0,36,36
"22353",2018,0,71,71,142
"22354",2016,0,0,36,36
"22354",2018,0,71,71,142
"22356",2016,0,0,36,36
"22356",2018,0,71,71,142
"22358",2016,0,0,36,36
"22358",2018,0,71,71,142
"22359",2016,0,0,36,36
"22359",2018,0,71,71,142
"22360",2016,0,0,36,36
"22360",2018,0,71,71,142
"22361",2016,0,0,36,36
"22361",2018,0,71,71,142
"22362",2016,0,0,36,36
"22362",2018,0,71,71,142
"22363",2016,0,0,36,36
"22363",2018,0,71,71,142
"22364",2016,0,0,36,36
"22364",2018,0,71,71,142
"22365",2016,0,0,36,36
"22365",2018,0,71,71,142
"22366",2016,0,0,36,36
"22366",2018,0,71,71,142
"22368",2016,0,0,36,36
"22368",2018,0,71,71,142
"22369",2016,0,0,36,36
"22369",2018,0,71,71,142
"22370",2016,0,0,36,36
"22370",2018,0,71,71,142
"22371",2016,0,0,36,36
"22371",2018,0,71,71,142
"22372",2016,0,0,36,36
"22372",2018,0,71,71,142
"22373",2016,0,0,36,36
"22373",2018,0,71,71,142
"22375",2016,0,0,36,36
"22375",2018,0,71,71,142
"22376",2016,0,0,36,36
"22376",2018,0,71,71,142
"22377",2016,0,0,36,36
"22377",2018,0,71,71,142
"22378",2016,0,0,36,36
"22378",2018,0,71,71,142
"22379",2016,0,0,36,36
"22379",2018,0,71,71,142
"22380",2016,0,0,36,36
"22380",2018,0,71,71,142
"22381",2016,0,0,36,36
"22381",2018,0,71,71,142
"22383",2016,0,0,36,36
"22383",2018,0,71,71,142
"22384",2016,0,0,36,36
"22384",2018,0,71,71,142
"22385",2016,0,0,36,36
"22385",2018,0,71,71,142
"22386",2016,0,0,36,36
"22386",2018,0,71,71,142
"22387",2016,0,0,36,36
"22387",2018,0,71,71,142
"22388",2016,0,0,36,36
"22388",2018,0,71,71,142
"22389",2016,0,0,36,36
"22389",2018,0,71,71,142
"22390",2016,0,0,36,36
"22390",2018,0,71,71,142
"22391",2016,0,0,36,36
"22391",2018,0,71,71,142
"23001",2019,0,44,44,88
"23001",2020,0,56,31,87
"23002",2019,0,44,44,88
"23002",2020,0,56,31,87
"23003",2019,0,44,44,88
"23003",2020,0,56,31,87
"23004",2019,0,44,44,88
"23004",2020,0,56,31,87
"23005",2019,0,44,44,88
"23005",2020,0,56,31,87
"23006",2019,0,44,44,88
"23006",2020,0,56,31,87
"23007",2019,0,44,44,88
"23007",2020,0,56,31,87
"23008",2019,0,44,44,88
"23008",2020,0,56,31,87
"23009",2019,0,44,44,88
"23009",2020,0,56,31,87
"23010",2019,0,44,44,88
"23010",2020,0,56,31,87
"23011",2019,0,44,44,88
"23011",2020,0,56,31,87
"23012",2019,0,44,44,88
"23012",2020,0,56,31,87
"23013",2019,0,44,44,88
"23013",2020,0,56,31,87
"23014",2019,0,44,44,88
"23014",2020,0,56,31,87
"23015",2019,0,44,44,88
"23015",2020,0,56,31,87
"23016",2019,0,44,44,88
"23016",2020,0,56,31,87
"23017",2019,0,44,44,88
"23017",2020,0,56,31,87
"23018",2019,0,44,44,88
"23018",2020,0,56,31,87
"23019",2019,0,44,44,88
"23019",2020,0,56,31,87
"23020",2019,0,44,44,88
"23020",2020,0,56,31,87
"23021",2019,0,44,44,88
"23021",2020,0,56,31,87
"23022",2019,0,44,44,88
"23022",2020,0,56,31,87
"23023",2019,0,44,44,88
"23023",2020,0,56,31,87
"23024",2019,0,44,44,88
"23024",2020,0,56,31,87
"23025",2019,0,44,44,88
"23025",2020,0,56,31,87
"23026",2019,0,44,44,88
"23026",2020,0,56,31,87
"23027",2019,0,44,44,88
"23027",2020,0,56,31,87
"23028",2019,0,44,44,88
"23028",2020,0,56,31,87
"23029",2019,0,44,44,88
"23029",2020,0,56,31,87
"23030",2019,0,44,44,88
"23030",2020,0,56,31,87
"23031",2019,0,44,44,88
"23031",2020,0,56,31,87
"23032",2019,0,44,44,88
"23032",2020,0,56,31,87
"23033",2019,0,44,44,88
"23033",2020,0,56,31,87
"23034",2019,0,44,44,88
"23034",2020,0,56,31,87
"23035",2019,0,44,44,88
"23035",2020,0,56,31,87
"23036",2019,0,44,44,88
"23036",2020,0,56,31,87
"23037",2019,0,44,44,88
"23037",2020,0,56,31,87
"23038",2019,0,44,44,88
"23038",2020,0,56,31,87
"23039",2019,0,44,44,88
"23039",2020,0,56,31,87
"23040",2019,0,44,44,88
"23040",2020,0,56,31,87
"23041",2019,0,44,44,88
"23041",2020,0,56,31,87
"23042",2019,0,44,44,88
"23042",2020,0,56,31,87
"23043",2019,0,44,44,88
"23043",2020,0,56,31,87
"23044",2019,0,44,44,88
"23044",2020,0,56,31,87
"23045",2019,0,44,44,88
"23045",2020,0,56,31,87
"23046",2019,0,44,44,88
"23046",2020,0,56,31,87
"23047",2019,0,44,44,88
"23047",2020,0,56,31,87
"23048",2019,0,44,44,88
"23048",2020,0,56,31,87
"23049",2019,0,44,44,88
"23049",2020,0,56,31,87
"23050",2019,0,44,44,88
"23050",2020,0,56,31,87
"23051",2019,0,44,44,88
"23051",2020,0,56,31,87
"23052",2019,0,44,44,88
"23052",2020,0,56,31,87
"23053",2019,0,44,44,88
"23053",2020,0,56,31,87
"23054",2019,0,44,44,88
"23054",2020,0,56,31,87
"23055",2019,0,44,44,88
"23055",2020,0,56,31,87
"23056",2019,0,44,44,88
"23056",2020,0,56,31,87
"23057",2019,0,44,44,88
"23057",2020,0,56,31,87
"23058",2019,0,44,44,88
"23058",2020,0,56,31,87
"23059",2019,0,44,44,88
"23059",2020,0,56,31,87
"23060",2019,0,44,44,88
"23060",2020,0,56,31,87
"23061",2019,0,44,44,88
"23061",2020,0,56,31,87
"23062",2019,0,44,44,88
"23062",2020,0,56,31,87
"23063",2019,0,44,44,88
"23063",2020,0,56,31,87
"23064",2019,0,44,44,88
"23064",2020,0,56,31,87
"23065",2019,0,44,44,88
"23065",2020,0,56,31,87
"23066",2019,0,44,44,88
"23066",2020,0,56,31,87
"23067",2019,0,44,44,88
"23067",2020,0,56,31,87
"23068",2019,0,44,44,88
"23068",2020,0,56,31,87
"23069",2019,0,44,44,88
"23069",2020,0,56,31,87
"23070",2019,0,44,44,88
"23070",2020,0,56,31,87
"23071",2019,0,44,44,88
"23071",2020,0,56,31,87
"23072",2019,0,44,44,88
"23072",2020,0,56,31,87
"23073",2019,0,44,44,88
"23073",2020,0,56,31,87
"23074",2019,0,44,44,88
"23074",2020,0,56,31,87
"23075",2019,0,44,44,88
"23075",2020,0,56,31,87
"23076",2019,0,44,44,88
"23076",2020,0,56,31,87
"23077",2019,0,44,44,88
"23077",2020,0,56,31,87
"23078",2019,0,44,44,88
"23078",2020,0,56,31,87
"23079",2019,0,44,44,88
"23079",2020,0,56,31,87
"23080",2019,0,44,44,88
"23080",2020,0,56,31,87
"23081",2019,0,44,44,88
"23081",2020,0,56,31,87
"23082",2019,0,44,44,88
"23082",2020,0,56,31,87
"23083",2019,0,44,44,88
"23083",2020,0,56,31,87
"23084",2019,0,44,44,88
"23084",2020,0,56,31,87
"23086",2019,0,44,44,88
"23086",2020,0,56,31,87
"23087",2019,0,44,44,88
"23087",2020,0,56,31,87
"23088",2019,0,44,44,88
"23088",2020,0,56,31,87
"23089",2019,0,44,44,88
"23089",2020,0,56,31,87
"23090",2019,0,44,44,88
"23090",2020,0,56,31,87
"23091",2019,0,44,44,88
"23091",2020,0,56,31,87
"23092",2019,0,44,44,88
"23092",2020,0,56,31,87
"23093",2019,0,44,44,88
"23093",2020,0,56,31,87
"23095",2019,0,44,44,88
"23095",2020,0,56,31,87
"23096",2019,0,44,44,88
"23096",2020,0,56,31,87
"23097",2019,0,44,44,88
"23097",2020,0,56,31,87
"23098",2019,0,44,44,88
"23098",2020,0,56,31,87
"23099",2019,0,44,44,88
"23099",2020,0,56,31,87
"23100",2019,0,44,44,88
"23100",2020,0,56,31,87
"23101",2019,0,44,44,88
"23101",2020,0,56,31,87
"23102",2019,0,44,44,88
"23102",2020,0,56,31,87
"23103",2019,0,44,44,88
"23103",2020,0,56,31,87
"23104",2019,0,44,44,88
"23104",2020,0,56,31,87
"23105",2019,0,44,44,88
"23105",2020,0,56,31,87
"23106",2019,0,44,44,88
"23106",2020,0,56,31,87
"23107",2019,0,44,44,88
"23107",2020,0,56,31,87
"23108",2019,0,44,44,88
"23108",2020,0,56,31,87
"23109",2019,0,44,44,88
"23109",2020,0,56,31,87
"23110",2019,0,44,44,88
"23110",2020,0,56,31,87
"23111",2019,0,44,44,88
"23111",2020,0,56,31,87
"23112",2019,0,44,44,88
"23112",2020,0,56,31,87
"23113",2019,0,44,44,88
"23113",2020,0,56,31,87
"23114",2019,0,44,44,88
"23114",2020,0,56,31,87
"23115",2019,0,44,44,88
"23115",2020,0,56,31,87
"23116",2019,0,44,44,88
"23116",2020,0,56,31,87
"23117",2019,0,44,44,88
"23117",2020,0,56,31,87
"23118",2019,0,44,44,88
"23118",2020,0,56,31,87
"23119",2019,0,44,44,88
"23119",2020,0,56,31,87
"23120",2019,0,44,44,88
"23120",2020,0,56,31,87
"23122",2019,0,44,44,88
"23122",2020,0,56,31,87
"23123",2019,0,44,44,88
"23123",2020,0,56,31,87
"23124",2019,0,44,44,88
"23124",2020,0,56,31,87
"23125",2019,0,44,44,88
"23125",2020,0,56,31,87
"23127",2019,0,44,44,88
"23127",2020,0,56,31,87
"23128",2019,0,44,44,88
"23128",2020,0,56,31,87
"23129",2019,0,44,44,88
"23129",2020,0,56,31,87
"23130",2019,0,44,44,88
"23130",2020,0,56,31,87
"23131",2019,0,44,44,88
"23131",2020,0,56,31,87
"23132",2019,0,44,44,88
"23132",2020,0,56,31,87
"23133",2019,0,44,44,88
"23133",2020,0,56,31,87
"23134",2019,0,44,44,88
"23134",2020,0,56,31,87
"23136",2019,0,44,44,88
"23136",2020,0,56,31,87
"23137",2019,0,44,44,88
"23137",2020,0,56,31,87
"23138",2019,0,44,44,88
"23138",2020,0,56,31,87
"23139",2019,0,44,44,88
"23139",2020,0,56,31,87
"23140",2019,0,44,44,88
"23140",2020,0,56,31,87
"23141",2019,0,44,44,88
"23141",2020,0,56,31,87
"23142",2019,0,44,44,88
"23142",2020,0,56,31,87
"23143",2019,0,44,44,88
"23143",2020,0,56,31,87
"23144",2019,0,44,44,88
"23144",2020,0,56,31,87
"23145",2019,0,44,44,88
"23145",2020,0,56,31,87
"23146",2019,0,44,44,88
"23146",2020,0,56,31,87
"23147",2019,0,44,44,88
"23147",2020,0,56,31,87
"23148",2019,0,44,44,88
"23148",2020,0,56,31,87
"23149",2019,0,44,44,88
"23149",2020,0,56,31,87
"23150",2019,0,44,44,88
"23150",2020,0,56,31,87
"23151",2019,0,44,44,88
"23151",2020,0,56,31,87
"23152",2019,0,44,44,88
"23152",2020,0,56,31,87
"23154",2019,0,44,44,88
"23154",2020,0,56,31,87
"23155",2019,0,44,44,88
"23155",2020,0,56,31,87
"23156",2019,0,44,44,88
"23156",2020,0,56,31,87
"23157",2019,0,44,44,88
"23157",2020,0,56,31,87
"23158",2019,0,44,44,88
"23158",2020,0,56,31,87
"23159",2019,0,44,44,88
"23159",2020,0,56,31,87
"23160",2019,0,44,44,88
"23160",2020,0,56,31,87
"23162",2019,0,44,44,88
"23162",2020,0,56,31,87
"23164",2019,0,44,44,88
"23164",2020,0,56,31,87
"23165",2019,0,44,44,88
"23165",2020,0,56,31,87
"23166",2019,0,44,44,88
"23166",2020,0,56,31,87
"23167",2019,0,44,44,88
"23167",2020,0,56,31,87
"23168",2019,0,44,44,88
"23168",2020,0,56,31,87
"23169",2019,0,44,44,88
"23169",2020,0,56,31,87
"23170",2019,0,44,44,88
"23170",2020,0,56,31,87
"23171",2019,0,44,44,88
"23171",2020,0,56,31,87
"23172",2019,0,44,44,88
"23172",2020,0,56,31,87
"23173",2019,0,44,44,88
"23173",2020,0,56,31,87
"23174",2019,0,44,44,88
"23174",2020,0,56,31,87
"23175",2019,0,44,44,88
"23175",2020,0,56,31,87
"23176",2019,0,44,44,88
"23176",2020,0,56,31,87
"23177",2019,0,44,44,88
"23177",2020,0,56,31,87
"23178",2019,0,44,44,88
"23178",2020,0,56,31,87
"23179",2019,0,44,44,88
"23179",2020,0,56,31,87
"23180",2019,0,44,44,88
"23180",2020,0,56,31,87
"23181",2019,0,44,44,88
"23181",2020,0,56,31,87
"23182",2019,0,44,44,88
"23182",2020,0,56,31,87
"23183",2019,0,44,44,88
"23183",2020,0,56,31,87
"23184",2019,0,44,44,88
"23184",2020,0,56,31,87
"23185",2019,0,44,44,88
"23185",2020,0,56,31,87
"23186",2019,0,44,44,88
"23186",2020,0,56,31,87
"23187",2019,0,44,44,88
"23187",2020,0,56,31,87
"23188",2019,0,44,44,88
"23188",2020,0,56,31,87
"23189",2019,0,44,44,88
"23189",2020,0,56,31,87
"23190",2019,0,44,44,88
"23190",2020,0,56,31,87
"23191",2019,0,44,44,88
"23191",2020,0,56,31,87
"23192",2019,0,44,44,88
"23192",2020,0,56,31,87
"23193",2019,0,44,44,88
"23193",2020,0,56,31,87
"23194",2019,0,44,44,88
"23194",2020,0,56,31,87
"23195",2019,0,44,44,88
"23195",2020,0,56,31,87
"23196",2019,0,44,44,88
"23196",2020,0,56,31,87
"23197",2019,0,44,44,88
"23197",2020,0,56,31,87
"23198",2019,0,44,44,88
"23198",2020,0,56,31,87
"23199",2019,0,44,44,88
"23199",2020,0,56,31,87
"23200",2019,0,44,44,88
"23200",2020,0,56,31,87
"23201",2019,0,44,44,88
"23201",2020,0,56,31,87
"23202",2019,0,44,44,88
"23202",2020,0,56,31,87
"23203",2019,0,44,44,88
"23203",2020,0,56,31,87
"23204",2019,0,44,44,88
"23204",2020,0,56,31,87
"23205",2019,0,44,44,88
"23205",2020,0,56,31,87
"23206",2019,0,44,44,88
"23206",2020,0,56,31,87
"23207",2019,0,44,44,88
"23207",2020,0,56,31,87
"23208",2019,0,44,44,88
"23208",2020,0,56,31,87
"23209",2019,0,44,44,88
"23209",2020,0,56,31,87
"23210",2019,0,44,44,88
"23210",2020,0,56,31,87
"23211",2019,0,44,44,88
"23211",2020,0,56,31,87
"23212",2019,0,44,44,88
"23212",2020,0,56,31,87
"23213",2019,0,44,44,88
"23213",2020,0,56,31,87
"23214",2019,0,44,44,88
"23214",2020,0,56,31,87
"23215",2019,0,44,44,88
"23215",2020,0,56,31,87
"23216",2019,0,44,44,88
"23216",2020,0,56,31,87
"23217",2019,0,44,44,88
"23217",2020,0,56,31,87
"23218",2019,0,44,44,88
"23218",2020,0,56,31,87
"23219",2019,0,44,44,88
"23219",2020,0,56,31,87
"23220",2019,0,44,44,88
"23220",2020,0,56,31,87
"23221",2019,0,44,44,88
"23221",2020,0,56,31,87
"23222",2019,0,44,44,88
"23222",2020,0,56,31,87
"23223",2019,0,44,44,88
"23223",2020,0,56,31,87
"23224",2019,0,44,44,88
"23224",2020,0,56,31,87
"23225",2019,0,44,44,88
"23225",2020,0,56,31,87
"23226",2019,0,44,44,88
"23226",2020,0,56,31,87
"23227",2019,0,44,44,88
"23227",2020,0,56,31,87
"23228",2019,0,44,44,88
"23228",2020,0,56,31,87
"23229",2019,0,44,44,88
"23229",2020,0,56,31,87
"23230",2019,0,44,44,88
"23230",2020,0,56,31,87
"23232",2019,0,44,44,88
"23232",2020,0,56,31,87
"23233",2019,0,44,44,88
"23233",2020,0,56,31,87
"23234",2019,0,44,44,88
"23234",2020,0,56,31,87
"23235",2019,0,44,44,88
"23235",2020,0,56,31,87
"23236",2019,0,44,44,88
"23236",2020,0,56,31,87
"23237",2019,0,44,44,88
"23237",2020,0,56,31,87
"23238",2019,0,44,44,88
"23238",2020,0,56,31,87
"23239",2019,0,44,44,88
"23239",2020,0,56,31,87
"23240",2019,0,44,44,88
"23240",2020,0,56,31,87
"23241",2019,0,44,44,88
"23241",2020,0,56,31,87
"23242",2019,0,44,44,88
"23242",2020,0,56,31,87
"23243",2019,0,44,44,88
"23243",2020,0,56,31,87
"23244",2019,0,44,44,88
"23244",2020,0,56,31,87
"23245",2019,0,44,44,88
"23245",2020,0,56,31,87
"23246",2019,0,44,44,88
"23246",2020,0,56,31,87
"23247",2019,0,44,44,88
"23247",2020,0,56,31,87
"23248",2019,0,44,44,88
"23248",2020,0,56,31,87
"23249",2019,0,44,44,88
"23249",2020,0,56,31,87
"23250",2019,0,44,44,88
"23250",2020,0,56,31,87
"23251",2019,0,44,44,88
"23251",2020,0,56,31,87
"23252",2019,0,44,44,88
"23252",2020,0,56,31,87
"23253",2019,0,44,44,88
"23253",2020,0,56,31,87
"23254",2019,0,44,44,88
"23254",2020,0,56,31,87
"23255",2019,0,44,44,88
"23255",2020,0,56,31,87
"23257",2019,0,44,44,88
"23257",2020,0,56,31,87
"23258",2019,0,44,44,88
"23258",2020,0,56,31,87
"23259",2019,0,44,44,88
"23259",2020,0,56,31,87
"23260",2019,0,44,44,88
"23260",2020,0,56,31,87
"23261",2019,0,44,44,88
"23261",2020,0,56,31,87
"23262",2019,0,44,44,88
"23262",2020,0,56,31,87
"23263",2019,0,44,44,88
"23263",2020,0,56,31,87
"23264",2019,0,44,44,88
"23264",2020,0,56,31,87
"23265",2019,0,44,44,88
"23265",2020,0,56,31,87
"23266",2019,0,44,44,88
"23266",2020,0,56,31,87
"24005",2020,0,0,7,7
"24008",2019,0,0,7,7
"24008",2020,0,0,7,7
"24009",2019,0,0,7,7
"24009",2020,0,0,7,7
"24010",2020,0,0,17,17
"24011",2019,0,0,7,7
"24011",2020,0,0,7,7
"24014",2020,0,0,7,7
"24015",2020,0,0,7,7
"24018",2020,0,0,7,7
"24020",2020,0,0,7,7
"24021",2020,0,0,7,7
"24022",2015,0,0,7,7
"24022",2020,0,0,17,17
"24023",2015,0,0,7,7
"24023",2020,0,0,17,17
"24030",2020,0,0,7,7
"24032",2020,0,0,17,17
"24067",2020,0,0,7,7
"24069",2020,0,0,24,24
"24073",2015,0,0,7,7
"24073",2020,0,0,17,17
"24074",2020,0,0,7,7
"24076",2020,0,0,7,7
"24081",2020,0,0,7,7
"24082",2020,0,0,7,7
"24095",2019,0,0,7,7
"24095",2020,0,0,7,7
"24096",2020,0,0,24,24
"24097",2020,0,0,12,12
"24104",2020,0,0,17,17
"24106",2020,0,0,7,7
"24107",2020,0,0,24,24
"24110",2020,0,0,12,12
"24113",2020,0,0,7,7
"24116",2020,0,0,7,7
"24117",2020,0,0,7,7
"24120",2019,0,0,7,7
"24120",2020,0,0,7,7
"24124",2019,0,0,7,7
"24124",2020,0,0,7,7
"24129",2020,0,0,24,24
"24130",2020,0,0,7,7
"24133",2019,0,0,7,7
"24133",2020,0,0,7,7
"24134",2019,0,0,7,7
"24134",2020,0,0,7,7
"24136",2020,0,0,7,7
"24137",2019,0,0,7,7
"24137",2020,0,0,7,7
"24138",2020,0,0,17,17
"24142",2020,0,0,7,7
"24157",2020,0,0,17,17
"24158",2019,0,0,7,7
"24158",2020,0,0,7,7
"24159",2020,0,0,17,17
"24162",2019,0,0,7,7
"24162",2020,0,0,7,7
"24164",2019,0,0,7,7
"24164",2020,0,0,7,7
"24165",2020,0,0,17,17
"24171",2019,0,0,7,7
"24171",2020,0,0,7,7
"24172",2020,0,0,7,7
"24174",2020,0,0,7,7
"24175",2020,0,0,7,7
"24179",2020,0,0,7,7
"24180",2019,0,0,7,7
"24180",2020,0,0,7,7
"24183",2020,0,0,7,7
"24199",2020,0,0,12,12
"24207",2015,0,0,7,7
"24216",2020,0,0,17,17
"24218",2019,0,0,7,7
"24218",2020,0,0,7,7
"24222",2015,0,0,7,7
"24223",2015,0,0,7,7
"24223",2020,0,0,17,17
"24227",2019,0,0,7,7
"24227",2020,0,0,7,7
"24229",2020,0,0,7,7
"24236",2020,0,0,17,17
"24240",2020,0,0,7,7
"24246",2015,0,0,7,7
"24261",2020,0,0,7,7
"24262",2019,0,0,7,7
"24262",2020,0,0,7,7
"24264",2020,0,0,17,17
"24266",2020,0,0,24,24
"24268",2020,0,0,7,7
"24271",2020,0,0,24,24
"24291",2020,0,0,7,7
"24297",2020,0,0,17,17
"24304",2019,0,0,7,7
"24304",2020,0,0,7,7
"24305",2019,0,0,7,7
"24305",2020,0,0,7,7
"24318",2020,0,0,7,7
"24320",2019,0,0,7,7
"24320",2020,0,0,7,7
"24321",2020,0,0,7,7
"24324",2020,0,0,7,7
"24326",2020,0,0,7,7
"24329",2020,0,0,17,17
"24330",2020,0,0,7,7
"24336",2020,0,0,7,7
"24339",2019,0,0,7,7
"24339",2020,0,0,7,7
"24349",2015,0,0,7,7
"24349",2020,0,0,17,17
"24350",2020,0,0,17,17
"24353",2020,0,0,12,12
"24354",2020,0,0,17,17
"24355",2015,0,0,7,7
"24361",2015,0,0,7,7
"24361",2020,0,0,17,17
"24364",2020,0,0,7,7
"24367",2020,0,0,17,17
"24371",2020,0,0,17,17
"24372",2020,0,0,17,17
"24376",2020,0,0,17,17
"24380",2020,0,0,17,17
"24382",2015,0,0,7,7
"24382",2020,0,0,17,17
"24388",2020,0,0,7,7
"24394",2020,0,0,12,12
"24396",2020,0,0,7,7
"24399",2020,0,0,17,17
"24401",2019,0,0,7,7
"24401",2020,0,0,7,7
"24409",2020,0,0,17,17
"24417",2019,0,0,7,7
"24417",2020,0,0,7,7
"24418",2020,0,0,17,17
"24424",2020,0,0,17,17
"24425",2020,0,0,24,24
"24428",2020,0,0,24,24
"24429",2019,0,0,7,7
"24429",2020,0,0,7,7
"24432",2015,0,0,7,7
"24437",2015,0,0,7,7
"24437",2020,0,0,17,17
"24443",2020,0,0,7,7
"24444",2020,0,0,17,17
"24448",2019,0,0,7,7
"24448",2020,0,0,7,7
"24453",2020,0,0,24,24
"24455",2020,0,0,17,17
"24463",2019,0,0,7,7
"24463",2020,0,0,7,7
"24465",2020,0,0,17,17
"24470",2015,0,0,7,7
"24471",2020,0,0,7,7
"24476",2019,0,0,7,7
"24476",2020,0,0,7,7
"24481",2019,0,0,7,7
"24481",2020,0,0,7,7
"24484",2020,0,0,17,17
"24485",2020,0,0,24,24
"24486",2019,0,0,7,7
"24486",2020,0,0,7,7
"24487",2015,0,0,7,7
"24489",2019,0,0,7,7
"24489",2020,0,0,7,7
"24493",2019,0,0,7,7
"24493",2020,0,0,7,7
"24496",2020,0,0,24,24
"24504",2020,0,0,17,17
"24505",2019,0,0,7,7
"24505",2020,0,0,7,7
"24509",2020,0,0,17,17
"24510",2015,0,0,7,7
"24512",2020,0,0,7,7
"24513",2019,0,0,7,7
"24513",2020,0,0,7,7
"24519",2019,0,0,7,7
"24519",2020,0,0,7,7
"24521",2019,0,0,7,7
"24521",2020,0,0,7,7
"24522",2019,0,0,7,7
"24522",2020,0,0,7,7
"24524",2020,0,0,7,7
"24526",2019,0,0,7,7
"24526",2020,0,0,7,7
"24527",2019,0,0,7,7
"24527",2020,0,0,7,7
"24529",2020,0,0,17,17
"24531",2020,0,0,7,7
"24533",2020,0,0,17,17
"24535",2020,0,0,7,7
"24537",2020,0,0,17,17
"24544",2020,0,0,7,7
"24545",2020,0,0,7,7
"24547",2020,0,0,7,7
"24551",2019,0,0,7,7
"24551",2020,0,0,7,7
"24552",2020,0,0,7,7
"24553",2020,0,0,24,24
"24555",2019,0,0,7,7
"24555",2020,0,0,7,7
"24557",2019,0,0,7,7
"24557",2020,0,0,7,7
"24558",2015,0,0,7,7
"24558",2020,0,0,17,17
"24559",2020,0,0,7,7
"24563",2020,0,0,7,7
"24574",2015,0,0,7,7
"24580",2020,0,0,7,7
"24582",2020,0,0,24,24
"24587",2020,0,0,7,7
"25001",2014,0,25,0,25
"25002",2014,0,25,0,25
"25003",2014,0,25,0,25
"25004",2014,0,25,0,25
"25005",2014,0,25,0,25
"25006",2014,0,25,0,25
"25007",2014,0,25,0,25
"25008",2014,0,25,0,25
"25009",2014,0,25,0,25
"25011",2014,0,25,0,25
"25012",2014,0,25,0,25
"25013",2014,0,25,0,25
"25014",2014,0,25,0,25
"25015",2014,0,25,0,25
"25016",2014,0,25,0,25
"25017",2014,0,25,0,25
"25018",2014,0,25,0,25
"25019",2014,0,25,0,25
"25020",2014,0,25,0,25
"25021",2014,0,25,0,25
"25022",2014,0,25,0,25
"25024",2014,0,25,0,25
"25025",2014,0,25,0,25
"25026",2014,0,25,0,25
"25029",2014,0,25,0,25
"25030",2014,0,25,0,25
"25031",2014,0,25,0,25
"25032",2014,0,25,0,25
"25033",2014,0,25,0,25
"25035",2014,0,25,0,25
"25036",2014,0,25,0,25
"25038",2014,0,25,0,25
"25039",2014,0,25,0,25
"25040",2014,0,25,0,25
"25041",2014,0,25,0,25
"25042",2014,0,25,0,25
"25043",2014,0,25,0,25
"25044",2014,0,25,0,25
"25045",2014,0,25,0,25
"25046",2014,0,25,0,25
"25047",2014,0,25,0,25
"25048",2014,0,25,0,25
"25049",2014,0,25,0,25
"25050",2014,0,25,0,25
"25051",2014,0,25,0,25
"25052",2014,0,25,0,25
"25053",2014,0,25,0,25
"25054",2014,0,25,0,25
"25055",2014,0,25,0,25
"25056",2014,0,25,0,25
"25057",2014,0,25,0,25
"25058",2014,0,25,0,25
"25059",2014,0,25,0,25
"25060",2014,0,25,0,25
"25061",2014,0,25,0,25
"25062",2014,0,25,0,25
"25063",2014,0,25,0,25
"25065",2014,0,25,0,25
"25066",2014,0,25,0,25
"25067",2014,0,25,0,25
"25070",2014,0,25,0,25
"25071",2014,0,25,0,25
"25072",2014,0,25,0,25
"25073",2014,0,25,0,25
"25074",2014,0,25,0,25
"25075",2014,0,25,0,25
"25077",2014,0,25,0,25
"25078",2014,0,25,0,25
"25079",2014,0,25,0,25
"25082",2014,0,25,0,25
"25083",2014,0,25,0,25
"25084",2014,0,25,0,25
"25085",2014,0,25,0,25
"25086",2014,0,25,0,25
"25087",2014,0,25,0,25
"25088",2014,0,25,0,25
"25089",2014,0,25,0,25
"25090",2014,0,25,0,25
"25091",2014,0,25,0,25
"25092",2014,0,25,0,25
"25093",2014,0,25,0,25
"25094",2014,0,25,0,25
"25095",2014,0,25,0,25
"25096",2014,0,25,0,25
"25097",2014,0,25,0,25
"25098",2014,0,25,0,25
"25099",2014,0,25,0,25
"25100",2014,0,25,0,25
"25101",2014,0,25,0,25
"25102",2014,0,25,0,25
"25103",2014,0,25,0,25
"25104",2014,0,25,0,25
"25105",2014,0,25,0,25
"25106",2014,0,25,0,25
"25107",2014,0,25,0,25
"25108",2014,0,25,0,25
"25109",2014,0,25,0,25
"25110",2014,0,25,0,25
"25111",2014,0,25,0,25
"25112",2014,0,25,0,25
"25113",2014,0,25,0,25
"25114",2014,0,25,0,25
"25115",2014,0,25,0,25
"25116",2014,0,25,0,25
"25117",2014,0,25,0,25
"25119",2014,0,25,0,25
"25120",2014,0,25,0,25
"25121",2014,0,25,0,25
"25122",2014,0,25,0,25
"25124",2014,0,25,0,25
"25125",2014,0,25,0,25
"25126",2014,0,25,0,25
"25127",2014,0,25,0,25
"25129",2014,0,25,0,25
"25130",2014,0,25,0,25
"25131",2014,0,25,0,25
"25132",2014,0,25,0,25
"25133",2014,0,25,0,25
"25136",2014,0,25,0,25
"25138",2014,0,25,0,25
"25139",2014,0,25,0,25
"25141",2014,0,25,0,25
"25142",2014,0,25,0,25
"25143",2014,0,25,0,25
"25145",2014,0,25,0,25
"25147",2014,0,25,0,25
"25148",2014,0,25,0,25
"25149",2014,0,25,0,25
"25150",2014,0,25,0,25
"25151",2014,0,25,0,25
"25152",2014,0,25,0,25
"25153",2014,0,25,0,25
"25154",2014,0,25,0,25
"25155",2014,0,25,0,25
"25156",2014,0,25,0,25
"25157",2014,0,25,0,25
"25159",2014,0,25,0,25
"25160",2014,0,25,0,25
"25161",2014,0,25,0,25
"25162",2014,0,25,0,25
"25163",2014,0,25,0,25
"25164",2014,0,25,0,25
"25166",2014,0,25,0,25
"25170",2014,0,25,0,25
"25171",2014,0,25,0,25
"25172",2014,0,25,0,25
"25173",2014,0,25,0,25
"25174",2014,0,25,0,25
"25175",2014,0,25,0,25
"25176",2014,0,25,0,25
"25177",2014,0,25,0,25
"25178",2014,0,25,0,25
"25179",2014,0,25,0,25
"25180",2014,0,25,0,25
"25181",2014,0,25,0,25
"25182",2014,0,25,0,25
"25183",2014,0,25,0,25
"25184",2014,0,25,0,25
"25185",2014,0,25,0,25
"25186",2014,0,25,0,25
"25187",2014,0,25,0,25
"25188",2014,0,25,0,25
"25189",2014,0,25,0,25
"25190",2014,0,25,0,25
"25191",2014,0,25,0,25
"25192",2014,0,25,0,25
"25193",2014,0,25,0,25
"25194",2014,0,25,0,25
"25195",2014,0,25,0,25
"25196",2014,0,25,0,25
"25197",2014,0,25,0,25
"25198",2014,0,25,0,25
"25199",2014,0,25,0,25
"25200",2014,0,25,0,25
"25201",2014,0,25,0,25
"25202",2014,0,25,0,25
"25203",2014,0,25,0,25
"25204",2014,0,25,0,25
"25207",2014,0,25,0,25
"25208",2014,0,25,0,25
"25209",2014,0,25,0,25
"25210",2014,0,25,0,25
"25211",2014,0,25,0,25
"25212",2014,0,25,0,25
"25213",2014,0,25,0,25
"25214",2014,0,25,0,25
"25215",2014,0,25,0,25
"25216",2014,0,25,0,25
"25217",2014,0,25,0,25
"25218",2014,0,25,0,25
"25219",2014,0,25,0,25
"25220",2014,0,25,0,25
"25221",2014,0,25,0,25
"25222",2014,0,25,0,25
"25223",2014,0,25,0,25
"25224",2014,0,25,0,25
"25225",2014,0,25,0,25
"25226",2014,0,25,0,25
"25227",2014,0,25,0,25
"25228",2014,0,25,0,25
"25229",2014,0,25,0,25
"25230",2014,0,25,0,25
"25231",2014,0,25,0,25
"25232",2014,0,25,0,25
"25233",2014,0,25,0,25
"25234",2014,0,25,0,25
"25235",2014,0,25,0,25
"25236",2014,0,25,0,25
"25237",2014,0,25,0,25
"25238",2014,0,25,0,25
"25239",2014,0,25,0,25
"25240",2014,0,25,0,25
"25241",2014,0,25,0,25
"25242",2014,0,25,0,25
"25243",2014,0,25,0,25
"25244",2014,0,25,0,25
"25245",2014,0,25,0,25
"25246",2014,0,25,0,25
"25247",2014,0,25,0,25
"25248",2014,0,25,0,25
"25249",2014,0,25,0,25
"25251",2014,0,25,0,25
"25252",2014,0,25,0,25
"25253",2014,0,25,0,25
"25254",2014,0,25,0,25
"25255",2014,0,25,0,25
"25256",2014,0,25,0,25
"25257",2014,0,25,0,25
"25258",2014,0,25,0,25
"25259",2014,0,25,0,25
"25261",2014,0,25,0,25
"25262",2014,0,25,0,25
"25263",2014,0,25,0,25
"25264",2014,0,25,0,25
"25265",2014,0,25,0,25
"25266",2014,0,25,0,25
"25267",2014,0,25,0,25
"25268",2014,0,25,0,25
"25269",2014,0,25,0,25
"25270",2014,0,25,0,25
"25271",2014,0,25,0,25
"25273",2014,0,25,0,25
"25274",2014,0,25,0,25
"25275",2014,0,25,0,25
"25276",2014,0,25,0,25
"25277",2014,0,25,0,25
"25278",2014,0,25,0,25
"25279",2014,0,25,0,25
"25280",2014,0,25,0,25
"25281",2014,0,25,0,25
"25283",2014,0,25,0,25
"25284",2014,0,25,0,25
"25285",2014,0,25,0,25
"25286",2014,0,25,0,25
"25287",2014,0,25,0,25
"25288",2014,0,25,0,25
"25289",2014,0,25,0,25
"25290",2014,0,25,0,25
"25293",2014,0,25,0,25
"25295",2014,0,25,0,25
"25296",2014,0,25,0,25
"25297",2014,0,25,0,25
"25298",2014,0,25,0,25
"25299",2014,0,25,0,25
"25300",2014,0,25,0,25
"25301",2014,0,25,0,25
"25303",2014,0,25,0,25
"25304",2014,0,25,0,25
"25305",2014,0,25,0,25
"25306",2014,0,25,0,25
"25307",2014,0,25,0,25
"25308",2014,0,25,0,25
"25309",2014,0,25,0,25
"25310",2014,0,25,0,25
"25311",2014,0,25,0,25
"25312",2014,0,25,0,25
"25313",2014,0,25,0,25
"25314",2014,0,25,0,25
"25315",2014,0,25,0,25
"25316",2014,0,25,0,25
"25317",2014,0,25,0,25
"25318",2014,0,25,0,25
"25320",2014,0,25,0,25
"25321",2014,0,25,0,25
"25322",2014,0,25,0,25
"25323",2014,0,25,0,25
"25324",2014,0,25,0,25
"25325",2014,0,25,0,25
"25326",2014,0,25,0,25
"25327",2014,0,25,0,25
"25328",2014,0,25,0,25
"25329",2014,0,25,0,25
"25330",2014,0,25,0,25
"25331",2014,0,25,0,25
"25332",2014,0,25,0,25
"25333",2014,0,25,0,25
"25334",2014,0,25,0,25
"25335",2014,0,25,0,25
"25336",2014,0,25,0,25
"25338",2014,0,25,0,25
"25339",2014,0,25,0,25
"25340",2014,0,25,0,25
"25341",2014,0,25,0,25
"25342",2014,0,25,0,25
"25343",2014,0,25,0,25
"25344",2014,0,25,0,25
"25345",2014,0,25,0,25
"25346",2014,0,25,0,25
"25347",2014,0,25,0,25
"25348",2014,0,25,0,25
"25349",2014,0,25,0,25
"25350",2014,0,25,0,25
"25351",2014,0,25,0,25
"25354",2014,0,25,0,25
"25355",2014,0,25,0,25
"25356",2014,0,25,0,25
"25357",2014,0,25,0,25
"25359",2014,0,25,0,25
"25360",2014,0,25,0,25
"25361",2014,0,25,0,25
"25362",2014,0,25,0,25
"25364",2014,0,25,0,25
"25365",2014,0,25,0,25
"25366",2014,0,25,0,25
"25367",2014,0,25,0,25
"25368",2014,0,25,0,25
"25369",2014,0,25,0,25
"25370",2014,0,25,0,25
"25371",2014,0,25,0,25
"25372",2014,0,25,0,25
"25373",2014,0,25,0,25
"25374",2014,0,25,0,25
"25375",2014,0,25,0,25
"25376",2014,0,25,0,25
"25377",2014,0,25,0,25
"25378",2014,0,25,0,25
"25379",2014,0,25,0,25
"25380",2014,0,25,0,25
"25381",2014,0,25,0,25
"25382",2014,0,25,0,25
"25383",2014,0,25,0,25
"25384",2014,0,25,0,25
"25385",2014,0,25,0,25
"25386",2014,0,25,0,25
"25387",2014,0,25,0,25
"25388",2014,0,25,0,25
"25389",2014,0,25,0,25
"25390",2014,0,25,0,25
"25391",2014,0,25,0,25
"25392",2014,0,25,0,25
"25393",2014,0,25,0,25
"25394",2014,0,25,0,25
"25395",2014,0,25,0,25
"25397",2014,0,25,0,25
"25398",2014,0,25,0,25
"25400",2014,0,25,0,25
"25401",2014,0,25,0,25
"25402",2014,0,25,0,25
"25403",2014,0,25,0,25
"25404",2014,0,25,0,25
"25405",2014,0,25,0,25
"25406",2014,0,25,0,25
"25408",2014,0,25,0,25
"25410",2014,0,25,0,25
"25411",2014,0,25,0,25
"25413",2014,0,25,0,25
"25414",2014,0,25,0,25
"25415",2014,0,25,0,25
"25416",2014,0,25,0,25
"25417",2014,0,25,0,25
"25418",2014,0,25,0,25
"25419",2014,0,25,0,25
"25420",2014,0,25,0,25
"25421",2014,0,25,0,25
"25422",2014,0,25,0,25
"25424",2014,0,25,0,25
"25425",2014,0,25,0,25
"25426",2014,0,25,0,25
"25427",2014,0,25,0,25
"25428",2014,0,25,0,25
"25429",2014,0,25,0,25
"25430",2014,0,25,0,25
"25431",2014,0,25,0,25
"25432",2014,0,25,0,25
"25433",2014,0,25,0,25
"25434",2014,0,25,0,25
"25435",2014,0,25,0,25
"25436",2014,0,25,0,25
"25437",2014,0,25,0,25
"25438",2014,0,25,0,25
"25439",2014,0,25,0,25
"25440",2014,0,25,0,25
"25441",2014,0,25,0,25
"25442",2014,0,25,0,25
"25443",2014,0,25,0,25
"25444",2014,0,25,0,25
"25445",2014,0,25,0,25
"25446",2014,0,25,0,25
"25447",2014,0,25,0,25
"25448",2014,0,25,0,25
"25449",2014,0,25,0,25
"25450",2014,0,25,0,25
"25451",2014,0,25,0,25
"25452",2014,0,25,0,25
"25453",2014,0,25,0,25
"25454",2014,0,25,0,25
"25455",2014,0,25,0,25
"25456",2014,0,25,0,25
"25457",2014,0,25,0,25
"25458",2014,0,25,0,25
"25459",2014,0,25,0,25
"25460",2014,0,25,0,25
"25461",2014,0,25,0,25
"25462",2014,0,25,0,25
"25463",2014,0,25,0,25
"25464",2014,0,25,0,25
"25465",2014,0,25,0,25
"25466",2014,0,25,0,25
"25467",2014,0,25,0,25
"25468",2014,0,25,0,25
"25469",2014,0,25,0,25
"25470",2014,0,25,0,25
"25471",2014,0,25,0,25
"25472",2014,0,25,0,25
"25473",2014,0,25,0,25
"25474",2014,0,25,0,25
"25475",2014,0,25,0,25
"25476",2014,0,25,0,25
"25477",2014,0,25,0,25
"25478",2014,0,25,0,25
"25479",2014,0,25,0,25
"25481",2014,0,25,0,25
"25482",2014,0,25,0,25
"25483",2014,0,25,0,25
"25485",2014,0,25,0,25
"25486",2014,0,25,0,25
"25487",2014,0,25,0,25
"25488",2014,0,25,0,25
"25489",2014,0,25,0,25
"25490",2014,0,25,0,25
"25491",2014,0,25,0,25
"25492",2014,0,25,0,25
"25493",2014,0,25,0,25
"25494",2014,0,25,0,25
"25495",2014,0,25,0,25
"25496",2014,0,25,0,25
"25497",2014,0,25,0,25
"25498",2014,0,25,0,25
"25499",2014,0,25,0,25
"25500",2014,0,25,0,25
"25501",2014,0,25,0,25
"25502",2014,0,25,0,25
"25503",2014,0,25,0,25
"25504",2014,0,25,0,25
"25505",2014,0,25,0,25
"25506",2014,0,25,0,25
"25507",2014,0,25,0,25
"25508",2014,0,25,0,25
"25510",2014,0,25,0,25
"25511",2014,0,25,0,25
"25512",2014,0,25,0,25
"25513",2014,0,25,0,25
"25514",2014,0,25,0,25
"25515",2014,0,25,0,25
"25516",2014,0,25,0,25
"25517",2014,0,25,0,25
"25518",2014,0,25,0,25
"25519",2014,0,25,0,25
"25520",2014,0,25,0,25
"25521",2014,0,25,0,25
"25522",2014,0,25,0,25
"25523",2014,0,25,0,25
"25524",2014,0,25,0,25
"25525",2014,0,25,0,25
"25526",2014,0,25,0,25
"25527",2014,0,25,0,25
"25528",2014,0,25,0,25
"25529",2014,0,25,0,25
"25532",2014,0,25,0,25
"25533",2014,0,25,0,25
"25534",2014,0,25,0,25
"25535",2014,0,25,0,25
"25536",2014,0,25,0,25
"25537",2014,0,25,0,25
"25538",2014,0,25,0,25
"25539",2014,0,25,0,25
"25540",2014,0,25,0,25
"25541",2014,0,25,0,25
"25542",2014,0,25,0,25
"25544",2014,0,25,0,25
"25545",2014,0,25,0,25
"25546",2014,0,25,0,25
"25547",2014,0,25,0,25
"25548",2014,0,25,0,25
"25550",2014,0,25,0,25
"25551",2014,0,25,0,25
"25552",2014,0,25,0,25
"25553",2014,0,25,0,25
"25554",2014,0,25,0,25
"25555",2014,0,25,0,25
"25556",2014,0,25,0,25
"25557",2014,0,25,0,25
"25558",2014,0,25,0,25
"25559",2014,0,25,0,25
"25560",2014,0,25,0,25
"25561",2014,0,25,0,25
"25562",2014,0,25,0,25
"25563",2014,0,25,0,25
"25564",2014,0,25,0,25
"25565",2014,0,25,0,25
"25566",2014,0,25,0,25
"25567",2014,0,25,0,25
"25569",2014,0,25,0,25
"25570",2014,0,25,0,25
"25571",2014,0,25,0,25
"25572",2014,0,25,0,25
"25573",2014,0,25,0,25
"25574",2014,0,25,0,25
"25575",2014,0,25,0,25
"25578",2014,0,25,0,25
"25579",2014,0,25,0,25
"25580",2014,0,25,0,25
"25582",2014,0,25,0,25
"25583",2014,0,25,0,25
"25584",2014,0,25,0,25
"25586",2014,0,25,0,25
"25588",2014,0,25,0,25
"25589",2014,0,25,0,25
"25590",2014,0,25,0,25
"25591",2014,0,25,0,25
"25592",2014,0,25,0,25
"25594",2014,0,25,0,25
"25595",2014,0,25,0,25
"25596",2014,0,25,0,25
"25597",2014,0,25,0,25
"25598",2014,0,25,0,25
"25599",2014,0,25,0,25
"25600",2014,0,25,0,25
"25601",2014,0,25,0,25
"25602",2014,0,25,0,25
"25604",2014,0,25,0,25
"25605",2014,0,25,0,25
"25607",2014,0,25,0,25
"25608",2014,0,25,0,25
"25609",2014,0,25,0,25
"25611",2014,0,25,0,25
"25612",2014,0,25,0,25
"25613",2014,0,25,0,25
"25614",2014,0,25,0,25
"25615",2014,0,25,0,25
"25616",2014,0,25,0,25
"25617",2014,0,25,0,25
"25618",2014,0,25,0,25
"25619",2014,0,25,0,25
"25620",2014,0,25,0,25
"25621",2014,0,25,0,25
"25622",2014,0,25,0,25
"25623",2014,0,25,0,25
"25624",2014,0,25,0,25
"25625",2014,0,25,0,25
"25626",2014,0,25,0,25
"25627",2014,0,25,0,25
"25629",2014,0,25,0,25
"25630",2014,0,25,0,25
"25631",2014,0,25,0,25
"25632",2014,0,25,0,25
"25633",2014,0,25,0,25
"25634",2014,0,25,0,25
"25635",2014,0,25,0,25
"26001",2014,0,95,95,190
"26001",2016,0,73,22,95
"26001",2017,0,151,50,201
"26001",2018,0,177,31,208
"26001",2019,0,118,92,210
"26002",2014,0,0,128,128
"26002",2015,0,87,9,96
"26002",2016,0,0,73,73
"26002",2017,0,50,50,100
"26002",2018,0,16,44,60
"26002",2019,0,50,50,100
"26003",2014,0,17,0,17
"26003",2017,0,50,50,100
"26003",2018,0,177,82,259
"26003",2019,0,118,82,200
"26004",2014,0,0,95,95
"26004",2015,0,87,0,87
"26004",2016,0,0,73,73
"26004",2017,0,50,50,100
"26004",2018,0,98,126,224
"26004",2019,0,174,92,266
"26005",2014,0,17,0,17
"26005",2017,0,50,50,100
"26005",2018,0,177,82,259
"26005",2019,0,118,82,200
"26006",2014,0,95,95,190
"26006",2016,0,73,22,95
"26006",2017,0,50,50,100
"26006",2018,0,98,75,173
"26006",2019,0,118,92,210
"26007",2014,0,95,95,190
"26007",2016,0,73,22,95
"26007",2017,0,50,50,100
"26007",2018,0,98,75,173
"26007",2019,0,118,92,210
"26009",2015,0,87,87,174
"26009",2017,0,50,50,100
"26009",2018,0,16,44,60
"26009",2019,0,50,50,100
"26009",2020,0,91,57,148
"26010",2014,0,0,128,128
"26010",2015,0,87,9,96
"26010",2016,0,0,73,73
"26010",2017,0,50,50,100
"26010",2018,0,16,44,60
"26010",2019,0,50,50,100
"26011",2014,0,95,78,173
"26011",2016,0,73,22,95
"26011",2017,0,151,50,201
"26011",2018,0,177,31,208
"26011",2019,0,118,92,210
"26012",2014,0,17,17,34
"26012",2017,0,50,50,100
"26012",2018,0,177,31,208
"26012",2019,0,118,82,200
"26013",2014,0,17,17,34
"26013",2017,0,50,50,100
"26013",2018,0,177,82,259
"26013",2019,0,118,82,200
"26014",2014,0,0,128,128
"26014",2015,0,87,9,96
"26014",2016,0,0,73,73
"26014",2017,0,50,50,100
"26014",2018,0,177,44,221
"26014",2019,0,118,92,210
"26015",2014,0,95,78,173
"26015",2016,0,73,22,95
"26015",2017,0,151,50,201
"26015",2018,0,177,31,208
"26015",2019,0,118,92,210
"26016",2014,0,17,17,34
"26016",2017,0,50,50,100
"26016",2018,0,177,82,259
"26016",2019,0,118,82,200
"26017",2014,0,95,95,190
"26017",2016,0,73,22,95
"26017",2017,0,151,50,201
"26017",2018,0,177,31,208
"26017",2019,0,118,92,210
"26018",2014,0,17,17,34
"26018",2017,0,50,50,100
"26018",2018,0,177,82,259
"26018",2019,0,118,82,200
"26019",2014,0,95,95,190
"26019",2016,0,73,22,95
"26019",2017,0,151,50,201
"26019",2018,0,177,31,208
"26019",2019,0,118,92,210
"26020",2014,0,95,78,173
"26020",2016,0,73,22,95
"26020",2017,0,151,50,201
"26020",2018,0,177,31,208
"26020",2019,0,118,92,210
"26021",2014,0,95,95,190
"26021",2016,0,73,22,95
"26021",2017,0,151,50,201
"26021",2018,0,177,31,208
"26021",2019,0,118,92,210
"26022",2014,0,17,17,34
"26022",2017,0,50,50,100
"26022",2018,0,177,82,259
"26022",2019,0,118,82,200
"26023",2014,0,0,95,95
"26023",2015,0,87,0,87
"26023",2016,0,0,73,73
"26023",2017,0,50,50,100
"26023",2018,0,98,75,173
"26023",2019,0,174,92,266
"26024",2014,0,0,95,95
"26024",2015,0,87,0,87
"26024",2016,0,0,73,73
"26024",2017,0,50,50,100
"26024",2018,0,98,126,224
"26024",2019,0,174,92,266
"26025",2014,0,95,95,190
"26025",2016,0,73,22,95
"26025",2017,0,151,50,201
"26025",2018,0,177,31,208
"26025",2019,0,118,92,210
"26026",2014,0,17,17,34
"26026",2017,0,50,50,100
"26026",2018,0,177,82,259
"26026",2019,0,118,82,200
"26027",2014,0,95,95,190
"26027",2016,0,73,22,95
"26027",2017,0,151,50,201
"26027",2018,0,177,31,208
"26027",2019,0,118,92,210
"26028",2014,0,0,128,128
"26028",2015,0,87,9,96
"26028",2016,0,0,73,73
"26028",2017,0,50,50,100
"26028",2018,0,177,44,221
"26028",2019,0,118,50,168
"26030",2014,0,95,95,190
"26030",2016,0,73,22,95
"26030",2017,0,151,50,201
"26030",2018,0,177,31,208
"26030",2019,0,118,92,210
"26031",2014,0,95,78,173
"26031",2016,0,0,73,73
"26031",2017,0,151,50,201
"26031",2018,0,260,82,342
"26031",2019,0,236,92,328
"26032",2014,0,95,95,190
"26032",2016,0,73,22,95
"26032",2017,0,50,50,100
"26032",2018,0,98,75,173
"26032",2019,0,118,92,210
"26033",2014,0,17,17,34
"26033",2017,0,50,50,100
"26033",2018,0,177,82,259
"26033",2019,0,118,82,200
"26034",2014,0,0,95,95
"26034",2015,0,87,0,87
"26034",2016,0,0,73,73
"26034",2017,0,50,50,100
"26034",2018,0,98,75,173
"26034",2019,0,174,92,266
"26035",2014,0,95,95,190
"26035",2016,0,73,22,95
"26035",2017,0,151,50,201
"26035",2018,0,177,31,208
"26035",2019,0,118,92,210
"26036",2014,0,17,17,34
"26036",2017,0,50,50,100
"26036",2018,0,177,31,208
"26036",2019,0,118,82,200
"26037",2014,0,0,95,95
"26037",2015,0,87,0,87
"26037",2016,0,0,73,73
"26037",2017,0,50,50,100
"26037",2018,0,98,126,224
"26037",2019,0,174,92,266
"26038",2014,0,0,95,95
"26038",2015,0,87,0,87
"26038",2016,0,0,73,73
"26038",2017,0,50,50,100
"26038",2018,0,98,44,142
"26038",2019,0,118,92,210
"26039",2014,0,0,95,95
"26039",2015,0,87,0,87
"26039",2016,0,0,73,73
"26039",2017,0,50,50,100
"26039",2018,0,98,44,142
"26039",2019,0,118,92,210
"26040",2014,0,95,95,190
"26040",2016,0,73,22,95
"26040",2017,0,151,50,201
"26040",2018,0,177,31,208
"26040",2019,0,118,92,210
"26041",2014,0,0,128,128
"26041",2015,0,87,9,96
"26041",2016,0,0,73,73
"26041",2017,0,50,50,100
"26041",2018,0,16,44,60
"26041",2019,0,50,50,100
"26042",2014,0,0,95,95
"26042",2015,0,87,0,87
"26042",2016,0,0,73,73
"26042",2017,0,50,50,100
"26042",2018,0,98,126,224
"26042",2019,0,174,92,266
"26043",2014,0,17,17,34
"26043",2017,0,50,50,100
"26043",2018,0,177,82,259
"26043",2019,0,118,82,200
"26045",2014,0,95,78,173
"26045",2016,0,0,73,73
"26045",2017,0,151,50,201
"26045",2018,0,260,82,342
"26045",2019,0,236,92,328
"26046",2014,0,17,17,34
"26046",2017,0,50,50,100
"26046",2018,0,177,82,259
"26046",2019,0,118,82,200
"26047",2014,0,17,17,34
"26047",2017,0,50,50,100
"26047",2018,0,177,31,208
"26047",2019,0,118,82,200
"26048",2014,0,17,17,34
"26048",2017,0,50,50,100
"26048",2018,0,177,82,259
"26048",2019,0,118,82,200
"26049",2014,0,0,95,95
"26049",2015,0,87,0,87
"26049",2016,0,0,73,73
"26049",2017,0,50,50,100
"26049",2018,0,98,126,224
"26049",2019,0,174,92,266
"26050",2014,0,17,17,34
"26050",2017,0,50,50,100
"26050",2018,0,177,82,259
"26050",2019,0,118,82,200
"26051",2014,0,95,78,173
"26051",2016,0,73,22,95
"26051",2017,0,151,50,201
"26051",2018,0,177,31,208
"26051",2019,0,118,92,210
"26052",2014,0,95,78,173
"26052",2016,0,0,73,73
"26052",2017,0,151,50,201
"26052",2018,0,260,82,342
"26052",2019,0,236,92,328
"26054",2014,0,17,17,34
"26054",2017,0,50,50,100
"26054",2018,0,177,82,259
"26054",2019,0,118,82,200
"26055",2014,0,95,95,190
"26055",2016,0,73,22,95
"26055",2017,0,151,50,201
"26055",2018,0,177,31,208
"26055",2019,0,118,92,210
"26056",2014,0,95,78,173
"26056",2016,0,73,22,95
"26056",2017,0,151,50,201
"26056",2018,0,177,31,208
"26056",2019,0,118,92,210
"26057",2014,0,0,95,95
"26057",2015,0,87,0,87
"26057",2016,0,0,73,73
"26057",2017,0,50,50,100
"26057",2018,0,98,44,142
"26057",2019,0,118,92,210
"26058",2014,0,0,95,95
"26058",2015,0,87,0,87
"26058",2016,0,0,73,73
"26058",2017,0,50,50,100
"26058",2018,0,98,44,142
"26058",2019,0,118,92,210
"26059",2014,0,95,95,190
"26059",2016,0,73,22,95
"26059",2017,0,151,50,201
"26059",2018,0,177,31,208
"26059",2019,0,118,92,210
"26060",2014,0,17,0,17
"26060",2017,0,50,50,100
"26060",2018,0,177,31,208
"26060",2019,0,118,82,200
"26061",2014,0,0,128,128
"26061",2015,0,87,9,96
"26061",2016,0,0,73,73
"26061",2017,0,50,50,100
"26061",2018,0,177,44,221
"26061",2019,0,118,50,168
"26062",2014,0,95,95,190
"26062",2016,0,73,22,95
"26062",2017,0,151,50,201
"26062",2018,0,177,31,208
"26062",2019,0,118,92,210
"26063",2014,0,17,17,34
"26063",2017,0,50,50,100
"26063",2018,0,177,82,259
"26063",2019,0,118,82,200
"26064",2014,0,0,95,95
"26064",2015,0,87,0,87
"26064",2016,0,0,73,73
"26064",2017,0,50,50,100
"26064",2018,0,98,126,224
"26064",2019,0,174,92,266
"26065",2014,0,95,95,190
"26065",2016,0,73,22,95
"26065",2017,0,151,50,201
"26065",2018,0,177,31,208
"26065",2019,0,118,92,210
"26066",2014,0,95,95,190
"26066",2016,0,73,22,95
"26066",2017,0,50,50,100
"26066",2018,0,98,75,173
"26066",2019,0,118,92,210
"26067",2014,0,17,17,34
"26067",2017,0,50,50,100
"26067",2018,0,177,31,208
"26067",2019,0,118,82,200
"26068",2014,0,0,128,128
"26068",2015,0,87,9,96
"26068",2016,0,0,73,73
"26068",2017,0,50,50,100
"26068",2018,0,177,44,221
"26068",2019,0,118,92,210
"26069",2014,0,95,95,190
"26069",2016,0,73,22,95
"26069",2017,0,151,50,201
"26069",2018,0,177,31,208
"26069",2019,0,118,92,210
"26070",2014,0,17,17,34
"26070",2017,0,50,50,100
"26070",2018,0,177,82,259
"26070",2019,0,118,82,200
"26071",2014,0,0,128,128
"26071",2015,0,87,9,96
"26071",2016,0,0,73,73
"26071",2017,0,50,50,100
"26071",2018,0,177,44,221
"26071",2019,0,118,92,210
"26072",2014,0,0,128,128
"26072",2015,0,87,9,96
"26072",2016,0,0,73,73
"26072",2017,0,50,50,100
"26072",2018,0,177,44,221
"26072",2019,0,118,50,168
"26073",2014,0,17,17,34
"26073",2017,0,50,50,100
"26073",2018,0,177,82,259
"26073",2019,0,118,82,200
"26074",2015,0,87,0,87
"26074",2016,0,0,73,73
"26074",2017,0,151,50,201
"26074",2018,0,177,31,208
"26074",2019,0,236,118,354
"26074",2020,0,91,91,182
"26075",2014,0,17,17,34
"26075",2017,0,50,50,100
"26075",2018,0,177,82,259
"26075",2019,0,118,82,200
"26076",2014,0,17,17,34
"26076",2017,0,50,50,100
"26076",2018,0,177,31,208
"26076",2019,0,118,82,200
"26077",2014,0,0,128,128
"26077",2015,0,87,9,96
"26077",2016,0,0,73,73
"26077",2017,0,50,50,100
"26077",2018,0,177,44,221
"26077",2019,0,118,92,210
"26078",2014,0,95,78,173
"26078",2016,0,0,73,73
"26078",2017,0,151,50,201
"26078",2018,0,260,82,342
"26078",2019,0,236,92,328
"26079",2014,0,0,95,95
"26079",2015,0,87,0,87
"26079",2016,0,0,73,73
"26079",2017,0,50,50,100
"26079",2018,0,98,126,224
"26079",2019,0,174,92,266
"26080",2014,0,95,78,173
"26080",2016,0,73,22,95
"26080",2017,0,151,50,201
"26080",2018,0,177,31,208
"26080",2019,0,118,92,210
"26081",2014,0,95,95,190
"26081",2016,0,73,22,95
"26081",2017,0,50,50,100
"26081",2018,0,98,75,173
"26081",2019,0,118,92,210
"26082",2014,0,17,17,34
"26082",2017,0,50,50,100
"26082",2018,0,177,82,259
"26082",2019,0,118,82,200
"26083",2014,0,0,128,128
"26083",2015,0,87,9,96
"26083",2016,0,0,73,73
"26083",2017,0,50,50,100
"26083",2018,0,16,44,60
"26083",2019,0,50,50,100
"26084",2014,0,0,95,95
"26084",2015,0,87,0,87
"26084",2016,0,0,73,73
"26084",2017,0,50,50,100
"26084",2018,0,98,44,142
"26084",2019,0,118,92,210
"26085",2014,0,17,17,34
"26085",2017,0,50,50,100
"26085",2018,0,177,82,259
"26085",2019,0,118,82,200
"26086",2014,0,95,95,190
"26086",2016,0,73,22,95
"26086",2017,0,151,50,201
"26086",2018,0,177,31,208
"26086",2019,0,118,92,210
"26087",2014,0,0,128,128
"26087",2015,0,87,9,96
"26087",2016,0,0,73,73
"26087",2017,0,50,50,100
"26087",2018,0,177,44,221
"26087",2019,0,118,92,210
"26088",2014,0,0,95,95
"26088",2015,0,87,0,87
"26088",2016,0,0,73,73
"26088",2017,0,50,50,100
"26088",2018,0,98,44,142
"26088",2019,0,118,92,210
"26089",2014,0,17,0,17
"26089",2017,0,50,50,100
"26089",2018,0,177,31,208
"26089",2019,0,118,82,200
"26090",2014,0,95,78,173
"26090",2016,0,73,22,95
"26090",2017,0,151,50,201
"26090",2018,0,177,31,208
"26090",2019,0,118,92,210
"26091",2014,0,17,17,34
"26091",2017,0,50,50,100
"26091",2018,0,177,82,259
"26091",2019,0,118,82,200
"26092",2014,0,0,128,128
"26092",2015,0,87,9,96
"26092",2016,0,0,73,73
"26092",2017,0,50,50,100
"26092",2018,0,177,44,221
"26092",2019,0,118,92,210
"26093",2014,0,17,17,34
"26093",2017,0,50,50,100
"26093",2018,0,177,82,259
"26093",2019,0,118,82,200
"26094",2014,0,0,128,128
"26094",2015,0,87,9,96
"26094",2016,0,0,73,73
"26094",2017,0,50,50,100
"26094",2018,0,177,44,221
"26094",2019,0,118,50,168
"26095",2014,0,95,78,173
"26095",2016,0,0,73,73
"26095",2017,0,151,50,201
"26095",2018,0,260,82,342
"26095",2019,0,236,92,328
"26096",2014,0,0,128,128
"26096",2015,0,87,9,96
"26096",2016,0,0,73,73
"26096",2017,0,50,50,100
"26096",2018,0,177,44,221
"26096",2019,0,118,92,210
"26097",2014,0,95,95,190
"26097",2016,0,73,22,95
"26097",2017,0,151,50,201
"26097",2018,0,177,31,208
"26097",2019,0,118,92,210
"26098",2014,0,95,95,190
"26098",2016,0,73,22,95
"26098",2017,0,151,50,201
"26098",2018,0,177,31,208
"26098",2019,0,118,92,210
"26099",2014,0,17,17,34
"26099",2017,0,50,50,100
"26099",2018,0,177,82,259
"26099",2019,0,118,82,200
"26100",2014,0,95,95,190
"26100",2016,0,73,22,95
"26100",2017,0,50,50,100
"26100",2018,0,98,75,173
"26100",2019,0,118,92,210
"26101",2014,0,17,0,17
"26101",2017,0,50,50,100
"26101",2018,0,177,82,259
"26101",2019,0,118,82,200
"26102",2014,0,95,78,173
"26102",2016,0,73,22,95
"26102",2017,0,151,50,201
"26102",2018,0,177,31,208
"26102",2019,0,118,92,210
"26103",2014,0,17,17,34
"26103",2017,0,50,50,100
"26103",2018,0,177,82,259
"26103",2019,0,118,82,200
"26104",2014,0,17,17,34
"26104",2017,0,50,50,100
"26104",2018,0,177,82,259
"26104",2019,0,118,82,200
"26105",2014,0,17,17,34
"26105",2017,0,50,50,100
"26105",2018,0,177,31,208
"26105",2019,0,118,82,200
"26106",2014,0,95,78,173
"26106",2016,0,0,73,73
"26106",2017,0,151,50,201
"26106",2018,0,260,82,342
"26106",2019,0,236,92,328
"26107",2014,0,0,128,128
"26107",2015,0,87,9,96
"26107",2016,0,0,73,73
"26107",2017,0,50,50,100
"26107",2018,0,177,44,221
"26107",2019,0,118,92,210
"26108",2014,0,95,95,190
"26108",2016,0,73,22,95
"26108",2017,0,151,50,201
"26108",2018,0,177,31,208
"26108",2019,0,118,92,210
"26110",2014,0,0,128,128
"26110",2015,0,87,9,96
"26110",2016,0,0,73,73
"26110",2017,0,50,50,100
"26110",2018,0,177,44,221
"26110",2019,0,118,92,210
"26111",2014,0,17,0,17
"26111",2017,0,50,50,100
"26111",2018,0,177,82,259
"26111",2019,0,118,82,200
"26112",2014,0,17,17,34
"26112",2017,0,50,50,100
"26112",2018,0,177,82,259
"26112",2019,0,118,82,200
"26113",2014,0,95,95,190
"26113",2016,0,73,22,95
"26113",2017,0,151,50,201
"26113",2018,0,177,31,208
"26113",2019,0,118,92,210
"26114",2014,0,17,0,17
"26114",2017,0,50,50,100
"26114",2018,0,177,82,259
"26114",2019,0,118,82,200
"26115",2014,0,95,78,173
"26115",2016,0,73,22,95
"26115",2017,0,151,50,201
"26115",2018,0,177,31,208
"26115",2019,0,118,92,210
"26116",2014,0,17,17,34
"26116",2017,0,50,50,100
"26116",2018,0,177,82,259
"26116",2019,0,118,82,200
"26117",2015,0,87,0,87
"26117",2016,0,0,73,73
"26117",2017,0,151,50,201
"26117",2018,0,177,31,208
"26117",2019,0,236,118,354
"26117",2020,0,91,91,182
"26118",2015,0,87,87,174
"26118",2017,0,50,50,100
"26118",2018,0,16,44,60
"26118",2019,0,50,50,100
"26118",2020,0,91,57,148
"26119",2014,0,0,128,128
"26119",2015,0,87,9,96
"26119",2016,0,0,73,73
"26119",2017,0,50,50,100
"26119",2018,0,177,44,221
"26119",2019,0,118,50,168
"26121",2014,0,17,0,17
"26121",2017,0,50,50,100
"26121",2018,0,177,82,259
"26121",2019,0,118,82,200
"26122",2014,0,95,95,190
"26122",2016,0,73,22,95
"26122",2017,0,151,50,201
"26122",2018,0,177,31,208
"26122",2019,0,118,92,210
"26123",2014,0,17,17,34
"26123",2017,0,50,50,100
"26123",2018,0,177,82,259
"26123",2019,0,118,82,200
"26124",2014,0,95,95,190
"26124",2016,0,73,22,95
"26124",2017,0,50,50,100
"26124",2018,0,98,75,173
"26124",2019,0,118,92,210
"26125",2014,0,95,95,190
"26125",2016,0,73,22,95
"26125",2017,0,50,50,100
"26125",2018,0,98,75,173
"26125",2019,0,118,92,210
"26126",2014,0,17,17,34
"26126",2017,0,50,50,100
"26126",2018,0,177,82,259
"26126",2019,0,118,82,200
"26127",2014,0,17,17,34
"26127",2017,0,50,50,100
"26127",2018,0,177,82,259
"26127",2019,0,118,82,200
"26128",2014,0,95,95,190
"26128",2016,0,73,22,95
"26128",2017,0,151,50,201
"26128",2018,0,177,31,208
"26128",2019,0,118,92,210
"26129",2014,0,0,95,95
"26129",2015,0,87,0,87
"26129",2016,0,0,73,73
"26129",2017,0,50,50,100
"26129",2018,0,98,44,142
"26129",2019,0,118,92,210
"26130",2014,0,17,17,34
"26130",2017,0,50,50,100
"26130",2018,0,177,82,259
"26130",2019,0,118,82,200
"26131",2014,0,95,78,173
"26131",2016,0,0,73,73
"26131",2017,0,151,50,201
"26131",2018,0,260,82,342
"26131",2019,0,236,92,328
"26133",2014,0,0,128,128
"26133",2015,0,87,9,96
"26133",2016,0,0,73,73
"26133",2017,0,50,50,100
"26133",2018,0,16,44,60
"26133",2019,0,50,50,100
"26134",2014,0,95,78,173
"26134",2016,0,0,73,73
"26134",2017,0,151,50,201
"26134",2018,0,260,82,342
"26134",2019,0,236,92,328
"26135",2014,0,17,17,34
"26135",2017,0,50,50,100
"26135",2018,0,177,82,259
"26135",2019,0,118,82,200
"26136",2014,0,95,95,190
"26136",2016,0,73,22,95
"26136",2017,0,151,50,201
"26136",2018,0,177,31,208
"26136",2019,0,118,92,210
"26137",2014,0,95,78,173
"26137",2016,0,0,73,73
"26137",2017,0,151,50,201
"26137",2018,0,260,82,342
"26137",2019,0,236,92,328
"26138",2014,0,17,17,34
"26138",2017,0,50,50,100
"26138",2018,0,177,82,259
"26138",2019,0,118,82,200
"26139",2014,0,0,128,128
"26139",2015,0,87,9,96
"26139",2016,0,0,73,73
"26139",2017,0,50,50,100
"26139",2018,0,177,44,221
"26139",2019,0,118,92,210
"26140",2014,0,0,128,128
"26140",2015,0,87,9,96
"26140",2016,0,0,73,73
"26140",2017,0,50,50,100
"26140",2018,0,177,44,221
"26140",2019,0,118,92,210
"26141",2014,0,95,95,190
"26141",2016,0,73,22,95
"26141",2017,0,50,50,100
"26141",2018,0,98,75,173
"26141",2019,0,118,92,210
"26142",2014,0,95,95,190
"26142",2016,0,73,22,95
"26142",2017,0,151,50,201
"26142",2018,0,177,31,208
"26142",2019,0,118,92,210
"26143",2014,0,0,128,128
"26143",2015,0,87,9,96
"26143",2016,0,0,73,73
"26143",2017,0,50,50,100
"26143",2018,0,177,44,221
"26143",2019,0,118,50,168
"26144",2014,0,95,78,173
"26144",2016,0,73,22,95
"26144",2017,0,151,50,201
"26144",2018,0,177,31,208
"26144",2019,0,118,92,210
"26145",2014,0,17,17,34
"26145",2017,0,50,50,100
"26145",2018,0,177,82,259
"26145",2019,0,118,82,200
"26146",2014,0,17,0,17
"26146",2017,0,50,50,100
"26146",2018,0,177,82,259
"26146",2019,0,118,82,200
"26147",2014,0,17,0,17
"26147",2017,0,50,50,100
"26147",2018,0,177,31,208
"26147",2019,0,118,82,200
"26148",2014,0,0,128,128
"26148",2015,0,87,9,96
"26148",2016,0,0,73,73
"26148",2017,0,50,50,100
"26148",2018,0,16,44,60
"26148",2019,0,50,50,100
"26149",2014,0,0,95,95
"26149",2015,0,87,0,87
"26149",2016,0,0,73,73
"26149",2017,0,50,50,100
"26149",2018,0,98,75,173
"26149",2019,0,174,92,266
"26150",2014,0,17,17,34
"26150",2017,0,50,50,100
"26150",2018,0,177,82,259
"26150",2019,0,118,82,200
"26152",2014,0,17,17,34
"26152",2017,0,50,50,100
"26152",2018,0,177,31,208
"26152",2019,0,118,82,200
"26153",2014,0,17,17,34
"26153",2017,0,50,50,100
"26153",2018,0,177,82,259
"26153",2019,0,118,82,200
"26154",2014,0,17,17,34
"26154",2017,0,50,50,100
"26154",2018,0,177,82,259
"26154",2019,0,118,82,200
"26155",2015,0,87,87,174
"26155",2017,0,50,50,100
"26155",2018,0,16,44,60
"26155",2019,0,50,50,100
"26155",2020,0,91,57,148
"26156",2014,0,0,128,128
"26156",2015,0,87,9,96
"26156",2016,0,0,73,73
"26156",2017,0,50,50,100
"26156",2018,0,177,44,221
"26156",2019,0,118,92,210
"26157",2014,0,95,78,173
"26157",2016,0,0,73,73
"26157",2017,0,151,50,201
"26157",2018,0,260,82,342
"26157",2019,0,236,92,328
"26159",2014,0,95,95,190
"26159",2016,0,73,22,95
"26159",2017,0,151,50,201
"26159",2018,0,177,31,208
"26159",2019,0,118,92,210
"26160",2014,0,0,128,128
"26160",2015,0,87,9,96
"26160",2016,0,0,73,73
"26160",2017,0,50,50,100
"26160",2018,0,16,44,60
"26160",2019,0,50,50,100
"26161",2014,0,17,17,34
"26161",2017,0,50,50,100
"26161",2018,0,177,82,259
"26161",2019,0,118,82,200
"26162",2015,0,87,9,96
"26162",2017,0,50,50,100
"26162",2018,0,16,44,60
"26162",2019,0,50,50,100
"26163",2014,0,95,95,190
"26163",2016,0,73,22,95
"26163",2017,0,50,50,100
"26163",2018,0,98,75,173
"26163",2019,0,118,92,210
"26164",2014,0,95,95,190
"26164",2016,0,73,22,95
"26164",2017,0,151,50,201
"26164",2018,0,177,31,208
"26164",2019,0,118,92,210
"26165",2014,0,95,95,190
"26165",2016,0,73,22,95
"26165",2017,0,50,50,100
"26165",2018,0,98,75,173
"26165",2019,0,118,92,210
"26166",2014,0,95,95,190
"26166",2016,0,73,22,95
"26166",2017,0,151,50,201
"26166",2018,0,177,31,208
"26166",2019,0,118,92,210
"26167",2014,0,95,95,190
"26167",2016,0,73,22,95
"26167",2017,0,151,50,201
"26167",2018,0,177,31,208
"26167",2019,0,118,92,210
"26168",2014,0,95,95,190
"26168",2016,0,73,22,95
"26168",2017,0,151,50,201
"26168",2018,0,177,31,208
"26168",2019,0,118,92,210
"26169",2014,0,17,17,34
"26169",2017,0,50,50,100
"26169",2018,0,177,82,259
"26169",2019,0,118,82,200
"26170",2014,0,0,95,95
"26170",2015,0,87,0,87
"26170",2016,0,0,73,73
"26170",2017,0,50,50,100
"26170",2018,0,98,126,224
"26170",2019,0,174,92,266
"26171",2014,0,95,78,173
"26171",2016,0,0,73,73
"26171",2017,0,151,50,201
"26171",2018,0,260,82,342
"26171",2019,0,236,92,328
"26172",2015,0,87,87,174
"26172",2017,0,50,50,100
"26172",2018,0,16,44,60
"26172",2019,0,50,50,100
"26172",2020,0,91,57,148
"26173",2014,0,0,95,95
"26173",2015,0,87,0,87
"26173",2016,0,0,73,73
"26173",2017,0,50,50,100
"26173",2018,0,98,126,224
"26173",2019,0,174,92,266
"26174",2014,0,0,128,128
"26174",2015,0,87,9,96
"26174",2016,0,0,73,73
"26174",2017,0,50,50,100
"26174",2018,0,177,44,221
"26174",2019,0,118,92,210
"26175",2014,0,95,95,190
"26175",2016,0,73,22,95
"26175",2017,0,151,50,201
"26175",2018,0,177,31,208
"26175",2019,0,118,92,210
"26176",2014,0,95,78,173
"26176",2016,0,73,22,95
"26176",2017,0,151,50,201
"26176",2018,0,177,31,208
"26176",2019,0,118,92,210
"26177",2014,0,0,128,128
"26177",2015,0,87,9,96
"26177",2016,0,0,73,73
"26177",2017,0,50,50,100
"26177",2018,0,177,44,221
"26177",2019,0,118,50,168
"26178",2014,0,95,95,190
"26178",2016,0,73,22,95
"26178",2017,0,151,50,201
"26178",2018,0,177,31,208
"26178",2019,0,118,92,210
"26179",2014,0,0,128,128
"26179",2015,0,87,9,96
"26179",2016,0,0,73,73
"26179",2017,0,50,50,100
"26179",2018,0,177,44,221
"26179",2019,0,118,92,210
"26180",2014,0,17,17,34
"26180",2017,0,50,50,100
"26180",2018,0,177,82,259
"26180",2019,0,118,82,200
"26181",2014,0,17,17,34
"26181",2017,0,50,50,100
"26181",2018,0,177,82,259
"26181",2019,0,118,82,200
"26182",2014,0,17,17,34
"26182",2017,0,50,50,100
"26182",2018,0,177,82,259
"26182",2019,0,118,82,200
"26183",2014,0,95,95,190
"26183",2016,0,73,22,95
"26183",2017,0,151,50,201
"26183",2018,0,177,31,208
"26183",2019,0,118,92,210
"26185",2014,0,95,78,173
"26185",2016,0,73,22,95
"26185",2017,0,151,50,201
"26185",2018,0,177,31,208
"26185",2019,0,118,92,210
"26186",2014,0,95,95,190
"26186",2016,0,73,22,95
"26186",2017,0,151,50,201
"26186",2018,0,177,31,208
"26186",2019,0,118,92,210
"26188",2014,0,17,17,34
"26188",2017,0,50,50,100
"26188",2018,0,177,82,259
"26188",2019,0,118,82,200
"26189",2014,0,17,17,34
"26189",2017,0,50,50,100
"26189",2018,0,177,82,259
"26189",2019,0,118,82,200
"26190",2014,0,17,17,34
"26190",2017,0,50,50,100
"26190",2018,0,177,82,259
"26190",2019,0,118,82,200
"26191",2014,0,95,78,173
"26191",2016,0,0,73,73
"26191",2017,0,151,50,201
"26191",2018,0,260,82,342
"26191",2019,0,236,92,328
"26192",2014,0,17,17,34
"26192",2017,0,50,50,100
"26192",2018,0,177,82,259
"26192",2019,0,118,82,200
"26193",2014,0,17,17,34
"26193",2017,0,50,50,100
"26193",2018,0,177,82,259
"26193",2019,0,118,82,200
"26194",2014,0,0,128,128
"26194",2015,0,87,9,96
"26194",2016,0,0,73,73
"26194",2017,0,50,50,100
"26194",2018,0,177,44,221
"26194",2019,0,118,50,168
"26195",2014,0,95,95,190
"26195",2016,0,73,22,95
"26195",2017,0,151,50,201
"26195",2018,0,177,31,208
"26195",2019,0,118,92,210
"26196",2014,0,0,95,95
"26196",2015,0,87,0,87
"26196",2016,0,0,73,73
"26196",2017,0,50,50,100
"26196",2018,0,98,126,224
"26196",2019,0,174,92,266
"26197",2014,0,0,95,95
"26197",2015,0,87,0,87
"26197",2016,0,0,73,73
"26197",2017,0,50,50,100
"26197",2018,0,98,126,224
"26197",2019,0,174,92,266
"26198",2014,0,17,0,17
"26198",2017,0,50,50,100
"26198",2018,0,177,82,259
"26198",2019,0,118,82,200
"26199",2014,0,17,17,34
"26199",2017,0,50,50,100
"26199",2018,0,177,82,259
"26199",2019,0,118,82,200
"26200",2014,0,17,17,34
"26200",2017,0,50,50,100
"26200",2018,0,177,82,259
"26200",2019,0,118,82,200
"26201",2014,0,17,17,34
"26201",2017,0,50,50,100
"26201",2018,0,177,82,259
"26201",2019,0,118,82,200
"26202",2014,0,17,0,17
"26202",2017,0,50,50,100
"26202",2018,0,177,82,259
"26202",2019,0,118,82,200
"26203",2014,0,17,0,17
"26203",2017,0,50,50,100
"26203",2018,0,177,82,259
"26203",2019,0,118,82,200
"26204",2014,0,95,95,190
"26204",2016,0,73,22,95
"26204",2017,0,151,50,201
"26204",2018,0,177,31,208
"26204",2019,0,118,92,210
"26205",2014,0,95,95,190
"26205",2016,0,73,22,95
"26205",2017,0,151,50,201
"26205",2018,0,177,31,208
"26205",2019,0,118,92,210
"26206",2014,0,0,95,95
"26206",2015,0,87,0,87
"26206",2016,0,0,73,73
"26206",2017,0,50,50,100
"26206",2018,0,98,126,224
"26206",2019,0,174,92,266
"26207",2014,0,0,128,128
"26207",2015,0,87,9,96
"26207",2016,0,0,73,73
"26207",2017,0,50,50,100
"26207",2018,0,177,44,221
"26207",2019,0,118,92,210
"26208",2014,0,95,95,190
"26208",2016,0,73,22,95
"26208",2017,0,50,50,100
"26208",2018,0,98,75,173
"26208",2019,0,118,92,210
"26209",2014,0,17,17,34
"26209",2017,0,50,50,100
"26209",2018,0,177,82,259
"26209",2019,0,118,82,200
"26210",2014,0,0,128,128
"26210",2015,0,87,9,96
"26210",2016,0,0,73,73
"26210",2017,0,50,50,100
"26210",2018,0,177,44,221
"26210",2019,0,118,50,168
"26211",2014,0,17,17,34
"26211",2017,0,50,50,100
"26211",2018,0,177,82,259
"26211",2019,0,118,82,200
"26212",2014,0,0,95,95
"26212",2015,0,87,0,87
"26212",2016,0,0,73,73
"26212",2017,0,50,50,100
"26212",2018,0,98,126,224
"26212",2019,0,174,92,266
"26213",2014,0,0,128,128
"26213",2015,0,87,9,96
"26213",2016,0,0,73,73
"26213",2017,0,50,50,100
"26213",2018,0,16,44,60
"26213",2019,0,50,50,100
"26214",2014,0,95,78,173
"26214",2016,0,0,73,73
"26214",2017,0,151,50,201
"26214",2018,0,260,82,342
"26214",2019,0,236,92,328
"26215",2014,0,17,17,34
"26215",2017,0,50,50,100
"26215",2018,0,177,31,208
"26215",2019,0,118,82,200
"26216",2014,0,0,128,128
"26216",2015,0,87,9,96
"26216",2016,0,0,73,73
"26216",2017,0,50,50,100
"26216",2018,0,16,44,60
"26216",2019,0,50,50,100
"26217",2015,0,87,0,87
"26217",2016,0,0,73,73
"26217",2017,0,151,50,201
"26217",2018,0,177,31,208
"26217",2019,0,236,118,354
"26217",2020,0,91,91,182
"26218",2014,0,0,128,128
"26218",2015,0,87,9,96
"26218",2016,0,0,73,73
"26218",2017,0,50,50,100
"26218",2018,0,177,44,221
"26218",2019,0,118,92,210
"26220",2014,0,17,17,34
"26220",2017,0,50,50,100
"26220",2018,0,177,82,259
"26220",2019,0,118,82,200
"26221",2014,0,95,95,190
"26221",2016,0,73,22,95
"26221",2017,0,151,50,201
"26221",2018,0,177,31,208
"26221",2019,0,118,92,210
"26222",2014,0,17,0,17
"26222",2017,0,50,50,100
"26222",2018,0,177,82,259
"26222",2019,0,118,82,200
"26223",2015,0,87,0,87
"26223",2016,0,0,73,73
"26223",2017,0,50,50,100
"26223",2018,0,98,75,173
"26223",2019,0,174,92,266
"26224",2014,0,95,95,190
"26224",2016,0,73,22,95
"26224",2017,0,50,50,100
"26224",2018,0,98,75,173
"26224",2019,0,118,92,210
"26225",2014,0,0,128,128
"26225",2015,0,87,9,96
"26225",2016,0,0,73,73
"26225",2017,0,50,50,100
"26225",2018,0,177,44,221
"26225",2019,0,118,92,210
"26226",2014,0,17,17,34
"26226",2017,0,50,50,100
"26226",2018,0,177,82,259
"26226",2019,0,118,82,200
"26227",2014,0,17,17,34
"26227",2017,0,50,50,100
"26227",2018,0,177,82,259
"26227",2019,0,118,82,200
"26228",2014,0,95,95,190
"26228",2016,0,73,22,95
"26228",2017,0,151,50,201
"26228",2018,0,177,31,208
"26228",2019,0,118,92,210
"26229",2014,0,17,17,34
"26229",2017,0,50,50,100
"26229",2018,0,177,82,259
"26229",2019,0,118,82,200
"26231",2014,0,0,128,128
"26231",2015,0,87,9,96
"26231",2016,0,0,73,73
"26231",2017,0,50,50,100
"26231",2018,0,177,44,221
"26231",2019,0,118,92,210
"26232",2014,0,0,95,95
"26232",2015,0,87,0,87
"26232",2016,0,0,73,73
"26232",2017,0,50,50,100
"26232",2018,0,98,75,173
"26232",2019,0,174,92,266
"26233",2014,0,17,17,34
"26233",2017,0,50,50,100
"26233",2018,0,177,82,259
"26233",2019,0,118,82,200
"26234",2014,0,95,78,173
"26234",2016,0,73,22,95
"26234",2017,0,151,50,201
"26234",2018,0,177,31,208
"26234",2019,0,118,92,210
"26235",2014,0,17,17,34
"26235",2017,0,50,50,100
"26235",2018,0,177,82,259
"26235",2019,0,118,82,200
"26236",2014,0,17,17,34
"26236",2017,0,50,50,100
"26236",2018,0,177,82,259
"26236",2019,0,118,82,200
"26238",2014,0,17,17,34
"26238",2017,0,50,50,100
"26238",2018,0,177,82,259
"26238",2019,0,118,82,200
"26239",2014,0,17,17,34
"26239",2017,0,50,50,100
"26239",2018,0,177,82,259
"26239",2019,0,118,82,200
"26240",2014,0,95,95,190
"26240",2016,0,73,22,95
"26240",2017,0,151,50,201
"26240",2018,0,177,31,208
"26240",2019,0,118,92,210
"26241",2014,0,95,78,173
"26241",2016,0,0,73,73
"26241",2017,0,151,50,201
"26241",2018,0,260,82,342
"26241",2019,0,236,92,328
"26242",2014,0,17,17,34
"26242",2017,0,50,50,100
"26242",2018,0,177,82,259
"26242",2019,0,118,82,200
"26243",2014,0,17,0,17
"26243",2017,0,50,50,100
"26243",2018,0,177,82,259
"26243",2019,0,118,82,200
"26244",2014,0,17,17,34
"26244",2017,0,50,50,100
"26244",2018,0,177,82,259
"26244",2019,0,118,82,200
"26245",2014,0,17,17,34
"26245",2017,0,50,50,100
"26245",2018,0,177,82,259
"26245",2019,0,118,82,200
"26246",2014,0,95,95,190
"26246",2016,0,73,22,95
"26246",2017,0,151,50,201
"26246",2018,0,177,31,208
"26246",2019,0,118,92,210
"26247",2014,0,0,128,128
"26247",2015,0,87,9,96
"26247",2016,0,0,73,73
"26247",2017,0,50,50,100
"26247",2018,0,177,44,221
"26247",2019,0,118,50,168
"26248",2014,0,95,95,190
"26248",2016,0,73,22,95
"26248",2017,0,151,50,201
"26248",2018,0,177,31,208
"26248",2019,0,118,92,210
"26249",2014,0,95,78,173
"26249",2016,0,0,73,73
"26249",2017,0,151,50,201
"26249",2018,0,260,82,342
"26249",2019,0,236,92,328
"26250",2014,0,0,95,95
"26250",2015,0,87,0,87
"26250",2016,0,0,73,73
"26250",2017,0,50,50,100
"26250",2018,0,98,44,142
"26250",2019,0,118,92,210
"26251",2014,0,95,78,173
"26251",2016,0,0,73,73
"26251",2017,0,151,50,201
"26251",2018,0,260,82,342
"26251",2019,0,236,92,328
"26252",2014,0,0,95,95
"26252",2015,0,87,0,87
"26252",2016,0,0,73,73
"26252",2017,0,50,50,100
"26252",2018,0,98,126,224
"26252",2019,0,174,92,266
"26253",2014,0,95,95,190
"26253",2016,0,73,22,95
"26253",2017,0,151,50,201
"26253",2018,0,177,31,208
"26253",2019,0,118,92,210
"26254",2014,0,95,95,190
"26254",2016,0,73,22,95
"26254",2017,0,151,50,201
"26254",2018,0,177,31,208
"26254",2019,0,118,92,210
"26255",2014,0,95,95,190
"26255",2016,0,73,22,95
"26255",2017,0,151,50,201
"26255",2018,0,177,31,208
"26255",2019,0,118,92,210
"26256",2014,0,17,17,34
"26256",2017,0,50,50,100
"26256",2018,0,177,82,259
"26256",2019,0,118,82,200
"26257",2014,0,95,78,173
"26257",2016,0,0,73,73
"26257",2017,0,151,50,201
"26257",2018,0,260,82,342
"26257",2019,0,236,92,328
"26258",2014,0,95,78,173
"26258",2016,0,73,22,95
"26258",2017,0,151,50,201
"26258",2018,0,177,31,208
"26258",2019,0,118,92,210
"26259",2014,0,0,128,128
"26259",2015,0,87,9,96
"26259",2016,0,0,73,73
"26259",2017,0,50,50,100
"26259",2018,0,177,44,221
"26259",2019,0,118,50,168
"26261",2014,0,17,0,17
"26261",2017,0,50,50,100
"26261",2018,0,177,82,259
"26261",2019,0,118,82,200
"26262",2014,0,95,95,190
"26262",2016,0,73,22,95
"26262",2017,0,151,50,201
"26262",2018,0,177,31,208
"26262",2019,0,118,92,210
"26263",2014,0,17,17,34
"26263",2017,0,50,50,100
"26263",2018,0,177,82,259
"26263",2019,0,118,82,200
"26264",2014,0,17,17,34
"26264",2017,0,50,50,100
"26264",2018,0,177,82,259
"26264",2019,0,118,82,200
"26266",2014,0,95,95,190
"26266",2016,0,73,22,95
"26266",2017,0,151,50,201
"26266",2018,0,177,31,208
"26266",2019,0,118,92,210
"26267",2014,0,17,17,34
"26267",2017,0,50,50,100
"26267",2018,0,177,82,259
"26267",2019,0,118,82,200
"26268",2014,0,95,78,173
"26268",2016,0,0,73,73
"26268",2017,0,151,50,201
"26268",2018,0,260,82,342
"26268",2019,0,236,92,328
"26269",2014,0,17,17,34
"26269",2017,0,50,50,100
"26269",2018,0,177,82,259
"26269",2019,0,118,82,200
"26270",2014,0,0,95,95
"26270",2015,0,87,0,87
"26270",2016,0,0,73,73
"26270",2017,0,50,50,100
"26270",2018,0,98,75,173
"26270",2019,0,174,92,266
"26271",2014,0,0,95,95
"26271",2015,0,87,0,87
"26271",2016,0,0,73,73
"26271",2017,0,50,50,100
"26271",2018,0,98,44,142
"26271",2019,0,118,92,210
"26272",2014,0,95,78,173
"26272",2016,0,0,73,73
"26272",2017,0,151,50,201
"26272",2018,0,260,82,342
"26272",2019,0,236,92,328
"26273",2014,0,0,95,95
"26273",2015,0,87,0,87
"26273",2016,0,0,73,73
"26273",2017,0,50,50,100
"26273",2018,0,98,75,173
"26273",2019,0,174,92,266
"26274",2014,0,95,78,173
"26274",2016,0,73,22,95
"26274",2017,0,151,50,201
"26274",2018,0,177,31,208
"26274",2019,0,118,92,210
"26275",2014,0,17,17,34
"26275",2017,0,50,50,100
"26275",2018,0,177,82,259
"26275",2019,0,118,82,200
"26276",2014,0,17,0,17
"26276",2017,0,50,50,100
"26276",2018,0,177,82,259
"26276",2019,0,118,82,200
"26277",2014,0,95,78,173
"26277",2016,0,73,22,95
"26277",2017,0,151,50,201
"26277",2018,0,177,31,208
"26277",2019,0,118,92,210
"26278",2014,0,17,17,34
"26278",2017,0,50,50,100
"26278",2018,0,177,82,259
"26278",2019,0,118,82,200
"26279",2014,0,17,17,34
"26279",2017,0,50,50,100
"26279",2018,0,177,82,259
"26279",2019,0,118,82,200
"26281",2014,0,0,95,95
"26281",2015,0,87,0,87
"26281",2016,0,0,73,73
"26281",2017,0,50,50,100
"26281",2018,0,98,44,142
"26281",2019,0,118,92,210
"26282",2014,0,95,95,190
"26282",2016,0,73,22,95
"26282",2017,0,151,50,201
"26282",2018,0,177,31,208
"26282",2019,0,118,92,210
"26283",2014,0,17,17,34
"26283",2017,0,50,50,100
"26283",2018,0,177,82,259
"26283",2019,0,118,82,200
"26284",2014,0,17,17,34
"26284",2017,0,50,50,100
"26284",2018,0,177,82,259
"26284",2019,0,118,82,200
"26285",2014,0,17,17,34
"26285",2017,0,50,50,100
"26285",2018,0,177,82,259
"26285",2019,0,118,82,200
"26286",2014,0,17,17,34
"26286",2017,0,50,50,100
"26286",2018,0,177,82,259
"26286",2019,0,118,82,200
"26287",2014,0,95,78,173
"26287",2016,0,73,22,95
"26287",2017,0,151,50,201
"26287",2018,0,177,31,208
"26287",2019,0,118,92,210
"26288",2014,0,17,17,34
"26288",2017,0,50,50,100
"26288",2018,0,177,82,259
"26288",2019,0,118,82,200
"26289",2014,0,95,95,190
"26289",2016,0,73,22,95
"26289",2017,0,151,50,201
"26289",2018,0,177,31,208
"26289",2019,0,118,92,210
"26290",2014,0,95,95,190
"26290",2016,0,73,22,95
"26290",2017,0,151,50,201
"26290",2018,0,177,31,208
"26290",2019,0,118,92,210
"26291",2014,0,95,95,190
"26291",2016,0,73,22,95
"26291",2017,0,151,50,201
"26291",2018,0,177,31,208
"26291",2019,0,118,92,210
"26292",2014,0,17,17,34
"26292",2017,0,50,50,100
"26292",2018,0,177,82,259
"26292",2019,0,118,82,200
"26293",2014,0,0,128,128
"26293",2015,0,87,9,96
"26293",2016,0,0,73,73
"26293",2017,0,50,50,100
"26293",2018,0,177,44,221
"26293",2019,0,118,50,168
"26294",2014,0,0,128,128
"26294",2015,0,87,9,96
"26294",2016,0,0,73,73
"26294",2017,0,50,50,100
"26294",2018,0,177,44,221
"26294",2019,0,118,92,210
"26295",2014,0,0,128,128
"26295",2015,0,87,9,96
"26295",2016,0,0,73,73
"26295",2017,0,50,50,100
"26295",2018,0,16,44,60
"26295",2019,0,50,50,100
"26296",2014,0,95,95,190
"26296",2016,0,73,22,95
"26296",2017,0,151,50,201
"26296",2018,0,177,31,208
"26296",2019,0,118,92,210
"26298",2014,0,0,128,128
"26298",2015,0,87,9,96
"26298",2016,0,0,73,73
"26298",2017,0,50,50,100
"26298",2018,0,177,44,221
"26298",2019,0,118,50,168
"26299",2014,0,95,95,190
"26299",2016,0,73,22,95
"26299",2017,0,151,50,201
"26299",2018,0,177,31,208
"26299",2019,0,118,92,210
"26300",2014,0,17,17,34
"26300",2017,0,50,50,100
"26300",2018,0,177,31,208
"26300",2019,0,118,82,200
"26301",2014,0,0,128,128
"26301",2015,0,87,9,96
"26301",2016,0,0,73,73
"26301",2017,0,50,50,100
"26301",2018,0,177,44,221
"26301",2019,0,118,92,210
"26302",2015,0,87,0,87
"26302",2016,0,0,73,73
"26302",2017,0,151,50,201
"26302",2018,0,177,31,208
"26302",2019,0,236,118,354
"26302",2020,0,91,91,182
"26303",2014,0,17,17,34
"26303",2017,0,50,50,100
"26303",2018,0,177,82,259
"26303",2019,0,118,82,200
"26304",2014,0,17,17,34
"26304",2017,0,50,50,100
"26304",2018,0,177,82,259
"26304",2019,0,118,82,200
"26305",2014,0,95,78,173
"26305",2016,0,0,73,73
"26305",2017,0,151,50,201
"26305",2018,0,260,82,342
"26305",2019,0,236,92,328
"26306",2014,0,17,17,34
"26306",2017,0,50,50,100
"26306",2018,0,177,82,259
"26306",2019,0,118,82,200
"26307",2014,0,0,95,95
"26307",2015,0,87,0,87
"26307",2016,0,0,73,73
"26307",2017,0,50,50,100
"26307",2018,0,98,75,173
"26307",2019,0,174,92,266
"26308",2014,0,95,95,190
"26308",2016,0,73,22,95
"26308",2017,0,151,50,201
"26308",2018,0,177,31,208
"26308",2019,0,118,92,210
"26309",2015,0,87,0,87
"26309",2016,0,0,73,73
"26309",2017,0,151,50,201
"26309",2018,0,177,31,208
"26309",2019,0,236,118,354
"26309",2020,0,91,91,182
"26310",2014,0,0,128,128
"26310",2015,0,87,9,96
"26310",2016,0,0,73,73
"26310",2017,0,50,50,100
"26310",2018,0,177,44,221
"26310",2019,0,118,92,210
"26311",2015,0,87,0,87
"26311",2016,0,0,73,73
"26311",2017,0,151,50,201
"26311",2018,0,177,31,208
"26311",2019,0,236,118,354
"26311",2020,0,91,91,182
"26312",2014,0,95,78,173
"26312",2016,0,0,73,73
"26312",2017,0,151,50,201
"26312",2018,0,260,82,342
"26312",2019,0,236,92,328
"26313",2014,0,0,95,95
"26313",2015,0,87,0,87
"26313",2016,0,0,73,73
"26313",2017,0,50,50,100
"26313",2018,0,98,126,224
"26313",2019,0,174,92,266
"26314",2014,0,0,128,128
"26314",2015,0,87,9,96
"26314",2016,0,0,73,73
"26314",2017,0,50,50,100
"26314",2018,0,177,44,221
"26314",2019,0,118,50,168
"26315",2015,0,87,0,87
"26315",2016,0,0,73,73
"26315",2017,0,151,50,201
"26315",2018,0,177,31,208
"26315",2019,0,236,118,354
"26315",2020,0,91,91,182
"26316",2015,0,87,0,87
"26316",2016,0,0,73,73
"26316",2017,0,151,50,201
"26316",2018,0,177,31,208
"26316",2019,0,236,118,354
"26316",2020,0,91,91,182
"26317",2014,0,17,17,34
"26317",2017,0,50,50,100
"26317",2018,0,177,82,259
"26317",2019,0,118,82,200
"26318",2014,0,17,17,34
"26318",2017,0,50,50,100
"26318",2018,0,177,82,259
"26318",2019,0,118,82,200
"26319",2014,0,0,128,128
"26319",2015,0,87,9,96
"26319",2016,0,0,73,73
"26319",2017,0,50,50,100
"26319",2018,0,177,44,221
"26319",2019,0,118,92,210
"26320",2014,0,0,95,95
"26320",2015,0,87,0,87
"26320",2016,0,0,73,73
"26320",2017,0,50,50,100
"26320",2018,0,98,75,173
"26320",2019,0,174,92,266
"26321",2014,0,95,78,173
"26321",2016,0,73,22,95
"26321",2017,0,151,50,201
"26321",2018,0,177,31,208
"26321",2019,0,118,92,210
"26322",2014,0,17,17,34
"26322",2017,0,50,50,100
"26322",2018,0,177,82,259
"26322",2019,0,118,82,200
"26323",2014,0,0,95,95
"26323",2015,0,87,0,87
"26323",2016,0,0,73,73
"26323",2017,0,50,50,100
"26323",2018,0,98,44,142
"26323",2019,0,118,92,210
"26324",2014,0,17,17,34
"26324",2017,0,50,50,100
"26324",2018,0,177,82,259
"26324",2019,0,118,82,200
"26325",2015,0,87,87,174
"26325",2017,0,50,50,100
"26325",2018,0,16,44,60
"26325",2019,0,50,50,100
"26325",2020,0,91,57,148
"26326",2014,0,17,17,34
"26326",2017,0,50,50,100
"26326",2018,0,177,82,259
"26326",2019,0,118,82,200
"26327",2014,0,95,95,190
"26327",2016,0,73,22,95
"26327",2017,0,151,50,201
"26327",2018,0,177,31,208
"26327",2019,0,118,92,210
"26328",2014,0,95,78,173
"26328",2016,0,73,22,95
"26328",2017,0,151,50,201
"26328",2018,0,177,31,208
"26328",2019,0,118,92,210
"26329",2014,0,17,17,34
"26329",2017,0,50,50,100
"26329",2018,0,177,82,259
"26329",2019,0,118,82,200
"26330",2014,0,0,128,128
"26330",2015,0,87,9,96
"26330",2016,0,0,73,73
"26330",2017,0,50,50,100
"26330",2018,0,16,44,60
"26330",2019,0,50,50,100
"26331",2015,0,87,0,87
"26331",2016,0,0,73,73
"26331",2017,0,151,50,201
"26331",2018,0,177,31,208
"26331",2019,0,236,118,354
"26331",2020,0,91,91,182
"26332",2014,0,0,128,128
"26332",2015,0,87,9,96
"26332",2016,0,0,73,73
"26332",2017,0,50,50,100
"26332",2018,0,16,44,60
"26332",2019,0,50,50,100
"26333",2014,0,0,128,128
"26333",2015,0,87,9,96
"26333",2016,0,0,73,73
"26333",2017,0,50,50,100
"26333",2018,0,16,44,60
"26333",2019,0,50,50,100
"26334",2014,0,95,78,173
"26334",2016,0,0,73,73
"26334",2017,0,151,50,201
"26334",2018,0,260,82,342
"26334",2019,0,236,92,328
"26335",2014,0,17,0,17
"26335",2017,0,50,50,100
"26335",2018,0,177,82,259
"26335",2019,0,118,82,200
"26336",2014,0,95,78,173
"26336",2016,0,73,22,95
"26336",2017,0,151,50,201
"26336",2018,0,177,31,208
"26336",2019,0,118,92,210
"26337",2014,0,95,95,190
"26337",2016,0,73,22,95
"26337",2017,0,151,50,201
"26337",2018,0,177,31,208
"26337",2019,0,118,92,210
"26338",2014,0,95,78,173
"26338",2016,0,0,73,73
"26338",2017,0,151,50,201
"26338",2018,0,260,82,342
"26338",2019,0,236,92,328
"26339",2014,0,95,78,173
"26339",2016,0,0,73,73
"26339",2017,0,151,50,201
"26339",2018,0,260,82,342
"26339",2019,0,236,92,328
"26340",2014,0,17,17,34
"26340",2017,0,50,50,100
"26340",2018,0,177,82,259
"26340",2019,0,118,82,200
"26341",2014,0,0,128,128
"26341",2015,0,87,9,96
"26341",2016,0,0,73,73
"26341",2017,0,50,50,100
"26341",2018,0,177,44,221
"26341",2019,0,118,92,210
"26342",2014,0,17,17,34
"26342",2017,0,50,50,100
"26342",2018,0,177,82,259
"26342",2019,0,118,82,200
"26343",2014,0,95,78,173
"26343",2016,0,0,73,73
"26343",2017,0,151,50,201
"26343",2018,0,260,82,342
"26343",2019,0,236,92,328
"26344",2014,0,95,78,173
"26344",2016,0,73,22,95
"26344",2017,0,151,50,201
"26344",2018,0,177,31,208
"26344",2019,0,118,92,210
"26345",2014,0,17,17,34
"26345",2017,0,50,50,100
"26345",2018,0,177,82,259
"26345",2019,0,118,82,200
"26346",2014,0,95,95,190
"26346",2016,0,73,22,95
"26346",2017,0,151,50,201
"26346",2018,0,177,31,208
"26346",2019,0,118,92,210
"26347",2014,0,0,128,128
"26347",2015,0,87,9,96
"26347",2016,0,0,73,73
"26347",2017,0,50,50,100
"26347",2018,0,177,44,221
"26347",2019,0,118,92,210
"26348",2014,0,17,0,17
"26348",2017,0,50,50,100
"26348",2018,0,177,82,259
"26348",2019,0,118,82,200
"26349",2014,0,0,128,128
"26349",2015,0,87,9,96
"26349",2016,0,0,73,73
"26349",2017,0,50,50,100
"26349",2018,0,177,44,221
"26349",2019,0,118,50,168
"26350",2014,0,17,17,34
"26350",2017,0,50,50,100
"26350",2018,0,177,82,259
"26350",2019,0,118,82,200
"26351",2014,0,95,78,173
"26351",2016,0,73,22,95
"26351",2017,0,151,50,201
"26351",2018,0,177,31,208
"26351",2019,0,118,92,210
"26352",2014,0,95,78,173
"26352",2016,0,0,73,73
"26352",2017,0,151,50,201
"26352",2018,0,260,82,342
"26352",2019,0,236,92,328
"26353",2014,0,95,78,173
"26353",2016,0,73,22,95
"26353",2017,0,151,50,201
"26353",2018,0,177,31,208
"26353",2019,0,118,92,210
"26355",2014,0,0,128,128
"26355",2015,0,87,9,96
"26355",2016,0,0,73,73
"26355",2017,0,50,50,100
"26355",2018,0,177,44,221
"26355",2019,0,118,92,210
"26356",2014,0,95,78,173
"26356",2016,0,0,73,73
"26356",2017,0,151,50,201
"26356",2018,0,260,82,342
"26356",2019,0,236,92,328
"26357",2014,0,17,17,34
"26357",2017,0,50,50,100
"26357",2018,0,177,82,259
"26357",2019,0,118,82,200
"26358",2014,0,95,95,190
"26358",2016,0,73,22,95
"26358",2017,0,50,50,100
"26358",2018,0,98,75,173
"26358",2019,0,118,92,210
"26359",2014,0,95,95,190
"26359",2016,0,73,22,95
"26359",2017,0,151,50,201
"26359",2018,0,177,31,208
"26359",2019,0,118,92,210
"26360",2014,0,17,17,34
"26360",2017,0,50,50,100
"26360",2018,0,177,82,259
"26360",2019,0,118,82,200
"26361",2014,0,17,17,34
"26361",2017,0,50,50,100
"26361",2018,0,177,31,208
"26361",2019,0,118,82,200
"26362",2014,0,0,95,95
"26362",2015,0,87,0,87
"26362",2016,0,0,73,73
"26362",2017,0,50,50,100
"26362",2018,0,98,126,224
"26362",2019,0,174,92,266
"26363",2014,0,17,17,34
"26363",2017,0,50,50,100
"26363",2018,0,177,82,259
"26363",2019,0,118,82,200
"26364",2014,0,95,95,190
"26364",2016,0,73,22,95
"26364",2017,0,151,50,201
"26364",2018,0,177,31,208
"26364",2019,0,118,92,210
"26365",2014,0,95,95,190
"26365",2016,0,73,22,95
"26365",2017,0,50,50,100
"26365",2018,0,98,75,173
"26365",2019,0,118,92,210
"26367",2014,0,17,17,34
"26367",2017,0,50,50,100
"26367",2018,0,177,82,259
"26367",2019,0,118,82,200
"26368",2014,0,95,95,190
"26368",2016,0,73,22,95
"26368",2017,0,151,50,201
"26368",2018,0,177,31,208
"26368",2019,0,118,92,210
"26369",2014,0,17,17,34
"26369",2017,0,50,50,100
"26369",2018,0,177,82,259
"26369",2019,0,118,82,200
"26370",2014,0,17,17,34
"26370",2017,0,50,50,100
"26370",2018,0,177,82,259
"26370",2019,0,118,82,200
"26371",2014,0,95,95,190
"26371",2016,0,73,22,95
"26371",2017,0,151,50,201
"26371",2018,0,177,31,208
"26371",2019,0,118,92,210
"26372",2014,0,17,17,34
"26372",2017,0,50,50,100
"26372",2018,0,177,82,259
"26372",2019,0,118,82,200
"26373",2014,0,17,0,17
"26373",2017,0,50,50,100
"26373",2018,0,177,82,259
"26373",2019,0,118,82,200
"26374",2014,0,17,17,34
"26374",2017,0,50,50,100
"26374",2018,0,177,82,259
"26374",2019,0,118,82,200
"26375",2014,0,17,17,34
"26375",2017,0,50,50,100
"26375",2018,0,177,82,259
"26375",2019,0,118,82,200
"26376",2014,0,17,17,34
"26376",2017,0,50,50,100
"26376",2018,0,177,31,208
"26376",2019,0,118,82,200
"26377",2014,0,17,17,34
"26377",2017,0,50,50,100
"26377",2018,0,177,82,259
"26377",2019,0,118,82,200
"26378",2014,0,95,95,190
"26378",2016,0,73,22,95
"26378",2017,0,151,50,201
"26378",2018,0,177,31,208
"26378",2019,0,118,92,210
"26379",2014,0,0,128,128
"26379",2015,0,87,0,87
"26379",2016,0,0,73,73
"26379",2017,0,50,50,100
"26379",2018,0,177,44,221
"26379",2019,0,118,92,210
"26380",2014,0,0,128,128
"26380",2015,0,87,9,96
"26380",2016,0,0,73,73
"26380",2017,0,50,50,100
"26380",2018,0,177,44,221
"26380",2019,0,118,92,210
"26381",2014,0,0,95,95
"26381",2015,0,87,0,87
"26381",2016,0,0,73,73
"26381",2017,0,50,50,100
"26381",2018,0,98,126,224
"26381",2019,0,174,92,266
"26382",2014,0,0,95,95
"26382",2015,0,87,0,87
"26382",2016,0,0,73,73
"26382",2017,0,50,50,100
"26382",2018,0,98,75,173
"26382",2019,0,174,92,266
"27001",2016,0,0,63,63
"27001",2017,0,209,77,286
"27001",2019,0,106,0,106
"27001",2020,0,0,82,82
"27002",2016,0,0,47,47
"27002",2017,0,0,93,93
"27003",2015,0,0,78,78
"27003",2019,0,0,60,60
"27003",2020,0,0,104,104
"27004",2015,0,0,78,78
"27004",2019,0,0,91,91
"27005",2015,0,0,78,78
"27005",2019,0,0,60,60
"27005",2020,0,0,104,104
"27006",2016,0,0,63,63
"27006",2017,0,209,77,286
"27006",2019,0,106,0,106
"27006",2020,0,0,82,82
"27008",2013,0,0,58,58
"27008",2015,0,0,78,78
"27008",2016,0,0,77,77
"27008",2017,0,95,16,111
"27008",2019,0,0,106,106
"27008",2020,0,0,82,82
"27009",2013,0,0,111,111
"27009",2015,0,0,78,78
"27009",2016,0,0,14,14
"27009",2017,0,16,0,16
"27009",2018,0,0,113,113
"27009",2019,0,106,0,106
"27009",2020,0,0,49,49
"27010",2013,0,0,47,47
"27010",2015,0,0,29,29
"27010",2017,0,209,77,286
"27010",2019,0,0,91,91
"27010",2020,0,0,55,55
"27011",2013,0,0,58,58
"27011",2015,0,0,78,78
"27011",2017,0,193,77,270
"27011",2019,0,117,71,188
"27011",2020,0,0,104,104
"27012",2013,0,0,47,47
"27012",2015,0,0,29,29
"27012",2017,0,209,77,286
"27012",2019,0,0,106,106
"27012",2020,0,0,55,55
"27013",2013,0,0,58,58
"27013",2015,0,0,78,78
"27013",2016,0,0,77,77
"27013",2017,0,95,16,111
"27013",2019,0,0,106,106
"27013",2020,0,0,82,82
"27014",2013,0,0,58,58
"27014",2015,0,0,78,78
"27014",2019,0,0,60,60
"27014",2020,0,0,104,104
"27015",2013,0,0,58,58
"27015",2015,0,0,78,78
"27015",2016,0,0,77,77
"27015",2017,0,95,16,111
"27015",2019,0,0,106,106
"27015",2020,0,0,82,82
"27016",2015,0,0,78,78
"27016",2017,0,95,0,95
"27016",2019,0,0,91,91
"27016",2020,0,0,55,55
"27017",2015,0,0,78,78
"27017",2019,0,0,60,60
"27017",2020,0,0,104,104
"27018",2016,0,0,63,63
"27018",2017,0,209,77,286
"27018",2019,0,106,0,106
"27018",2020,0,0,82,82
"27019",2017,0,16,93,109
"27019",2018,0,0,51,51
"27019",2020,0,0,22,22
"27020",2015,0,0,78,78
"27020",2019,0,0,60,60
"27020",2020,0,0,104,104
"27021",2013,0,0,111,111
"27021",2016,0,0,47,47
"27021",2017,0,59,93,152
"27021",2019,0,33,33,66
"27021",2020,0,0,104,104
"27022",2015,0,0,78,78
"27022",2017,0,95,0,95
"27022",2019,0,0,91,91
"27022",2020,0,0,55,55
"27023",2013,0,0,58,58
"27023",2015,0,0,78,78
"27023",2017,0,0,77,77
"27023",2019,0,0,22,22
"27023",2020,0,0,104,104
"27025",2015,0,0,78,78
"27025",2019,0,0,91,91
"27026",2013,0,0,47,47
"27026",2015,0,0,29,29
"27026",2017,0,209,77,286
"27026",2019,0,0,91,91
"27026",2020,0,0,55,55
"27027",2015,0,0,78,78
"27027",2019,0,0,24,24
"27027",2020,0,0,104,104
"27028",2016,0,0,63,63
"27028",2017,0,209,77,286
"27028",2019,0,106,0,106
"27028",2020,0,0,82,82
"27031",2013,0,0,58,58
"27031",2015,0,0,78,78
"27031",2017,0,0,77,77
"27031",2019,0,0,22,22
"27031",2020,0,0,104,104
"27032",2015,0,0,78,78
"27032",2018,0,0,113,113
"27032",2020,0,0,49,49
"27033",2013,0,0,58,58
"27033",2015,0,0,78,78
"27033",2017,0,193,77,270
"27033",2019,0,106,22,128
"27033",2020,0,0,104,104
"27034",2013,0,0,47,47
"27034",2015,0,0,29,29
"27034",2017,0,209,77,286
"27034",2019,0,0,106,106
"27034",2020,0,0,55,55
"27035",2013,0,0,111,111
"27035",2016,0,0,47,47
"27035",2017,0,59,93,152
"27035",2019,0,33,33,66
"27035",2020,0,0,104,104
"27036",2017,0,16,93,109
"27036",2018,0,0,51,51
"27036",2020,0,0,22,22
"27037",2016,0,0,63,63
"27037",2017,0,209,93,302
"27037",2019,0,106,0,106
"27037",2020,0,0,82,82
"27038",2013,0,0,1,1
"27038",2015,0,0,14,14
"27038",2017,0,16,0,16
"27038",2018,0,0,51,51
"27038",2020,0,0,22,22
"27039",2016,0,0,63,63
"27039",2017,0,209,77,286
"27039",2019,0,106,0,106
"27039",2020,0,0,82,82
"27040",2013,0,0,58,58
"27040",2015,0,0,78,78
"27040",2017,0,193,77,270
"27040",2019,0,106,22,128
"27040",2020,0,0,104,104
"27042",2013,0,0,111,111
"27042",2016,0,0,63,63
"27042",2017,0,209,93,302
"27042",2019,0,117,33,150
"27042",2020,0,0,104,104
"27043",2013,0,0,111,111
"27043",2015,0,0,78,78
"27043",2016,0,0,14,14
"27043",2017,0,16,0,16
"27043",2018,0,0,113,113
"27043",2019,0,106,0,106
"27043",2020,0,0,49,49
"27044",2015,0,0,78,78
"27044",2019,0,0,60,60
"27044",2020,0,0,104,104
"27045",2013,0,0,47,47
"27045",2015,0,0,29,29
"27045",2017,0,209,77,286
"27045",2019,0,0,91,91
"27045",2020,0,0,55,55
"27046",2016,0,0,63,63
"27046",2017,0,209,93,302
"27046",2019,0,106,0,106
"27046",2020,0,0,82,82
"27047",2013,0,0,111,111
"27047",2015,0,0,78,78
"27047",2016,0,0,14,14
"27047",2018,0,0,113,113
"27047",2020,0,0,49,49
"27048",2013,0,0,47,47
"27048",2015,0,0,29,29
"27048",2017,0,209,77,286
"27048",2019,0,0,106,106
"27048",2020,0,0,55,55
"27049",2016,0,0,63,63
"27049",2017,0,16,93,109
"27049",2019,0,106,0,106
"27050",2016,0,0,63,63
"27050",2017,0,209,93,302
"27050",2019,0,106,0,106
"27050",2020,0,0,82,82
"27051",2016,0,0,63,63
"27051",2017,0,16,93,109
"27051",2019,0,106,0,106
"27052",2016,0,0,63,63
"27052",2017,0,209,77,286
"27052",2019,0,106,0,106
"27052",2020,0,0,82,82
"27053",2016,0,0,63,63
"27053",2017,0,209,77,286
"27053",2019,0,117,117,234
"27053",2020,0,0,82,82
"27054",2013,0,0,111,111
"27054",2015,0,0,78,78
"27054",2016,0,0,14,14
"27054",2018,0,0,113,113
"27054",2020,0,0,49,49
"27055",2013,0,0,58,58
"27055",2015,0,0,78,78
"27055",2017,0,0,77,77
"27055",2019,0,0,22,22
"27055",2020,0,0,104,104
"27056",2017,0,16,93,109
"27056",2019,0,106,0,106
"27057",2013,0,0,58,58
"27057",2015,0,0,78,78
"27057",2017,0,193,77,270
"27057",2019,0,106,22,128
"27057",2020,0,0,104,104
"27059",2013,0,0,47,47
"27059",2015,0,0,29,29
"27059",2017,0,209,77,286
"27059",2019,0,0,91,91
"27059",2020,0,0,55,55
"27061",2016,0,0,63,63
"27061",2017,0,209,93,302
"27061",2019,0,106,0,106
"27061",2020,0,0,82,82
"27062",2016,0,0,63,63
"27062",2017,0,209,77,286
"27062",2019,0,106,0,106
"27062",2020,0,0,82,82
"27063",2013,0,0,58,58
"27063",2015,0,0,78,78
"27063",2018,0,0,113,113
"27063",2019,0,106,0,106
"27063",2020,0,0,49,49
"27064",2016,0,0,63,63
"27064",2017,0,209,77,286
"27064",2019,0,106,0,106
"27064",2020,0,0,82,82
"27065",2016,0,0,63,63
"27065",2017,0,209,77,286
"27065",2019,0,106,0,106
"27065",2020,0,0,82,82
"27066",2013,0,0,47,47
"27066",2015,0,0,29,29
"27066",2017,0,209,77,286
"27066",2019,0,0,91,91
"27066",2020,0,0,55,55
"27067",2013,0,0,47,47
"27067",2015,0,0,29,29
"27067",2017,0,209,77,286
"27067",2019,0,0,91,91
"27067",2020,0,0,55,55
"27068",2016,0,0,63,63
"27068",2017,0,16,93,109
"27068",2019,0,106,0,106
"27069",2013,0,0,111,111
"27069",2015,0,0,78,78
"27069",2016,0,0,14,14
"27069",2017,0,16,0,16
"27069",2018,0,0,113,113
"27069",2019,0,106,0,106
"27069",2020,0,0,49,49
"27070",2013,0,0,47,47
"27070",2015,0,0,29,29
"27070",2017,0,209,77,286
"27070",2019,0,0,106,106
"27070",2020,0,0,55,55
"27071",2013,0,0,111,111
"27071",2016,0,0,63,63
"27071",2017,0,209,93,302
"27071",2019,0,117,33,150
"27071",2020,0,0,104,104
"27072",2015,0,0,78,78
"27072",2017,0,95,0,95
"27072",2019,0,0,91,91
"27072",2020,0,0,55,55
"27073",2015,0,0,78,78
"27073",2019,0,0,91,91
"27074",2016,0,0,63,63
"27074",2017,0,209,93,302
"27074",2019,0,106,0,106
"27074",2020,0,0,82,82
"27075",2016,0,0,63,63
"27075",2017,0,16,93,109
"27075",2019,0,106,0,106
"27076",2015,0,0,78,78
"27076",2019,0,0,91,91
"27077",2016,0,0,63,63
"27077",2017,0,209,77,286
"27077",2019,0,106,0,106
"27077",2020,0,0,82,82
"27078",2015,0,0,78,78
"27078",2019,0,0,91,91
"27079",2016,0,0,63,63
"27079",2017,0,209,93,302
"27079",2019,0,106,0,106
"27079",2020,0,0,82,82
"27081",2015,0,0,78,78
"27081",2019,0,0,91,91
"27082",2013,0,0,58,58
"27082",2015,0,0,78,78
"27082",2017,0,0,77,77
"27082",2019,0,0,22,22
"27082",2020,0,0,104,104
"27083",2016,0,0,63,63
"27083",2017,0,209,77,286
"27083",2019,0,106,0,106
"27083",2020,0,0,82,82
"27085",2016,0,0,63,63
"27085",2017,0,209,77,286
"27085",2019,0,106,0,106
"27085",2020,0,0,82,82
"27089",2016,0,0,63,63
"27089",2017,0,209,77,286
"27089",2019,0,106,0,106
"27089",2020,0,0,82,82
"27090",2016,0,0,63,63
"27090",2017,0,209,77,286
"27090",2019,0,106,0,106
"27090",2020,0,0,82,82
"27091",2016,0,0,63,63
"27091",2017,0,209,77,286
"27091",2019,0,106,0,106
"27091",2020,0,0,82,82
"27094",2013,0,0,47,47
"27094",2015,0,0,29,29
"27094",2017,0,209,77,286
"27094",2019,0,0,106,106
"27094",2020,0,0,55,55
"27095",2016,0,0,63,63
"27095",2017,0,209,77,286
"27095",2019,0,106,0,106
"27095",2020,0,0,82,82
"27096",2016,0,0,63,63
"27096",2017,0,16,93,109
"27096",2019,0,106,0,106
"27097",2015,0,0,78,78
"27097",2017,0,95,0,95
"27097",2019,0,0,91,91
"27097",2020,0,0,55,55
"27098",2013,0,0,47,47
"27098",2015,0,0,29,29
"27098",2017,0,209,77,286
"27098",2019,0,0,91,91
"27098",2020,0,0,55,55
"27099",2015,0,0,78,78
"27099",2019,0,0,60,60
"27099",2020,0,0,104,104
"27100",2016,0,0,63,63
"27100",2017,0,209,77,286
"27100",2019,0,106,0,106
"27100",2020,0,0,82,82
"27101",2016,0,0,63,63
"27101",2017,0,209,77,286
"27101",2019,0,106,0,106
"27101",2020,0,0,82,82
"27102",2016,0,0,63,63
"27102",2017,0,209,77,286
"27102",2019,0,106,0,106
"27102",2020,0,0,82,82
"27103",2016,0,0,63,63
"27103",2017,0,209,77,286
"27103",2019,0,106,0,106
"27103",2020,0,0,82,82
"27104",2017,0,209,77,286
"27104",2019,0,0,106,106
"27105",2016,0,0,63,63
"27105",2017,0,209,77,286
"27105",2019,0,106,0,106
"27105",2020,0,0,82,82
"27106",2013,0,0,111,111
"27106",2016,0,0,47,47
"27106",2017,0,59,93,152
"27106",2019,0,117,33,150
"27106",2020,0,0,104,104
"27107",2016,0,0,63,63
"27107",2017,0,209,77,286
"27107",2019,0,106,0,106
"27107",2020,0,0,82,82
"27108",2013,0,0,1,1
"27108",2015,0,0,14,14
"27108",2017,0,16,0,16
"27108",2018,0,0,51,51
"27108",2020,0,0,22,22
"27109",2016,0,0,63,63
"27109",2017,0,209,93,302
"27109",2019,0,106,0,106
"27109",2020,0,0,82,82
"27110",2016,0,0,63,63
"27110",2017,0,209,77,286
"27110",2019,0,106,0,106
"27110",2020,0,0,82,82
"27111",2015,0,0,78,78
"27111",2019,0,0,91,91
"27112",2015,0,0,14,14
"27112",2017,0,16,0,16
"27112",2018,0,0,51,51
"27112",2020,0,0,22,22
"27113",2016,0,0,63,63
"27113",2017,0,209,77,286
"27113",2019,0,106,0,106
"27113",2020,0,0,82,82
"27114",2015,0,0,78,78
"27114",2019,0,0,91,91
"27115",2016,0,0,47,47
"27115",2017,0,0,93,93
"27115",2020,0,0,49,49
"27116",2016,0,0,63,63
"27116",2017,0,209,77,286
"27116",2019,0,106,0,106
"27116",2020,0,0,82,82
"27117",2017,0,16,93,109
"27117",2019,0,106,0,106
"27118",2015,0,0,78,78
"27118",2019,0,0,60,60
"27118",2020,0,0,104,104
"27119",2015,0,0,78,78
"27119",2019,0,0,91,91
"27120",2013,0,0,58,58
"27120",2015,0,0,78,78
"27120",2018,0,0,113,113
"27120",2020,0,0,49,49
"27123",2015,0,0,78,78
"27123",2019,0,0,91,91
"27124",2015,0,0,78,78
"27124",2019,0,0,91,91
"27125",2016,0,0,63,63
"27125",2017,0,209,77,286
"27125",2019,0,106,0,106
"27125",2020,0,0,82,82
"27126",2016,0,0,63,63
"27126",2017,0,209,77,286
"27126",2019,0,106,0,106
"27126",2020,0,0,82,82
"27127",2013,0,0,58,58
"27127",2015,0,0,78,78
"27127",2019,0,0,60,60
"27127",2020,0,0,104,104
"27129",2017,0,16,93,109
"27129",2019,0,106,0,106
"27130",2017,0,16,93,109
"27130",2019,0,106,0,106
"27132",2013,0,0,58,58
"27132",2015,0,0,78,78
"27132",2017,0,0,77,77
"27132",2019,0,0,22,22
"27132",2020,0,0,104,104
"27133",2016,0,0,63,63
"27133",2017,0,209,77,286
"27133",2019,0,106,0,106
"27133",2020,0,0,82,82
"27134",2016,0,0,63,63
"27134",2017,0,209,77,286
"27134",2019,0,106,0,106
"27134",2020,0,0,82,82
"27135",2013,0,0,58,58
"27135",2015,0,0,78,78
"27135",2017,0,193,77,270
"27135",2019,0,106,22,128
"27135",2020,0,0,104,104
"27136",2015,0,0,78,78
"27136",2019,0,0,91,91
"27137",2013,0,0,1,1
"27137",2015,0,0,14,14
"27137",2017,0,16,0,16
"27137",2018,0,0,51,51
"27137",2020,0,0,22,22
"27138",2016,0,0,63,63
"27138",2017,0,16,93,109
"27138",2019,0,106,0,106
"27139",2016,0,0,63,63
"27139",2017,0,16,93,109
"27139",2019,0,106,0,106
"27140",2015,0,0,78,78
"27140",2019,0,0,91,91
"27141",2013,0,0,58,58
"27141",2015,0,0,78,78
"27141",2018,0,0,113,113
"27141",2020,0,0,104,104
"27142",2015,0,0,78,78
"27142",2019,0,0,91,91
"27144",2015,0,0,78,78
"27144",2016,0,0,47,47
"27144",2017,0,0,16,16
"27144",2019,0,0,9,9
"27146",2013,0,0,111,111
"27146",2016,0,0,63,63
"27146",2017,0,209,93,302
"27146",2019,0,117,33,150
"27146",2020,0,0,104,104
"27147",2015,0,0,78,78
"27147",2019,0,0,60,60
"27147",2020,0,0,104,104
"27148",2017,0,16,93,109
"27148",2019,0,106,0,106
"27149",2013,0,0,111,111
"27149",2016,0,0,47,47
"27149",2017,0,59,93,152
"27149",2019,0,33,33,66
"27149",2020,0,0,104,104
"27151",2017,0,209,77,286
"27151",2019,0,0,106,106
"27152",2013,0,0,47,47
"27152",2015,0,0,29,29
"27152",2017,0,209,77,286
"27152",2019,0,0,91,91
"27152",2020,0,0,55,55
"27153",2013,0,0,47,47
"27153",2015,0,0,29,29
"27153",2017,0,209,77,286
"27153",2019,0,0,91,91
"27153",2020,0,0,55,55
"27154",2015,0,0,78,78
"27154",2019,0,0,22,22
"27154",2020,0,0,49,49
"27155",2017,0,16,93,109
"27155",2018,0,0,51,51
"27155",2020,0,0,22,22
"27156",2013,0,0,111,111
"27156",2015,0,0,78,78
"27156",2016,0,0,14,14
"27156",2017,0,16,0,16
"27156",2018,0,0,113,113
"27156",2019,0,106,0,106
"27156",2020,0,0,49,49
"27157",2013,0,0,58,58
"27157",2015,0,0,78,78
"27157",2018,0,0,113,113
"27157",2020,0,0,49,49
"27158",2015,0,0,78,78
"27158",2019,0,0,91,91
"27161",2013,0,0,58,58
"27161",2015,0,0,78,78
"27161",2017,0,193,77,270
"27161",2019,0,106,22,128
"27161",2020,0,0,104,104
"27162",2013,0,0,58,58
"27162",2015,0,0,78,78
"27162",2018,0,0,113,113
"27162",2019,0,106,0,106
"27162",2020,0,0,49,49
"27163",2016,0,0,63,63
"27163",2017,0,209,77,286
"27163",2019,0,106,0,106
"27163",2020,0,0,82,82
"27164",2013,0,0,58,58
"27164",2015,0,0,78,78
"27164",2017,0,193,77,270
"27164",2019,0,106,22,128
"27164",2020,0,0,104,104
"27165",2013,0,0,111,111
"27165",2015,0,0,78,78
"27165",2016,0,0,14,14
"27165",2018,0,0,113,113
"27165",2020,0,0,49,49
"27167",2016,0,0,63,63
"27167",2017,0,209,77,286
"27167",2019,0,106,0,106
"27167",2020,0,0,82,82
"27168",2013,0,0,58,58
"27168",2015,0,0,78,78
"27168",2016,0,0,77,77
"27168",2017,0,95,16,111
"27168",2019,0,0,106,106
"27168",2020,0,0,82,82
"27169",2016,0,0,63,63
"27169",2017,0,209,77,286
"27169",2019,0,106,0,106
"27169",2020,0,0,82,82
"27170",2013,0,0,111,111
"27170",2016,0,0,63,63
"27170",2017,0,209,93,302
"27170",2019,0,117,33,150
"27170",2020,0,0,104,104
"27171",2015,0,0,78,78
"27171",2019,0,0,91,91
"27173",2016,0,0,63,63
"27173",2017,0,16,93,109
"27173",2019,0,106,0,106
"27174",2016,0,0,63,63
"27174",2017,0,209,77,286
"27174",2019,0,106,0,106
"27174",2020,0,0,82,82
"27176",2017,0,209,77,286
"27176",2019,0,0,106,106
"27177",2015,0,0,78,78
"27177",2019,0,0,24,24
"27177",2020,0,0,104,104
"27179",2016,0,0,63,63
"27179",2017,0,209,93,302
"27179",2019,0,106,0,106
"27179",2020,0,0,82,82
"27180",2015,0,0,78,78
"27180",2017,0,95,0,95
"27180",2019,0,0,91,91
"27180",2020,0,0,55,55
"27181",2015,0,0,78,78
"27181",2016,0,0,47,47
"27181",2017,0,0,16,16
"27181",2019,0,0,9,9
"27182",2017,0,16,93,109
"27182",2018,0,0,51,51
"27182",2020,0,0,22,22
"27183",2015,0,0,78,78
"27183",2019,0,0,91,91
"27184",2013,0,0,58,58
"27184",2015,0,0,78,78
"27184",2016,0,0,77,77
"27184",2017,0,0,6,6
"27184",2019,0,117,117,234
"27184",2020,0,0,82,82
"27185",2013,0,0,58,58
"27185",2015,0,0,78,78
"27185",2017,0,193,77,270
"27185",2019,0,117,71,188
"27185",2020,0,0,104,104
"27187",2013,0,0,58,58
"27187",2015,0,0,78,78
"27187",2017,0,0,77,77
"27187",2019,0,117,71,188
"27187",2020,0,0,104,104
"27188",2013,0,0,58,58
"27188",2015,0,0,78,78
"27188",2016,0,0,77,77
"27188",2017,0,0,16,16
"27188",2019,0,0,106,106
"27188",2020,0,0,82,82
"27189",2013,0,0,58,58
"27189",2015,0,0,78,78
"27189",2018,0,0,113,113
"27189",2020,0,0,49,49
"27190",2015,0,0,78,78
"27190",2019,0,0,91,91
"27191",2015,0,0,78,78
"27191",2019,0,0,91,91
"27192",2013,0,0,58,58
"27192",2015,0,0,78,78
"27192",2017,0,193,77,270
"27192",2019,0,106,22,128
"27192",2020,0,0,104,104
"27193",2015,0,0,78,78
"27193",2019,0,0,91,91
"27194",2013,0,0,47,47
"27194",2015,0,0,29,29
"27194",2017,0,209,77,286
"27194",2019,0,0,91,91
"27194",2020,0,0,55,55
"27196",2013,0,0,58,58
"27196",2015,0,0,78,78
"27196",2016,0,0,77,77
"27196",2017,0,95,16,111
"27196",2019,0,0,106,106
"27196",2020,0,0,82,82
"27198",2013,0,0,58,58
"27198",2015,0,0,78,78
"27198",2018,0,0,113,113
"27198",2020,0,0,49,49
"27199",2013,0,0,47,47
"27199",2015,0,0,29,29
"27199",2017,0,209,77,286
"27199",2019,0,0,91,91
"27199",2020,0,0,55,55
"27200",2015,0,0,78,78
"27200",2019,0,0,60,60
"27200",2020,0,0,104,104
"27201",2013,0,0,58,58
"27201",2015,0,0,78,78
"27201",2019,0,117,71,188
"27201",2020,0,0,104,104
"27202",2013,0,0,47,47
"27202",2015,0,0,29,29
"27202",2017,0,209,77,286
"27202",2019,0,0,91,91
"27202",2020,0,0,55,55
"27203",2015,0,0,78,78
"27203",2019,0,0,91,91
"27204",2013,0,0,47,47
"27204",2015,0,0,29,29
"27204",2017,0,209,77,286
"27204",2019,0,0,91,91
"27204",2020,0,0,55,55
"27205",2017,0,209,77,286
"27205",2019,0,0,106,106
"27206",2016,0,0,47,47
"27206",2017,0,0,93,93
"27206",2020,0,0,49,49
"27207",2013,0,0,111,111
"27207",2016,0,0,47,47
"27207",2017,0,59,93,152
"27207",2019,0,117,33,150
"27207",2020,0,0,104,104
"27208",2013,0,0,111,111
"27208",2016,0,0,63,63
"27208",2017,0,209,93,302
"27208",2019,0,117,33,150
"27208",2020,0,0,104,104
"27209",2016,0,0,63,63
"27209",2017,0,209,77,286
"27209",2019,0,106,0,106
"27209",2020,0,0,82,82
"27210",2016,0,0,63,63
"27210",2017,0,209,77,286
"27210",2019,0,106,0,106
"27210",2020,0,0,82,82
"27212",2013,0,0,58,58
"27212",2015,0,0,78,78
"27212",2017,0,0,77,77
"27212",2019,0,0,22,22
"27212",2020,0,0,104,104
"27213",2013,0,0,47,47
"27213",2015,0,0,29,29
"27213",2017,0,209,77,286
"27213",2019,0,0,91,91
"27213",2020,0,0,55,55
"27214",2013,0,0,47,47
"27214",2015,0,0,29,29
"27214",2017,0,209,77,286
"27214",2019,0,0,106,106
"27214",2020,0,0,55,55
"27215",2013,0,0,58,58
"27215",2015,0,0,78,78
"27215",2017,0,0,77,77
"27215",2019,0,0,22,22
"27215",2020,0,0,104,104
"27216",2015,0,0,78,78
"27216",2019,0,0,60,60
"27216",2020,0,0,104,104
"27217",2013,0,0,58,58
"27217",2015,0,0,78,78
"27217",2017,0,193,77,270
"27217",2019,0,106,22,128
"27217",2020,0,0,104,104
"27218",2013,0,0,111,111
"27218",2016,0,0,63,63
"27218",2017,0,209,93,302
"27218",2019,0,117,33,150
"27218",2020,0,0,104,104
"27219",2016,0,0,63,63
"27219",2017,0,209,77,286
"27219",2019,0,106,0,106
"27219",2020,0,0,82,82
"27220",2015,0,0,78,78
"27220",2019,0,0,91,91
"27222",2016,0,0,63,63
"27222",2017,0,209,77,286
"27222",2019,0,106,0,106
"27222",2020,0,0,82,82
"27224",2016,0,0,63,63
"27224",2017,0,209,77,286
"27224",2019,0,106,0,106
"27224",2020,0,0,82,82
"27226",2013,0,0,47,47
"27226",2015,0,0,29,29
"27226",2017,0,209,77,286
"27226",2019,0,0,91,91
"27226",2020,0,0,55,55
"27227",2016,0,0,63,63
"27227",2017,0,209,77,286
"27227",2019,0,106,0,106
"27227",2020,0,0,82,82
"27228",2016,0,0,63,63
"27228",2017,0,209,77,286
"27228",2019,0,106,0,106
"27228",2020,0,0,82,82
"27229",2015,0,0,78,78
"27229",2019,0,0,60,60
"27229",2020,0,0,104,104
"27230",2015,0,0,78,78
"27230",2019,0,0,91,91
"27231",2015,0,0,78,78
"27231",2019,0,0,91,91
"27232",2013,0,0,47,47
"27232",2015,0,0,29,29
"27232",2017,0,209,77,286
"27232",2019,0,0,106,106
"27232",2020,0,0,55,55
"27233",2016,0,0,63,63
"27233",2017,0,209,77,286
"27233",2019,0,106,0,106
"27233",2020,0,0,82,82
"27234",2015,0,0,78,78
"27234",2019,0,0,60,60
"27234",2020,0,0,104,104
"27235",2013,0,0,58,58
"27235",2015,0,0,78,78
"27235",2018,0,0,113,113
"27235",2020,0,0,49,49
"27237",2013,0,0,111,111
"27237",2016,0,0,63,63
"27237",2017,0,209,93,302
"27237",2019,0,117,33,150
"27237",2020,0,0,104,104
"27238",2013,0,0,58,58
"27238",2015,0,0,78,78
"27238",2017,0,193,77,270
"27238",2019,0,106,22,128
"27238",2020,0,0,104,104
"27239",2017,0,16,93,109
"27239",2019,0,106,0,106
"27240",2016,0,0,63,63
"27240",2017,0,16,93,109
"27240",2019,0,106,0,106
"27240",2020,0,0,49,49
"27241",2013,0,0,58,58
"27241",2015,0,0,78,78
"27241",2017,0,0,77,77
"27241",2019,0,0,22,22
"27241",2020,0,0,104,104
"27242",2013,0,0,111,111
"27242",2015,0,0,78,78
"27242",2016,0,0,14,14
"27242",2017,0,16,0,16
"27242",2018,0,0,113,113
"27242",2019,0,106,0,106
"27242",2020,0,0,49,49
"27243",2016,0,0,63,63
"27243",2017,0,209,77,286
"27243",2019,0,106,0,106
"27243",2020,0,0,82,82
"27245",2013,0,0,47,47
"27245",2015,0,0,29,29
"27245",2017,0,209,77,286
"27245",2019,0,0,106,106
"27245",2020,0,0,55,55
"27246",2017,0,209,77,286
"27246",2019,0,0,106,106
"27247",2013,0,0,47,47
"27247",2015,0,0,29,29
"27247",2017,0,209,77,286
"27247",2019,0,0,106,106
"27247",2020,0,0,55,55
"27248",2013,0,0,111,111
"27248",2016,0,0,63,63
"27248",2017,0,209,93,302
"27248",2019,0,117,33,150
"27248",2020,0,0,104,104
"27249",2015,0,0,78,78
"27249",2019,0,0,60,60
"27249",2020,0,0,104,104
"27251",2016,0,0,63,63
"27251",2017,0,16,93,109
"27251",2019,0,106,0,106
"27252",2013,0,0,111,111
"27252",2016,0,0,47,47
"27252",2017,0,59,93,152
"27252",2019,0,117,33,150
"27252",2020,0,0,104,104
"27254",2015,0,0,78,78
"27254",2019,0,0,91,91
"27256",2015,0,0,78,78
"27256",2019,0,0,60,60
"27256",2020,0,0,104,104
"27258",2016,0,0,63,63
"27258",2017,0,209,77,286
"27258",2019,0,106,0,106
"27258",2020,0,0,82,82
"27259",2015,0,0,78,78
"27259",2019,0,0,91,91
"27260",2016,0,0,63,63
"27260",2017,0,209,77,286
"27260",2019,0,106,0,106
"27260",2020,0,0,82,82
"27261",2013,0,0,58,58
"27261",2015,0,0,78,78
"27261",2017,0,0,77,77
"27261",2019,0,117,71,188
"27261",2020,0,0,104,104
"27263",2016,0,0,63,63
"27263",2017,0,209,77,286
"27263",2019,0,106,0,106
"27263",2020,0,0,82,82
"27266",2016,0,0,63,63
"27266",2017,0,209,77,286
"27266",2019,0,106,0,106
"27266",2020,0,0,82,82
"27267",2016,0,0,63,63
"27267",2017,0,209,77,286
"27267",2019,0,106,0,106
"27267",2020,0,0,82,82
"27269",2013,0,0,111,111
"27269",2016,0,0,63,63
"27269",2017,0,209,93,302
"27269",2019,0,117,33,150
"27269",2020,0,0,104,104
"27271",2015,0,0,78,78
"27271",2019,0,0,91,91
"27273",2015,0,0,78,78
"27273",2019,0,0,91,91
"27275",2015,0,0,78,78
"27275",2017,0,95,0,95
"27275",2019,0,0,91,91
"27275",2020,0,0,55,55
"27276",2013,0,0,47,47
"27276",2015,0,0,29,29
"27276",2017,0,209,77,286
"27276",2019,0,0,91,91
"27276",2020,0,0,55,55
"27277",2015,0,0,78,78
"27277",2019,0,0,91,91
"27278",2015,0,0,78,78
"27278",2019,0,0,91,91
"27279",2013,0,0,47,47
"27279",2015,0,0,29,29
"27279",2017,0,209,77,286
"27279",2019,0,0,91,91
"27279",2020,0,0,55,55
"27280",2015,0,0,78,78
"27280",2019,0,0,60,60
"27280",2020,0,0,104,104
"27281",2013,0,0,58,58
"27281",2015,0,0,78,78
"27281",2017,0,0,77,77
"27281",2019,0,0,22,22
"27281",2020,0,0,104,104
"27282",2013,0,0,58,58
"27282",2015,0,0,78,78
"27282",2017,0,193,77,270
"27282",2019,0,106,22,128
"27282",2020,0,0,104,104
"27284",2013,0,0,47,47
"27284",2015,0,0,29,29
"27284",2017,0,209,77,286
"27284",2019,0,0,91,91
"27284",2020,0,0,55,55
"27285",2015,0,0,78,78
"27285",2017,0,95,0,95
"27285",2019,0,0,91,91
"27285",2020,0,0,55,55
"27286",2016,0,0,63,63
"27286",2017,0,209,77,286
"27286",2019,0,106,0,106
"27286",2020,0,0,82,82
"27287",2013,0,0,58,58
"27287",2015,0,0,78,78
"27287",2018,0,0,113,113
"27287",2020,0,0,104,104
"27288",2016,0,0,63,63
"27288",2017,0,209,77,286
"27288",2019,0,106,0,106
"27288",2020,0,0,82,82
"27289",2017,0,16,93,109
"27289",2019,0,106,0,106
"27290",2016,0,0,63,63
"27290",2017,0,209,93,302
"27290",2019,0,106,0,106
"27290",2020,0,0,82,82
"27291",2013,0,0,1,1
"27291",2015,0,0,14,14
"27291",2017,0,16,0,16
"27291",2018,0,0,51,51
"27291",2020,0,0,22,22
"27294",2013,0,0,47,47
"27294",2015,0,0,29,29
"27294",2017,0,209,77,286
"27294",2019,0,0,106,106
"27294",2020,0,0,55,55
"27295",2017,0,16,93,109
"27295",2019,0,106,0,106
"27298",2013,0,0,58,58
"27298",2015,0,0,78,78
"27298",2017,0,193,77,270
"27298",2019,0,106,22,128
"27298",2020,0,0,104,104
"27299",2013,0,0,58,58
"27299",2015,0,0,78,78
"27299",2017,0,0,77,77
"27299",2019,0,0,60,60
"27299",2020,0,0,104,104
"27300",2016,0,0,63,63
"27300",2017,0,209,93,302
"27300",2019,0,106,0,106
"27300",2020,0,0,82,82
"27301",2015,0,0,78,78
"27301",2019,0,0,60,60
"27301",2020,0,0,104,104
"27302",2016,0,0,63,63
"27302",2017,0,209,77,286
"27302",2019,0,106,0,106
"27302",2020,0,0,82,82
"27304",2013,0,0,47,47
"27304",2015,0,0,29,29
"27304",2017,0,209,77,286
"27304",2019,0,0,91,91
"27304",2020,0,0,55,55
"27306",2015,0,0,78,78
"27306",2019,0,0,60,60
"27306",2020,0,0,104,104
"27307",2013,0,0,47,47
"27307",2015,0,0,29,29
"27307",2017,0,209,77,286
"27307",2019,0,0,91,91
"27307",2020,0,0,55,55
"27309",2015,0,0,78,78
"27309",2019,0,0,91,91
"27310",2013,0,0,47,47
"27310",2015,0,0,29,29
"27310",2017,0,209,77,286
"27310",2019,0,0,91,91
"27310",2020,0,0,55,55
"27311",2016,0,0,63,63
"27311",2017,0,209,77,286
"27311",2019,0,106,0,106
"27311",2020,0,0,82,82
"27312",2015,0,0,78,78
"27312",2019,0,0,91,91
"27313",2013,0,0,58,58
"27313",2015,0,0,78,78
"27313",2017,0,0,77,77
"27313",2019,0,117,71,188
"27313",2020,0,0,104,104
"27315",2013,0,0,47,47
"27315",2015,0,0,29,29
"27315",2017,0,209,77,286
"27315",2019,0,0,91,91
"27315",2020,0,0,55,55
"27316",2016,0,0,63,63
"27316",2017,0,209,77,286
"27316",2019,0,106,0,106
"27316",2020,0,0,82,82
"27317",2016,0,0,63,63
"27317",2017,0,209,77,286
"27317",2019,0,106,0,106
"27317",2020,0,0,82,82
"27318",2016,0,0,63,63
"27318",2017,0,209,77,286
"27318",2019,0,106,0,106
"27318",2020,0,0,82,82
"27319",2016,0,0,63,63
"27319",2017,0,209,77,286
"27319",2019,0,106,0,106
"27319",2020,0,0,82,82
"27320",2016,0,0,63,63
"27320",2017,0,209,77,286
"27320",2019,0,106,0,106
"27320",2020,0,0,82,82
"27321",2013,0,0,58,58
"27321",2015,0,0,78,78
"27321",2016,0,0,77,77
"27321",2017,0,0,16,16
"27321",2019,0,0,106,106
"27321",2020,0,0,82,82
"27322",2013,0,0,58,58
"27322",2015,0,0,78,78
"27322",2016,0,0,77,77
"27322",2017,0,0,6,6
"27322",2019,0,117,117,234
"27322",2020,0,0,82,82
"27323",2016,0,0,63,63
"27323",2017,0,16,93,109
"27323",2019,0,106,0,106
"27324",2013,0,0,47,47
"27324",2015,0,0,29,29
"27324",2017,0,209,77,286
"27324",2019,0,0,91,91
"27324",2020,0,0,55,55
"27325",2016,0,0,63,63
"27325",2017,0,209,77,286
"27325",2019,0,106,0,106
"27325",2020,0,0,82,82
"27326",2015,0,0,78,78
"27326",2019,0,0,91,91
"27327",2013,0,0,58,58
"27327",2015,0,0,78,78
"27327",2017,0,193,77,270
"27327",2019,0,117,71,188
"27327",2020,0,0,104,104
"27329",2013,0,0,47,47
"27329",2015,0,0,29,29
"27329",2017,0,209,77,286
"27329",2019,0,0,91,91
"27329",2020,0,0,55,55
"27330",2013,0,0,58,58
"27330",2015,0,0,78,78
"27330",2016,0,0,77,77
"27330",2017,0,209,0,209
"27330",2019,0,0,91,91
"27330",2020,0,0,82,82
"27331",2015,0,0,78,78
"27331",2017,0,95,0,95
"27331",2019,0,0,91,91
"27331",2020,0,0,55,55
"27332",2015,0,0,78,78
"27332",2016,0,0,77,77
"27332",2017,0,95,0,95
"27332",2019,0,0,60,60
"27332",2020,0,0,104,104
"27333",2013,0,0,47,47
"27333",2015,0,0,29,29
"27333",2017,0,209,77,286
"27333",2019,0,0,91,91
"27333",2020,0,0,55,55
"27334",2013,0,0,111,111
"27334",2016,0,0,63,63
"27334",2017,0,209,93,302
"27334",2019,0,117,33,150
"27334",2020,0,0,104,104
"27335",2015,0,0,78,78
"27335",2019,0,0,60,60
"27335",2020,0,0,104,104
"27336",2015,0,0,78,78
"27336",2019,0,0,91,91
"27337",2013,0,0,47,47
"27337",2015,0,0,29,29
"27337",2017,0,209,77,286
"27337",2019,0,0,106,106
"27337",2020,0,0,55,55
"27338",2017,0,209,77,286
"27338",2019,0,0,106,106
"27339",2013,0,0,58,58
"27339",2015,0,0,78,78
"27339",2017,0,0,77,77
"27339",2019,0,0,22,22
"27339",2020,0,0,104,104
"27340",2016,0,0,63,63
"27340",2017,0,209,77,286
"27340",2019,0,106,0,106
"27340",2020,0,0,82,82
"27341",2015,0,0,78,78
"27341",2016,0,0,14,14
"27341",2018,0,0,113,113
"27341",2020,0,0,49,49
"27342",2013,0,0,58,58
"27342",2015,0,0,78,78
"27342",2017,0,0,77,77
"27342",2019,0,0,22,22
"27342",2020,0,0,104,104
"27343",2015,0,0,78,78
"27343",2019,0,0,91,91
"27345",2013,0,0,111,111
"27345",2015,0,0,78,78
"27345",2016,0,0,14,14
"27345",2017,0,16,0,16
"27345",2018,0,0,113,113
"27345",2019,0,106,0,106
"27345",2020,0,0,49,49
"27346",2013,0,0,47,47
"27346",2015,0,0,29,29
"27346",2017,0,209,77,286
"27346",2019,0,0,106,106
"27346",2020,0,0,55,55
"27347",2015,0,0,78,78
"27347",2019,0,0,60,60
"27347",2020,0,0,104,104
"27348",2013,0,0,58,58
"27348",2015,0,0,78,78
"27348",2016,0,0,77,77
"27348",2017,0,95,16,111
"27348",2019,0,0,106,106
"27348",2020,0,0,82,82
"27349",2016,0,0,63,63
"27349",2017,0,209,77,286
"27349",2019,0,106,0,106
"27349",2020,0,0,82,82
"27350",2015,0,0,78,78
"27350",2016,0,0,47,47
"27350",2017,0,0,16,16
"27350",2019,0,0,9,9
"27351",2013,0,0,58,58
"27351",2015,0,0,78,78
"27351",2016,0,0,77,77
"27351",2017,0,0,16,16
"27351",2019,0,0,106,106
"27351",2020,0,0,82,82
"27353",2015,0,0,78,78
"27353",2019,0,0,45,45
"27353",2020,0,0,104,104
"27354",2013,0,0,58,58
"27354",2015,0,0,78,78
"27354",2017,0,193,77,270
"27354",2019,0,106,22,128
"27354",2020,0,0,104,104
"27355",2015,0,0,78,78
"27355",2019,0,0,91,91
"27358",2015,0,0,78,78
"27358",2019,0,0,91,91
"27359",2016,0,0,63,63
"27359",2017,0,16,93,109
"27359",2019,0,106,0,106
"27360",2015,0,0,78,78
"27360",2019,0,0,60,60
"27360",2020,0,0,104,104
"27361",2016,0,0,63,63
"27361",2017,0,209,77,286
"27361",2019,0,106,0,106
"27361",2020,0,0,82,82
"27363",2016,0,0,63,63
"27363",2017,0,209,77,286
"27363",2019,0,106,0,106
"27363",2020,0,0,82,82
"27364",2016,0,0,63,63
"27364",2017,0,209,93,302
"27364",2019,0,106,0,106
"27364",2020,0,0,82,82
"27365",2013,0,0,58,58
"27365",2015,0,0,78,78
"27365",2016,0,0,77,77
"27365",2017,0,0,16,16
"27365",2019,0,0,106,106
"27365",2020,0,0,82,82
"27366",2017,0,209,77,286
"27366",2019,0,0,106,106
"27367",2013,0,0,111,111
"27367",2016,0,0,63,63
"27367",2017,0,209,93,302
"27367",2019,0,117,33,150
"27367",2020,0,0,104,104
"27368",2015,0,0,78,78
"27368",2016,0,0,47,47
"27368",2017,0,0,16,16
"27368",2019,0,0,9,9
"27369",2013,0,0,47,47
"27369",2015,0,0,29,29
"27369",2017,0,209,77,286
"27369",2019,0,0,106,106
"27369",2020,0,0,55,55
"27370",2017,0,209,77,286
"27370",2019,0,0,106,106
"27371",2016,0,0,63,63
"27371",2017,0,209,77,286
"27371",2019,0,106,0,106
"27371",2020,0,0,82,82
"27372",2013,0,0,47,47
"27372",2015,0,0,29,29
"27372",2017,0,209,77,286
"27372",2019,0,0,91,91
"27372",2020,0,0,55,55
"27373",2017,0,209,77,286
"27373",2019,0,0,106,106
"27374",2013,0,0,58,58
"27374",2015,0,0,78,78
"27374",2018,0,0,113,113
"27374",2020,0,0,49,49
"27375",2013,0,0,58,58
"27375",2015,0,0,78,78
"27375",2016,0,0,77,77
"27375",2017,0,0,16,16
"27375",2019,0,0,106,106
"27375",2020,0,0,82,82
"27376",2015,0,0,78,78
"27376",2016,0,0,47,47
"27376",2017,0,0,16,16
"27376",2019,0,0,9,9
"27377",2013,0,0,47,47
"27377",2015,0,0,29,29
"27377",2017,0,209,77,286
"27377",2019,0,0,106,106
"27377",2020,0,0,55,55
"27378",2013,0,0,111,111
"27378",2016,0,0,47,47
"27378",2017,0,0,93,93
"27378",2019,0,0,7,7
"27379",2013,0,0,47,47
"27379",2015,0,0,29,29
"27379",2017,0,209,77,286
"27379",2019,0,0,91,91
"27379",2020,0,0,55,55
"27380",2016,0,0,63,63
"27380",2017,0,209,77,286
"27380",2019,0,106,0,106
"27380",2020,0,0,82,82
"27381",2017,0,16,93,109
"27381",2019,0,106,0,106
"27382",2013,0,0,58,58
"27382",2015,0,0,78,78
"27382",2017,0,0,77,77
"27382",2019,0,117,71,188
"27382",2020,0,0,104,104
"27383",2013,0,0,1,1
"27383",2015,0,0,14,14
"27383",2017,0,16,0,16
"27383",2018,0,0,51,51
"27383",2020,0,0,22,22
"27384",2016,0,0,63,63
"27384",2017,0,209,77,286
"27384",2019,0,106,0,106
"27384",2020,0,0,82,82
"27385",2016,0,0,63,63
"27385",2017,0,209,77,286
"27385",2019,0,106,0,106
"27385",2020,0,0,82,82
"27386",2013,0,0,58,58
"27386",2015,0,0,78,78
"27386",2016,0,0,77,77
"27386",2017,0,95,16,111
"27386",2019,0,0,106,106
"27386",2020,0,0,82,82
"27388",2016,0,0,63,63
"27388",2017,0,209,77,286
"27388",2019,0,106,0,106
"27388",2020,0,0,82,82
"27389",2013,0,0,58,58
"27389",2015,0,0,78,78
"27389",2017,0,193,77,270
"27389",2019,0,106,22,128
"27389",2020,0,0,104,104
"27390",2013,0,0,111,111
"27390",2016,0,0,47,47
"27390",2017,0,0,93,93
"27390",2019,0,0,7,7
"27390",2020,0,0,49,49
"27391",2015,0,0,78,78
"27391",2016,0,0,47,47
"27391",2017,0,0,16,16
"27391",2019,0,0,9,9
"27392",2013,0,0,47,47
"27392",2015,0,0,29,29
"27392",2017,0,209,77,286
"27392",2019,0,0,91,91
"27392",2020,0,0,55,55
"27393",2013,0,0,111,111
"27393",2016,0,0,63,63
"27393",2017,0,209,93,302
"27393",2019,0,117,33,150
"27393",2020,0,0,104,104
"27394",2013,0,0,58,58
"27394",2015,0,0,78,78
"27394",2016,0,0,77,77
"27394",2017,0,0,6,6
"27394",2019,0,117,117,234
"27394",2020,0,0,82,82
"27395",2016,0,0,63,63
"27395",2017,0,16,93,109
"27395",2019,0,106,0,106
"27396",2017,0,209,77,286
"27396",2019,0,0,106,106
"27397",2015,0,0,78,78
"27397",2019,0,0,91,91
"27398",2017,0,16,93,109
"27398",2019,0,106,0,106
"27399",2015,0,0,78,78
"27399",2019,0,0,91,91
"27400",2015,0,0,78,78
"27400",2019,0,0,91,91
"27401",2013,0,0,58,58
"27401",2015,0,0,78,78
"27401",2017,0,0,77,77
"27401",2019,0,0,22,22
"27401",2020,0,0,104,104
"27403",2013,0,0,58,58
"27403",2015,0,0,78,78
"27403",2019,0,0,60,60
"27403",2020,0,0,104,104
"27404",2016,0,0,63,63
"27404",2017,0,16,93,109
"27404",2019,0,106,0,106
"27405",2013,0,0,47,47
"27405",2015,0,0,29,29
"27405",2017,0,209,77,286
"27405",2019,0,0,91,91
"27405",2020,0,0,55,55
"27406",2013,0,0,111,111
"27406",2016,0,0,47,47
"27406",2017,0,0,93,93
"27406",2019,0,0,7,7
"27407",2013,0,0,47,47
"27407",2015,0,0,29,29
"27407",2017,0,209,77,286
"27407",2019,0,0,106,106
"27407",2020,0,0,55,55
"27408",2013,0,0,47,47
"27408",2015,0,0,29,29
"27408",2017,0,209,77,286
"27408",2019,0,0,91,91
"27408",2020,0,0,55,55
"27410",2015,0,0,78,78
"27410",2019,0,0,60,60
"27410",2020,0,0,104,104
"27411",2013,0,0,58,58
"27411",2015,0,0,78,78
"27411",2017,0,0,77,77
"27411",2019,0,0,22,22
"27411",2020,0,0,49,49
"27412",2013,0,0,58,58
"27412",2015,0,0,78,78
"27412",2016,0,0,77,77
"27412",2017,0,0,6,6
"27412",2019,0,117,117,234
"27412",2020,0,0,82,82
"27413",2016,0,0,63,63
"27413",2017,0,209,77,286
"27413",2019,0,106,0,106
"27413",2020,0,0,82,82
"27414",2017,0,16,93,109
"27414",2019,0,106,0,106
"27415",2013,0,0,111,111
"27415",2016,0,0,63,63
"27415",2017,0,209,93,302
"27415",2019,0,117,33,150
"27415",2020,0,0,104,104
"27417",2013,0,0,47,47
"27417",2015,0,0,29,29
"27417",2017,0,209,77,286
"27417",2019,0,0,106,106
"27417",2020,0,0,55,55
"27418",2016,0,0,63,63
"27418",2017,0,209,77,286
"27418",2019,0,106,0,106
"27418",2020,0,0,82,82
"27419",2015,0,0,78,78
"27419",2019,0,0,91,91
"27420",2013,0,0,47,47
"27420",2015,0,0,29,29
"27420",2017,0,209,77,286
"27420",2019,0,0,91,91
"27420",2020,0,0,55,55
"27421",2015,0,0,78,78
"27421",2019,0,0,91,91
"27422",2015,0,0,78,78
"27422",2016,0,0,77,77
"27422",2017,0,95,16,111
"27422",2019,0,0,106,106
"27422",2020,0,0,82,82
"27423",2013,0,0,111,111
"27423",2016,0,0,47,47
"27423",2017,0,0,93,93
"27423",2019,0,0,7,7
"27424",2013,0,0,58,58
"27424",2015,0,0,78,78
"27424",2018,0,0,113,113
"27424",2020,0,0,49,49
"27425",2016,0,0,63,63
"27425",2017,0,209,93,302
"27425",2019,0,106,0,106
"27425",2020,0,0,82,82
"27426",2013,0,0,47,47
"27426",2015,0,0,29,29
"27426",2017,0,209,77,286
"27426",2019,0,0,91,91
"27426",2020,0,0,55,55
"27427",2013,0,0,111,111
"27427",2015,0,0,78,78
"27427",2016,0,0,14,14
"27427",2017,0,16,0,16
"27427",2018,0,0,113,113
"27427",2019,0,106,0,106
"27427",2020,0,0,49,49
"27428",2016,0,0,63,63
"27428",2017,0,209,77,286
"27428",2019,0,106,0,106
"27428",2020,0,0,82,82
"27429",2015,0,0,78,78
"27429",2019,0,0,91,91
"27430",2013,0,0,47,47
"27430",2015,0,0,29,29
"27430",2017,0,209,77,286
"27430",2019,0,0,106,106
"27430",2020,0,0,55,55
"27431",2016,0,0,63,63
"27431",2017,0,16,93,109
"27431",2019,0,106,0,106
"27432",2016,0,0,63,63
"27432",2017,0,209,77,286
"27432",2019,0,106,0,106
"27432",2020,0,0,82,82
"27433",2016,0,0,63,63
"27433",2017,0,209,77,286
"27433",2019,0,106,0,106
"27433",2020,0,0,82,82
"27434",2013,0,0,111,111
"27434",2016,0,0,63,63
"27434",2017,0,209,93,302
"27434",2019,0,117,33,150
"27434",2020,0,0,104,104
"27435",2016,0,0,63,63
"27435",2017,0,209,77,286
"27435",2019,0,106,0,106
"27435",2020,0,0,82,82
"27436",2013,0,0,58,58
"27436",2015,0,0,78,78
"27436",2018,0,0,113,113
"27436",2020,0,0,49,49
"27437",2013,0,0,47,47
"27437",2015,0,0,29,29
"27437",2017,0,209,77,286
"27437",2019,0,0,106,106
"27437",2020,0,0,55,55
"27438",2013,0,0,111,111
"27438",2016,0,0,47,47
"27438",2017,0,0,93,93
"27438",2019,0,0,7,7
"27439",2015,0,0,78,78
"27439",2019,0,0,60,60
"27439",2020,0,0,104,104
"27440",2015,0,0,78,78
"27440",2017,0,95,0,95
"27440",2019,0,0,91,91
"27440",2020,0,0,55,55
"27441",2016,0,0,63,63
"27441",2017,0,209,77,286
"27441",2019,0,106,0,106
"27441",2020,0,0,82,82
"27442",2016,0,0,63,63
"27442",2017,0,16,93,109
"27442",2019,0,106,0,106
"27444",2016,0,0,63,63
"27444",2017,0,16,93,109
"27444",2019,0,106,0,106
"27445",2013,0,0,47,47
"27445",2015,0,0,29,29
"27445",2017,0,209,77,286
"27445",2019,0,0,91,91
"27445",2020,0,0,55,55
"27446",2013,0,0,58,58
"27446",2015,0,0,78,78
"27446",2017,0,193,77,270
"27446",2019,0,106,22,128
"27446",2020,0,0,104,104
"27447",2013,0,0,58,58
"27447",2015,0,0,78,78
"27447",2018,0,0,113,113
"27447",2020,0,0,49,49
"27448",2015,0,0,78,78
"27448",2019,0,0,91,91
"27451",2013,0,0,58,58
"27451",2015,0,0,78,78
"27451",2017,0,0,77,77
"27451",2019,0,0,22,22
"27451",2020,0,0,104,104
"27453",2017,0,209,77,286
"27453",2019,0,0,106,106
"27454",2017,0,209,77,286
"27454",2019,0,0,106,106
"27455",2013,0,0,111,111
"27455",2016,0,0,47,47
"27455",2017,0,59,93,152
"27455",2019,0,33,33,66
"27455",2020,0,0,104,104
"27456",2013,0,0,58,58
"27456",2015,0,0,78,78
"27456",2019,0,0,60,60
"27456",2020,0,0,104,104
"27457",2015,0,0,14,14
"27457",2017,0,16,0,16
"27457",2018,0,0,51,51
"27457",2020,0,0,22,22
"27458",2013,0,0,58,58
"27458",2015,0,0,78,78
"27458",2016,0,0,77,77
"27458",2017,0,95,16,111
"27458",2019,0,0,106,106
"27458",2020,0,0,82,82
"27459",2013,0,0,111,111
"27459",2016,0,0,47,47
"27459",2017,0,59,93,152
"27459",2019,0,33,33,66
"27459",2020,0,0,104,104
"27460",2017,0,16,93,109
"27460",2019,0,106,0,106
"27462",2013,0,0,111,111
"27462",2016,0,0,47,47
"27462",2017,0,59,93,152
"27462",2019,0,117,33,150
"27462",2020,0,0,104,104
"27463",2016,0,0,63,63
"27463",2017,0,209,93,302
"27463",2019,0,106,0,106
"27463",2020,0,0,82,82
"27464",2015,0,0,78,78
"27464",2018,0,0,113,113
"27464",2020,0,0,49,49
"27465",2015,0,0,78,78
"27465",2019,0,0,91,91
"27466",2013,0,0,58,58
"27466",2015,0,0,78,78
"27466",2017,0,193,77,270
"27466",2019,0,106,22,128
"27466",2020,0,0,104,104
"27467",2016,0,0,63,63
"27467",2017,0,209,77,286
"27467",2019,0,106,0,106
"27467",2020,0,0,82,82
"27468",2016,0,0,63,63
"27468",2017,0,209,77,286
"27468",2019,0,106,0,106
"27468",2020,0,0,82,82
"27469",2013,0,0,58,58
"27469",2015,0,0,78,78
"27469",2016,0,0,77,77
"27469",2017,0,95,16,111
"27469",2019,0,0,106,106
"27469",2020,0,0,82,82
"27470",2017,0,209,77,286
"27470",2019,0,0,106,106
"27471",2013,0,0,58,58
"27471",2015,0,0,78,78
"27471",2016,0,0,77,77
"27471",2017,0,95,16,111
"27471",2019,0,0,106,106
"27471",2020,0,0,82,82
"27472",2013,0,0,58,58
"27472",2015,0,0,78,78
"27472",2017,0,193,0,193
"27472",2018,0,0,113,113
"27472",2019,0,106,0,106
"27472",2020,0,0,49,49
"27473",2015,0,0,78,78
"27473",2017,0,95,0,95
"27473",2019,0,0,91,91
"27473",2020,0,0,55,55
"27474",2013,0,0,58,58
"27474",2015,0,0,78,78
"27474",2016,0,0,77,77
"27474",2017,0,95,16,111
"27474",2019,0,0,106,106
"27474",2020,0,0,82,82
"27475",2016,0,0,63,63
"27475",2017,0,209,77,286
"27475",2019,0,106,0,106
"27475",2020,0,0,82,82
"27476",2016,0,0,63,63
"27476",2017,0,209,77,286
"27476",2019,0,106,0,106
"27476",2020,0,0,82,82
"27477",2015,0,0,78,78
"27477",2017,0,95,0,95
"27477",2019,0,0,91,91
"27477",2020,0,0,55,55
"27478",2015,0,0,78,78
"27478",2019,0,0,60,60
"27478",2020,0,0,104,104
"27480",2013,0,0,47,47
"27480",2015,0,0,29,29
"27480",2017,0,209,77,286
"27480",2019,0,0,106,106
"27480",2020,0,0,55,55
"27481",2017,0,16,93,109
"27481",2018,0,0,51,51
"27481",2020,0,0,22,22
"27482",2016,0,0,63,63
"27482",2017,0,209,77,286
"27482",2019,0,117,117,234
"27482",2020,0,0,82,82
"27483",2013,0,0,58,58
"27483",2015,0,0,78,78
"27483",2019,0,0,60,60
"27483",2020,0,0,104,104
"27485",2016,0,0,63,63
"27485",2017,0,209,77,286
"27485",2019,0,106,0,106
"27485",2020,0,0,82,82
"27486",2013,0,0,58,58
"27486",2015,0,0,78,78
"27486",2017,0,193,77,270
"27486",2019,0,106,22,128
"27486",2020,0,0,104,104
"27487",2017,0,209,77,286
"27487",2019,0,0,106,106
"27488",2017,0,209,77,286
"27488",2019,0,0,106,106
"27489",2015,0,0,78,78
"27489",2019,0,0,60,60
"27489",2020,0,0,104,104
"27490",2013,0,0,47,47
"27490",2015,0,0,29,29
"27490",2017,0,209,77,286
"27490",2019,0,0,91,91
"27490",2020,0,0,55,55
"27492",2013,0,0,58,58
"27492",2015,0,0,78,78
"27492",2018,0,0,113,113
"27492",2019,0,106,0,106
"27492",2020,0,0,49,49
"27493",2013,0,0,47,47
"27493",2015,0,0,29,29
"27493",2017,0,209,77,286
"27493",2019,0,0,106,106
"27493",2020,0,0,55,55
"27495",2015,0,0,78,78
"27495",2017,0,95,0,95
"27495",2019,0,0,91,91
"27495",2020,0,0,55,55
"27496",2017,0,209,77,286
"27496",2019,0,0,106,106
"27497",2016,0,0,63,63
"27497",2017,0,209,77,286
"27497",2019,0,106,0,106
"27497",2020,0,0,82,82
"27498",2016,0,0,63,63
"27498",2017,0,209,77,286
"27498",2019,0,106,0,106
"27498",2020,0,0,82,82
"27500",2016,0,0,63,63
"27500",2017,0,209,77,286
"27500",2019,0,106,0,106
"27500",2020,0,0,82,82
"27501",2015,0,0,78,78
"27501",2019,0,0,91,91
"27502",2013,0,0,111,111
"27502",2015,0,0,78,78
"27502",2016,0,0,14,14
"27502",2017,0,16,0,16
"27502",2018,0,0,113,113
"27502",2019,0,106,0,106
"27502",2020,0,0,49,49
"27504",2013,0,0,58,58
"27504",2015,0,0,78,78
"27504",2017,0,193,77,270
"27504",2019,0,106,22,128
"27504",2020,0,0,104,104
"27505",2016,0,0,63,63
"27505",2017,0,16,93,109
"27505",2019,0,106,0,106
"27507",2015,0,0,78,78
"27507",2016,0,0,47,47
"27507",2017,0,0,16,16
"27507",2019,0,0,9,9
"27508",2016,0,0,63,63
"27508",2017,0,16,93,109
"27508",2019,0,106,0,106
"27511",2013,0,0,58,58
"27511",2015,0,0,78,78
"27511",2017,0,193,77,270
"27511",2019,0,106,22,128
"27511",2020,0,0,104,104
"27512",2013,0,0,111,111
"27512",2016,0,0,63,63
"27512",2017,0,209,93,302
"27512",2019,0,117,33,150
"27512",2020,0,0,104,104
"27514",2017,0,16,93,109
"27514",2019,0,106,0,106
"27516",2016,0,0,63,63
"27516",2017,0,16,93,109
"27516",2019,0,106,0,106
"27517",2015,0,0,78,78
"27517",2019,0,0,91,91
"27518",2016,0,0,63,63
"27518",2017,0,209,77,286
"27518",2019,0,106,0,106
"27518",2020,0,0,82,82
"27520",2016,0,0,63,63
"27520",2017,0,209,77,286
"27520",2019,0,106,0,106
"27520",2020,0,0,82,82
"27521",2017,0,16,93,109
"27521",2018,0,0,51,51
"27521",2020,0,0,22,22
"27522",2016,0,0,63,63
"27522",2017,0,209,77,286
"27522",2019,0,106,0,106
"27522",2020,0,0,82,82
"27524",2013,0,0,58,58
"27524",2015,0,0,78,78
"27524",2017,0,193,77,270
"27524",2019,0,106,22,128
"27524",2020,0,0,104,104
"27525",2015,0,0,78,78
"27525",2019,0,0,91,91
"27527",2016,0,0,63,63
"27527",2017,0,209,77,286
"27527",2019,0,106,0,106
"27527",2020,0,0,82,82
"27528",2013,0,0,58,58
"27528",2015,0,0,78,78
"27528",2016,0,0,77,77
"27528",2017,0,0,16,16
"27528",2019,0,0,106,106
"27528",2020,0,0,82,82
"27529",2017,0,0,77,77
"27529",2019,0,117,117,234
"27530",2017,0,16,93,109
"27530",2019,0,106,0,106
"27531",2016,0,0,63,63
"27531",2017,0,209,77,286
"27531",2019,0,106,0,106
"27531",2020,0,0,82,82
"27533",2013,0,0,47,47
"27533",2015,0,0,29,29
"27533",2017,0,209,77,286
"27533",2019,0,0,91,91
"27533",2020,0,0,55,55
"27534",2013,0,0,58,58
"27534",2015,0,0,78,78
"27534",2017,0,0,77,77
"27534",2019,0,117,71,188
"27534",2020,0,0,104,104
"27535",2013,0,0,58,58
"27535",2015,0,0,78,78
"27535",2018,0,0,113,113
"27535",2020,0,0,49,49
"27536",2016,0,0,63,63
"27536",2017,0,209,77,286
"27536",2019,0,106,0,106
"27536",2020,0,0,82,82
"27537",2013,0,0,58,58
"27537",2015,0,0,78,78
"27537",2016,0,0,77,77
"27537",2017,0,0,16,16
"27537",2019,0,0,106,106
"27537",2020,0,0,82,82
"27538",2016,0,0,63,63
"27538",2017,0,209,77,286
"27538",2019,0,106,0,106
"27538",2020,0,0,82,82
"27539",2015,0,0,78,78
"27539",2019,0,0,91,91
"27540",2013,0,0,47,47
"27540",2015,0,0,29,29
"27540",2017,0,209,77,286
"27540",2019,0,0,91,91
"27540",2020,0,0,55,55
"27541",2016,0,0,63,63
"27541",2017,0,209,77,286
"27541",2019,0,106,0,106
"27541",2020,0,0,82,82
"27542",2016,0,0,63,63
"27542",2017,0,209,77,286
"27542",2019,0,106,0,106
"27542",2020,0,0,82,82
"27543",2015,0,0,78,78
"27543",2016,0,0,47,47
"27543",2017,0,0,16,16
"27543",2019,0,0,9,9
"27544",2015,0,0,78,78
"27544",2019,0,0,91,91
"27545",2017,0,0,77,77
"27545",2019,0,117,117,234
"27546",2013,0,0,58,58
"27546",2015,0,0,78,78
"27546",2017,0,0,77,77
"27546",2019,0,0,60,60
"27546",2020,0,0,104,104
"27547",2017,0,16,93,109
"27547",2019,0,106,0,106
"27548",2013,0,0,111,111
"27548",2016,0,0,47,47
"27548",2017,0,0,93,93
"27548",2019,0,0,7,7
"27550",2016,0,0,63,63
"27550",2017,0,209,77,286
"27550",2019,0,106,0,106
"27550",2020,0,0,82,82
"27552",2017,0,16,93,109
"27552",2019,0,106,0,106
"27553",2015,0,0,78,78
"27553",2019,0,0,91,91
"27554",2015,0,0,78,78
"27554",2017,0,95,0,95
"27554",2019,0,0,91,91
"27554",2020,0,0,55,55
"27555",2015,0,0,78,78
"27555",2019,0,0,91,91
"27556",2017,0,16,93,109
"27556",2019,0,106,0,106
"27557",2016,0,0,63,63
"27557",2017,0,209,93,302
"27557",2019,0,106,0,106
"27557",2020,0,0,82,82
"27558",2016,0,0,63,63
"27558",2017,0,209,77,286
"27558",2019,0,106,0,106
"27558",2020,0,0,82,82
"27560",2015,0,0,78,78
"27560",2019,0,0,91,91
"27561",2016,0,0,63,63
"27561",2017,0,209,77,286
"27561",2019,0,106,0,106
"27561",2020,0,0,82,82
"27562",2015,0,0,78,78
"27562",2019,0,0,91,91
"27563",2016,0,0,63,63
"27563",2017,0,209,77,286
"27563",2019,0,106,0,106
"27563",2020,0,0,82,82
"27564",2013,0,0,111,111
"27564",2016,0,0,47,47
"27564",2017,0,59,93,152
"27564",2019,0,117,33,150
"27564",2020,0,0,104,104
"27565",2013,0,0,111,111
"27565",2015,0,0,78,78
"27565",2016,0,0,14,14
"27565",2018,0,0,113,113
"27565",2020,0,0,49,49
"27567",2013,0,0,47,47
"27567",2015,0,0,29,29
"27567",2017,0,209,77,286
"27567",2019,0,0,91,91
"27567",2020,0,0,55,55
"27568",2013,0,0,111,111
"27568",2015,0,0,78,78
"27568",2016,0,0,14,14
"27568",2018,0,0,113,113
"27568",2020,0,0,49,49
"27569",2017,0,16,93,109
"27569",2019,0,106,0,106
"27570",2013,0,0,58,58
"27570",2015,0,0,78,78
"27570",2017,0,193,77,270
"27570",2019,0,106,22,128
"27570",2020,0,0,104,104
"27571",2016,0,0,63,63
"27571",2017,0,209,77,286
"27571",2019,0,106,0,106
"27571",2020,0,0,82,82
"27572",2016,0,0,63,63
"27572",2017,0,209,77,286
"27572",2019,0,106,0,106
"27572",2020,0,0,82,82
"27576",2016,0,0,63,63
"27576",2017,0,209,77,286
"27576",2019,0,106,0,106
"27576",2020,0,0,82,82
"27577",2016,0,0,63,63
"27577",2017,0,209,77,286
"27577",2019,0,106,0,106
"27577",2020,0,0,82,82
"27578",2015,0,0,78,78
"27578",2016,0,0,14,14
"27578",2018,0,0,113,113
"27578",2020,0,0,49,49
"27579",2016,0,0,63,63
"27579",2017,0,209,77,286
"27579",2019,0,117,117,234
"27579",2020,0,0,82,82
"27580",2016,0,0,63,63
"27580",2017,0,209,77,286
"27580",2019,0,106,0,106
"27580",2020,0,0,82,82
"27582",2016,0,0,63,63
"27582",2017,0,209,77,286
"27582",2019,0,106,0,106
"27582",2020,0,0,82,82
"27584",2016,0,0,63,63
"27584",2017,0,209,77,286
"27584",2019,0,106,0,106
"27584",2020,0,0,82,82
"27586",2016,0,0,63,63
"27586",2017,0,209,77,286
"27586",2019,0,106,0,106
"27586",2020,0,0,82,82
"27587",2016,0,0,63,63
"27587",2017,0,209,77,286
"27587",2019,0,106,0,106
"27587",2020,0,0,82,82
"27589",2015,0,0,78,78
"27589",2019,0,0,91,91
"27590",2016,0,0,63,63
"27590",2017,0,16,93,109
"27590",2019,0,106,0,106
"27591",2013,0,0,111,111
"27591",2016,0,0,47,47
"27591",2017,0,59,93,152
"27591",2019,0,117,33,150
"27591",2020,0,0,104,104
"27592",2016,0,0,63,63
"27592",2017,0,209,77,286
"27592",2019,0,106,0,106
"27592",2020,0,0,82,82
"27593",2016,0,0,63,63
"27593",2017,0,209,77,286
"27593",2019,0,117,117,234
"27593",2020,0,0,82,82
"27594",2016,0,0,63,63
"27594",2017,0,209,77,286
"27594",2019,0,106,0,106
"27594",2020,0,0,82,82
"27595",2016,0,0,63,63
"27595",2017,0,209,77,286
"27595",2019,0,106,0,106
"27595",2020,0,0,82,82
"27597",2016,0,0,63,63
"27597",2017,0,209,77,286
"27597",2019,0,106,0,106
"27597",2020,0,0,82,82
"27598",2013,0,0,58,58
"27598",2015,0,0,78,78
"27598",2016,0,0,77,77
"27598",2017,0,95,16,111
"27598",2019,0,0,106,106
"27598",2020,0,0,82,82
"27599",2015,0,0,78,78
"27599",2017,0,95,0,95
"27599",2019,0,0,91,91
"27599",2020,0,0,55,55
"27601",2016,0,0,63,63
"27601",2017,0,209,77,286
"27601",2019,0,106,0,106
"27601",2020,0,0,82,82
"27602",2013,0,0,58,58
"27602",2015,0,0,78,78
"27602",2017,0,0,77,77
"27602",2019,0,0,22,22
"27602",2020,0,0,104,104
"27603",2016,0,0,63,63
"27603",2017,0,209,77,286
"27603",2019,0,106,0,106
"27603",2020,0,0,82,82
"27604",2016,0,0,63,63
"27604",2017,0,209,77,286
"27604",2019,0,106,0,106
"27604",2020,0,0,82,82
"27605",2013,0,0,111,111
"27605",2016,0,0,63,63
"27605",2017,0,209,93,302
"27605",2019,0,117,33,150
"27605",2020,0,0,104,104
"27606",2016,0,0,63,63
"27606",2017,0,209,77,286
"27606",2019,0,106,0,106
"27606",2020,0,0,82,82
"27608",2017,0,16,93,109
"27608",2019,0,106,0,106
"27609",2016,0,0,63,63
"27609",2017,0,209,77,286
"27609",2019,0,106,0,106
"27609",2020,0,0,82,82
"27610",2017,0,16,93,109
"27610",2018,0,0,51,51
"27610",2020,0,0,22,22
"27611",2015,0,0,78,78
"27611",2019,0,0,91,91
"27612",2015,0,0,78,78
"27612",2019,0,0,91,91
"27613",2013,0,0,111,111
"27613",2016,0,0,47,47
"27613",2017,0,59,93,152
"27613",2019,0,117,33,150
"27613",2020,0,0,104,104
"27614",2013,0,0,47,47
"27614",2015,0,0,29,29
"27614",2017,0,209,77,286
"27614",2019,0,0,91,91
"27614",2020,0,0,55,55
"27615",2015,0,0,78,78
"27615",2019,0,0,60,60
"27615",2020,0,0,104,104
"27616",2016,0,0,63,63
"27616",2017,0,209,77,286
"27616",2019,0,117,117,234
"27616",2020,0,0,82,82
"27617",2013,0,0,47,47
"27617",2015,0,0,29,29
"27617",2017,0,209,77,286
"27617",2019,0,0,106,106
"27617",2020,0,0,55,55
"27618",2013,0,0,111,111
"27618",2015,0,0,78,78
"27618",2016,0,0,14,14
"27618",2017,0,16,0,16
"27618",2018,0,0,113,113
"27618",2019,0,106,0,106
"27618",2020,0,0,49,49
"27620",2016,0,0,63,63
"27620",2017,0,209,77,286
"27620",2019,0,106,0,106
"27620",2020,0,0,82,82
"27621",2015,0,0,78,78
"27621",2019,0,0,91,91
"27622",2016,0,0,63,63
"27622",2017,0,209,93,302
"27622",2019,0,106,0,106
"27622",2020,0,0,82,82
"27623",2013,0,0,58,58
"27623",2015,0,0,78,78
"27623",2019,0,117,71,188
"27623",2020,0,0,104,104
"27624",2013,0,0,58,58
"27624",2015,0,0,78,78
"27624",2016,0,0,77,77
"27624",2017,0,0,16,16
"27624",2019,0,0,106,106
"27624",2020,0,0,82,82
"27625",2013,0,0,47,47
"27625",2015,0,0,29,29
"27625",2017,0,209,77,286
"27625",2019,0,0,91,91
"27625",2020,0,0,55,55
"27627",2016,0,0,63,63
"27627",2017,0,209,93,302
"27627",2019,0,106,0,106
"27627",2020,0,0,82,82
"27629",2013,0,0,111,111
"27629",2016,0,0,47,47
"27629",2017,0,59,93,152
"27629",2019,0,33,33,66
"27629",2020,0,0,104,104
"27630",2016,0,0,63,63
"27630",2017,0,209,77,286
"27630",2019,0,106,0,106
"27630",2020,0,0,82,82
"27631",2016,0,0,63,63
"27631",2017,0,209,77,286
"27631",2019,0,106,0,106
"27631",2020,0,0,82,82
"27632",2013,0,0,47,47
"27632",2015,0,0,29,29
"27632",2017,0,209,77,286
"27632",2019,0,0,91,91
"27632",2020,0,0,55,55
"27633",2013,0,0,47,47
"27633",2015,0,0,29,29
"27633",2017,0,209,77,286
"27633",2019,0,0,91,91
"27633",2020,0,0,55,55
"27635",2015,0,0,78,78
"27635",2017,0,95,0,95
"27635",2019,0,0,91,91
"27635",2020,0,0,55,55
"27638",2016,0,0,63,63
"27638",2017,0,209,77,286
"27638",2019,0,117,117,234
"27638",2020,0,0,82,82
"27640",2013,0,0,58,58
"27640",2015,0,0,78,78
"27640",2018,0,0,113,113
"27640",2020,0,0,49,49
"27641",2013,0,0,58,58
"27641",2015,0,0,78,78
"27641",2017,0,193,77,270
"27641",2019,0,106,22,128
"27641",2020,0,0,104,104
"27643",2015,0,0,78,78
"27643",2016,0,0,14,14
"27643",2018,0,0,113,113
"27643",2020,0,0,49,49
"27644",2015,0,0,78,78
"27644",2017,0,95,0,95
"27644",2019,0,0,91,91
"27644",2020,0,0,55,55
"27645",2016,0,0,63,63
"27645",2017,0,209,77,286
"27645",2019,0,106,0,106
"27645",2020,0,0,82,82
"27646",2016,0,0,63,63
"27646",2017,0,209,77,286
"27646",2019,0,106,0,106
"27646",2020,0,0,82,82
"27649",2013,0,0,47,47
"27649",2015,0,0,29,29
"27649",2017,0,209,77,286
"27649",2019,0,0,106,106
"27649",2020,0,0,55,55
"27650",2013,0,0,58,58
"27650",2015,0,0,78,78
"27650",2017,0,193,77,270
"27650",2019,0,106,22,128
"27650",2020,0,0,104,104
"27652",2013,0,0,58,58
"27652",2015,0,0,78,78
"27652",2017,0,0,77,77
"27652",2019,0,0,22,22
"27652",2020,0,0,104,104
"27654",2016,0,0,63,63
"27654",2017,0,209,77,286
"27654",2019,0,117,117,234
"27654",2020,0,0,82,82
"27655",2016,0,0,63,63
"27655",2017,0,209,77,286
"27655",2019,0,106,0,106
"27655",2020,0,0,82,82
"27656",2016,0,0,63,63
"27656",2017,0,209,77,286
"27656",2019,0,106,0,106
"27656",2020,0,0,82,82
"27658",2016,0,0,63,63
"27658",2017,0,209,77,286
"27658",2019,0,106,0,106
"27658",2020,0,0,82,82
"27659",2015,0,0,78,78
"27659",2019,0,0,91,91
"27660",2016,0,0,63,63
"27660",2017,0,16,93,109
"27660",2019,0,106,0,106
"27661",2016,0,0,63,63
"27661",2017,0,209,77,286
"27661",2019,0,106,0,106
"27661",2020,0,0,82,82
"27662",2016,0,0,63,63
"27662",2017,0,209,77,286
"27662",2019,0,106,0,106
"27662",2020,0,0,82,82
"27663",2013,0,0,58,58
"27663",2015,0,0,78,78
"27663",2017,0,193,77,270
"27663",2019,0,117,71,188
"27663",2020,0,0,104,104
"27664",2017,0,209,77,286
"27664",2019,0,0,106,106
"27665",2016,0,0,63,63
"27665",2017,0,209,77,286
"27665",2019,0,106,0,106
"27665",2020,0,0,82,82
"27666",2015,0,0,78,78
"27666",2019,0,0,60,60
"27666",2020,0,0,104,104
"27667",2017,0,16,93,109
"27667",2019,0,106,0,106
"27668",2015,0,0,78,78
"27668",2019,0,0,91,91
"27669",2016,0,0,63,63
"27669",2017,0,209,77,286
"27669",2019,0,106,0,106
"27669",2020,0,0,82,82
"27670",2017,0,209,77,286
"27670",2019,0,0,106,106
"27671",2016,0,0,63,63
"27671",2017,0,209,77,286
"27671",2019,0,106,0,106
"27671",2020,0,0,82,82
"27672",2017,0,209,77,286
"27672",2019,0,0,106,106
"27673",2013,0,0,58,58
"27673",2015,0,0,78,78
"27673",2016,0,0,77,77
"27673",2017,0,95,16,111
"27673",2019,0,0,106,106
"27673",2020,0,0,82,82
"27674",2015,0,0,78,78
"27674",2019,0,0,91,91
"27676",2015,0,0,78,78
"27676",2016,0,0,77,77
"27676",2017,0,95,16,111
"27676",2019,0,0,106,106
"27676",2020,0,0,82,82
"27677",2013,0,0,58,58
"27677",2015,0,0,78,78
"27677",2019,0,0,60,60
"27677",2020,0,0,104,104
"27678",2013,0,0,58,58
"27678",2015,0,0,78,78
"27678",2018,0,0,113,113
"27678",2020,0,0,49,49
"27679",2015,0,0,14,14
"27679",2017,0,16,0,16
"27679",2018,0,0,51,51
"27679",2020,0,0,22,22
"27680",2017,0,16,93,109
"27680",2019,0,106,0,106
"27681",2015,0,0,78,78
"27681",2017,0,95,0,95
"27681",2019,0,0,91,91
"27681",2020,0,0,55,55
"27682",2013,0,0,47,47
"27682",2015,0,0,29,29
"27682",2017,0,209,77,286
"27682",2019,0,0,91,91
"27682",2020,0,0,55,55
"27683",2015,0,0,78,78
"27683",2017,0,95,0,95
"27683",2019,0,0,91,91
"27683",2020,0,0,55,55
"27684",2015,0,0,78,78
"27684",2019,0,0,60,60
"27684",2020,0,0,104,104
"27685",2013,0,0,111,111
"27685",2015,0,0,78,78
"27685",2016,0,0,14,14
"27685",2017,0,16,0,16
"27685",2018,0,0,113,113
"27685",2019,0,106,0,106
"27685",2020,0,0,49,49
"27686",2016,0,0,63,63
"27686",2017,0,209,77,286
"27686",2019,0,106,0,106
"27686",2020,0,0,82,82
"27689",2015,0,0,78,78
"27689",2019,0,0,91,91
"27690",2013,0,0,47,47
"27690",2015,0,0,29,29
"27690",2017,0,209,77,286
"27690",2019,0,0,91,91
"27690",2020,0,0,55,55
"27691",2015,0,0,78,78
"27691",2017,0,95,0,95
"27691",2019,0,0,91,91
"27691",2020,0,0,55,55
"27692",2013,0,0,58,58
"27692",2015,0,0,78,78
"27692",2017,0,0,77,77
"27692",2019,0,0,22,22
"27692",2020,0,0,104,104
"27693",2013,0,0,58,58
"27693",2015,0,0,78,78
"27693",2018,0,0,113,113
"27693",2020,0,0,49,49
"27694",2015,0,0,78,78
"27694",2019,0,0,91,91
"27695",2016,0,0,63,63
"27695",2017,0,209,77,286
"27695",2019,0,106,0,106
"27695",2020,0,0,82,82
"27696",2015,0,0,78,78
"27696",2019,0,0,91,91
"27697",2013,0,0,58,58
"27697",2015,0,0,78,78
"27697",2016,0,0,77,77
"27697",2017,0,0,16,16
"27697",2019,0,0,106,106
"27697",2020,0,0,82,82
"27698",2016,0,0,63,63
"27698",2017,0,209,77,286
"27698",2019,0,106,0,106
"27698",2020,0,0,82,82
"27699",2016,0,0,63,63
"27699",2017,0,209,77,286
"27699",2019,0,106,0,106
"27699",2020,0,0,82,82
"27700",2013,0,0,58,58
"27700",2015,0,0,78,78
"27700",2019,0,117,71,188
"27700",2020,0,0,104,104
"27701",2013,0,0,58,58
"27701",2015,0,0,78,78
"27701",2016,0,0,77,77
"27701",2017,0,95,16,111
"27701",2019,0,0,106,106
"27701",2020,0,0,82,82
"28003",2013,0,0,57,57
"28006",2013,0,0,57,57
"28014",2013,0,0,57,57
"28019",2013,0,0,57,57
"28024",2013,0,0,57,57
"28025",2013,0,0,57,57
"28026",2013,0,0,57,57
"28028",2013,0,0,57,57
"28029",2013,0,0,57,57
"28045",2013,0,0,57,57
"28053",2013,0,0,57,57
"28054",2013,0,0,57,57
"28055",2013,0,0,57,57
"28058",2013,0,0,57,57
"28059",2013,0,0,57,57
"28075",2013,0,0,57,57
"28076",2013,0,0,57,57
"28082",2013,0,0,57,57
"28087",2013,0,0,57,57
"28089",2013,0,0,57,57
"28090",2013,0,0,57,57
"28092",2013,0,0,57,57
"28094",2013,0,0,57,57
"28095",2013,0,0,57,57
"28098",2013,0,0,57,57
"28100",2013,0,0,57,57
"28107",2013,0,0,57,57
"28108",2013,0,0,57,57
"28110",2013,0,0,57,57
"28111",2013,0,0,57,57
"28114",2013,0,0,57,57
"28117",2013,0,0,57,57
"28118",2013,0,0,57,57
"28120",2013,0,0,57,57
"28121",2013,0,0,57,57
"28124",2013,0,0,57,57
"28132",2013,0,0,57,57
"28134",2013,0,0,57,57
"28136",2013,0,0,57,57
"28143",2013,0,0,57,57
"28144",2013,0,0,57,57
"28146",2013,0,0,57,57
"28153",2013,0,0,57,57
"28155",2013,0,0,57,57
"28157",2013,0,0,57,57
"28158",2013,0,0,57,57
"28159",2013,0,0,57,57
"28164",2013,0,0,57,57
"28170",2013,0,0,57,57
"28171",2013,0,0,57,57
"28178",2013,0,0,57,57
"28183",2013,0,0,57,57
"28184",2013,0,0,57,57
"28189",2013,0,0,57,57
"28190",2013,0,0,57,57
"28197",2013,0,0,57,57
"28198",2013,0,0,57,57
"28199",2013,0,0,57,57
"28200",2013,0,0,57,57
"28201",2013,0,0,57,57
"28206",2013,0,0,57,57
"28209",2013,0,0,57,57
"28210",2013,0,0,57,57
"28212",2013,0,0,57,57
"28215",2013,0,0,57,57
"28216",2013,0,0,57,57
"28217",2013,0,0,57,57
"28218",2013,0,0,57,57
"28220",2013,0,0,57,57
"28221",2013,0,0,57,57
"28223",2013,0,0,57,57
"28226",2013,0,0,57,57
"28229",2013,0,0,57,57
"28231",2013,0,0,57,57
"28233",2013,0,0,57,57
"28239",2013,0,0,57,57
"28243",2013,0,0,57,57
"28248",2013,0,0,57,57
"28251",2013,0,0,57,57
"28267",2013,0,0,57,57
"28269",2013,0,0,57,57
"28274",2013,0,0,57,57
"28276",2013,0,0,57,57
"28280",2013,0,0,57,57
"28281",2013,0,0,57,57
"28283",2013,0,0,57,57
"28284",2013,0,0,57,57
"28287",2013,0,0,57,57
"28292",2013,0,0,57,57
"28296",2013,0,0,57,57
"28300",2013,0,0,57,57
"28303",2013,0,0,57,57
"28304",2013,0,0,57,57
"28308",2013,0,0,57,57
"28310",2013,0,0,57,57
"28312",2013,0,0,57,57
"28319",2013,0,0,57,57
"28323",2013,0,0,57,57
"28327",2013,0,0,57,57
"28329",2013,0,0,57,57
"28330",2013,0,0,57,57
"28332",2013,0,0,57,57
"28341",2013,0,0,57,57
"28342",2013,0,0,57,57
"28343",2013,0,0,57,57
"28346",2013,0,0,57,57
"28348",2013,0,0,57,57
"28351",2013,0,0,57,57
"28357",2013,0,0,57,57
"28359",2013,0,0,57,57
"28360",2013,0,0,57,57
"28367",2013,0,0,57,57
"28368",2013,0,0,57,57
"28369",2013,0,0,57,57
"28378",2013,0,0,57,57
"28382",2013,0,0,57,57
"28388",2013,0,0,57,57
"28389",2013,0,0,57,57
"28390",2013,0,0,57,57
"28391",2013,0,0,57,57
"28392",2013,0,0,57,57
"28394",2013,0,0,57,57
"28396",2013,0,0,57,57
"28400",2013,0,0,57,57
"28403",2013,0,0,57,57
"28404",2013,0,0,57,57
"28405",2013,0,0,57,57
"28410",2013,0,0,57,57
"28415",2013,0,0,57,57
"28426",2013,0,0,57,57
"2A001",2019,0,0,100,100
"2A004",2019,0,0,100,100
"2A006",2019,0,0,100,100
"2A008",2019,0,0,100,100
"2A011",2019,0,0,100,100
"2A014",2019,0,0,100,100
"2A017",2019,0,0,100,100
"2A018",2019,0,0,100,100
"2A019",2019,0,0,100,100
"2A021",2019,0,0,100,100
"2A022",2019,0,0,100,100
"2A024",2019,0,0,100,100
"2A026",2019,0,0,100,100
"2A027",2019,0,0,100,100
"2A028",2019,0,0,100,100
"2A031",2019,0,0,100,100
"2A032",2019,0,0,100,100
"2A035",2019,0,0,100,100
"2A038",2019,0,0,100,100
"2A040",2019,0,0,100,100
"2A041",2019,0,0,100,100
"2A048",2019,0,0,100,100
"2A056",2019,0,0,100,100
"2A060",2019,0,0,100,100
"2A061",2019,0,0,100,100
"2A062",2019,0,0,100,100
"2A064",2019,0,0,100,100
"2A065",2019,0,0,100,100
"2A066",2019,0,0,100,100
"2A070",2019,0,0,100,100
"2A071",2019,0,0,100,100
"2A085",2019,0,0,100,100
"2A089",2019,0,0,100,100
"2A090",2019,0,0,100,100
"2A091",2019,0,0,100,100
"2A092",2019,0,0,100,100
"2A094",2019,0,0,100,100
"2A098",2019,0,0,100,100
"2A099",2019,0,0,100,100
"2A100",2019,0,0,100,100
"2A103",2019,0,0,100,100
"2A104",2019,0,0,100,100
"2A108",2019,0,0,100,100
"2A114",2019,0,0,100,100
"2A115",2019,0,0,100,100
"2A117",2019,0,0,100,100
"2A118",2019,0,0,100,100
"2A119",2019,0,0,100,100
"2A127",2019,0,0,100,100
"2A128",2019,0,0,100,100
"2A129",2019,0,0,100,100
"2A130",2019,0,0,100,100
"2A131",2019,0,0,100,100
"2A132",2019,0,0,100,100
"2A133",2019,0,0,100,100
"2A139",2019,0,0,100,100
"2A141",2019,0,0,100,100
"2A142",2019,0,0,100,100
"2A144",2019,0,0,100,100
"2A146",2019,0,0,100,100
"2A154",2019,0,0,100,100
"2A158",2019,0,0,100,100
"2A160",2019,0,0,100,100
"2A163",2019,0,0,100,100
"2A174",2019,0,0,100,100
"2A181",2019,0,0,100,100
"2A186",2019,0,0,100,100
"2A189",2019,0,0,100,100
"2A191",2019,0,0,100,100
"2A196",2019,0,0,100,100
"2A197",2019,0,0,100,100
"2A198",2019,0,0,100,100
"2A200",2019,0,0,100,100
"2A203",2019,0,0,100,100
"2A204",2019,0,0,100,100
"2A209",2019,0,0,100,100
"2A211",2019,0,0,100,100
"2A212",2019,0,0,100,100
"2A215",2019,0,0,100,100
"2A228",2019,0,0,100,100
"2A232",2019,0,0,100,100
"2A240",2019,0,0,100,100
"2A247",2019,0,0,100,100
"2A249",2019,0,0,100,100
"2A253",2019,0,0,100,100
"2A254",2019,0,0,100,100
"2A258",2019,0,0,100,100
"2A259",2019,0,0,100,100
"2A262",2019,0,0,100,100
"2A266",2019,0,0,100,100
"2A268",2019,0,0,100,100
"2A269",2019,0,0,100,100
"2A270",2019,0,0,100,100
"2A271",2019,0,0,100,100
"2A272",2019,0,0,100,100
"2A276",2019,0,0,100,100
"2A278",2019,0,0,100,100
"2A279",2019,0,0,100,100
"2A282",2019,0,0,100,100
"2A284",2019,0,0,100,100
"2A285",2019,0,0,100,100
"2A288",2019,0,0,100,100
"2A295",2019,0,0,100,100
"2A300",2019,0,0,100,100
"2A308",2019,0,0,100,100
"2A310",2019,0,0,100,100
"2A312",2019,0,0,100,100
"2A322",2019,0,0,100,100
"2A323",2019,0,0,100,100
"2A324",2019,0,0,100,100
"2A326",2019,0,0,100,100
"2A330",2019,0,0,100,100
"2A331",2019,0,0,100,100
"2A336",2019,0,0,100,100
"2A345",2019,0,0,100,100
"2A348",2019,0,0,100,100
"2A349",2019,0,0,100,100
"2A351",2019,0,0,100,100
"2A357",2019,0,0,100,100
"2A358",2019,0,0,100,100
"2A359",2019,0,0,100,100
"2A360",2019,0,0,100,100
"2A362",2019,0,0,100,100
"2A363",2019,0,0,100,100
"2B002",2016,0,75,75,150
"2B002",2017,0,45,28,73
"2B002",2018,0,264,264,528
"2B002",2019,0,0,93,93
"2B002",2020,0,38,38,76
"2B003",2016,0,75,75,150
"2B003",2017,0,45,45,90
"2B003",2018,0,264,264,528
"2B003",2019,0,0,93,93
"2B003",2020,0,38,38,76
"2B005",2016,0,75,75,150
"2B005",2017,0,45,45,90
"2B005",2018,0,264,264,528
"2B005",2019,0,0,93,93
"2B005",2020,0,38,38,76
"2B007",2016,0,75,75,150
"2B007",2017,0,45,28,73
"2B007",2018,0,264,264,528
"2B007",2019,0,0,93,93
"2B007",2020,0,38,38,76
"2B009",2016,0,75,75,150
"2B009",2017,0,45,28,73
"2B009",2018,0,264,264,528
"2B009",2019,0,0,93,93
"2B009",2020,0,38,38,76
"2B010",2016,0,75,75,150
"2B010",2017,0,45,28,73
"2B010",2018,0,264,264,528
"2B010",2019,0,0,93,93
"2B010",2020,0,38,38,76
"2B012",2016,0,75,75,150
"2B012",2017,0,45,45,90
"2B012",2018,0,264,264,528
"2B012",2019,0,0,93,93
"2B012",2020,0,38,38,76
"2B013",2016,0,75,75,150
"2B013",2017,0,45,45,90
"2B013",2018,0,264,264,528
"2B013",2019,0,0,93,93
"2B013",2020,0,38,38,76
"2B015",2016,0,75,75,150
"2B015",2017,0,45,28,73
"2B015",2018,0,264,264,528
"2B015",2019,0,0,93,93
"2B015",2020,0,38,38,76
"2B016",2016,0,75,75,150
"2B016",2017,0,45,28,73
"2B016",2018,0,264,264,528
"2B016",2019,0,0,93,93
"2B016",2020,0,38,38,76
"2B020",2016,0,75,75,150
"2B020",2017,0,45,28,73
"2B020",2018,0,264,264,528
"2B020",2019,0,0,93,93
"2B020",2020,0,38,38,76
"2B023",2016,0,75,75,150
"2B023",2017,0,45,28,73
"2B023",2018,0,264,264,528
"2B023",2019,0,0,93,93
"2B023",2020,0,38,38,76
"2B025",2016,0,75,75,150
"2B025",2017,0,45,28,73
"2B025",2018,0,264,264,528
"2B025",2019,0,0,93,93
"2B025",2020,0,38,38,76
"2B029",2016,0,75,75,150
"2B029",2017,0,45,28,73
"2B029",2018,0,264,264,528
"2B029",2019,0,0,93,93
"2B029",2020,0,38,38,76
"2B030",2016,0,75,75,150
"2B030",2017,0,45,45,90
"2B030",2018,0,264,264,528
"2B030",2019,0,0,93,93
"2B030",2020,0,38,38,76
"2B033",2016,0,75,75,150
"2B033",2017,0,45,28,73
"2B033",2018,0,264,264,528
"2B033",2019,0,0,93,93
"2B033",2020,0,38,38,76
"2B034",2016,0,75,75,150
"2B034",2017,0,45,28,73
"2B034",2018,0,264,264,528
"2B034",2019,0,0,93,93
"2B034",2020,0,38,38,76
"2B036",2016,0,75,75,150
"2B036",2017,0,45,45,90
"2B036",2018,0,264,264,528
"2B036",2019,0,0,93,93
"2B036",2020,0,38,38,76
"2B037",2016,0,75,75,150
"2B037",2017,0,45,28,73
"2B037",2018,0,264,264,528
"2B037",2019,0,0,93,93
"2B037",2020,0,38,38,76
"2B039",2016,0,75,75,150
"2B039",2017,0,45,28,73
"2B039",2018,0,264,264,528
"2B039",2019,0,0,93,93
"2B039",2020,0,38,38,76
"2B042",2016,0,75,75,150
"2B042",2017,0,45,28,73
"2B042",2018,0,264,264,528
"2B042",2019,0,0,93,93
"2B042",2020,0,38,38,76
"2B043",2016,0,75,75,150
"2B043",2017,0,45,45,90
"2B043",2018,0,264,264,528
"2B043",2019,0,0,93,93
"2B043",2020,0,38,38,76
"2B045",2016,0,75,75,150
"2B045",2017,0,45,28,73
"2B045",2018,0,264,264,528
"2B045",2019,0,0,93,93
"2B045",2020,0,38,38,76
"2B046",2016,0,75,75,150
"2B046",2017,0,45,45,90
"2B046",2018,0,264,264,528
"2B046",2019,0,0,93,93
"2B046",2020,0,38,38,76
"2B047",2016,0,75,75,150
"2B047",2017,0,45,45,90
"2B047",2018,0,264,264,528
"2B047",2019,0,0,93,93
"2B047",2020,0,38,38,76
"2B049",2016,0,75,75,150
"2B049",2017,0,45,28,73
"2B049",2018,0,264,264,528
"2B049",2019,0,0,93,93
"2B049",2020,0,38,38,76
"2B050",2016,0,75,75,150
"2B050",2017,0,45,28,73
"2B050",2018,0,264,264,528
"2B050",2019,0,0,93,93
"2B050",2020,0,38,38,76
"2B051",2016,0,75,75,150
"2B051",2017,0,45,28,73
"2B051",2018,0,264,264,528
"2B051",2019,0,0,93,93
"2B051",2020,0,38,38,76
"2B052",2016,0,75,75,150
"2B052",2017,0,45,28,73
"2B052",2018,0,264,264,528
"2B052",2019,0,0,93,93
"2B052",2020,0,38,38,76
"2B053",2016,0,75,75,150
"2B053",2017,0,45,28,73
"2B053",2018,0,264,264,528
"2B053",2019,0,0,93,93
"2B053",2020,0,38,38,76
"2B054",2016,0,75,75,150
"2B054",2017,0,45,28,73
"2B054",2018,0,264,264,528
"2B054",2019,0,0,93,93
"2B054",2020,0,38,38,76
"2B055",2016,0,75,75,150
"2B055",2017,0,45,28,73
"2B055",2018,0,264,264,528
"2B055",2019,0,0,93,93
"2B055",2020,0,38,38,76
"2B057",2016,0,75,75,150
"2B057",2017,0,45,28,73
"2B057",2018,0,264,264,528
"2B057",2019,0,0,93,93
"2B057",2020,0,38,38,76
"2B058",2016,0,75,75,150
"2B058",2017,0,45,45,90
"2B058",2018,0,264,264,528
"2B058",2019,0,0,93,93
"2B058",2020,0,38,38,76
"2B059",2016,0,75,75,150
"2B059",2017,0,45,45,90
"2B059",2018,0,264,264,528
"2B059",2019,0,0,93,93
"2B059",2020,0,38,38,76
"2B063",2016,0,75,75,150
"2B063",2017,0,45,28,73
"2B063",2018,0,264,264,528
"2B063",2019,0,0,93,93
"2B063",2020,0,38,38,76
"2B067",2016,0,75,75,150
"2B067",2017,0,45,28,73
"2B067",2018,0,264,264,528
"2B067",2019,0,0,93,93
"2B067",2020,0,38,38,76
"2B068",2016,0,75,75,150
"2B068",2017,0,45,28,73
"2B068",2018,0,264,264,528
"2B068",2019,0,0,93,93
"2B068",2020,0,38,38,76
"2B069",2016,0,75,75,150
"2B069",2017,0,45,28,73
"2B069",2018,0,264,264,528
"2B069",2019,0,0,93,93
"2B069",2020,0,38,38,76
"2B072",2016,0,75,75,150
"2B072",2017,0,45,28,73
"2B072",2018,0,264,264,528
"2B072",2019,0,0,93,93
"2B072",2020,0,38,38,76
"2B073",2016,0,75,75,150
"2B073",2017,0,45,45,90
"2B073",2018,0,264,264,528
"2B073",2019,0,0,93,93
"2B073",2020,0,38,38,76
"2B074",2016,0,75,75,150
"2B074",2017,0,45,45,90
"2B074",2018,0,264,264,528
"2B074",2019,0,0,93,93
"2B074",2020,0,38,38,76
"2B075",2016,0,75,75,150
"2B075",2017,0,45,28,73
"2B075",2018,0,264,264,528
"2B075",2019,0,0,93,93
"2B075",2020,0,38,38,76
"2B077",2016,0,75,75,150
"2B077",2017,0,45,28,73
"2B077",2018,0,264,264,528
"2B077",2019,0,0,93,93
"2B077",2020,0,38,38,76
"2B078",2016,0,75,75,150
"2B078",2017,0,45,45,90
"2B078",2018,0,264,264,528
"2B078",2019,0,0,93,93
"2B078",2020,0,38,38,76
"2B079",2016,0,75,75,150
"2B079",2017,0,45,28,73
"2B079",2018,0,264,264,528
"2B079",2019,0,0,93,93
"2B079",2020,0,38,38,76
"2B080",2016,0,75,75,150
"2B080",2017,0,45,28,73
"2B080",2018,0,264,264,528
"2B080",2019,0,0,93,93
"2B080",2020,0,38,38,76
"2B081",2016,0,75,75,150
"2B081",2017,0,45,45,90
"2B081",2018,0,264,264,528
"2B081",2019,0,0,93,93
"2B081",2020,0,38,38,76
"2B082",2016,0,75,75,150
"2B082",2017,0,45,28,73
"2B082",2018,0,264,264,528
"2B082",2019,0,0,93,93
"2B082",2020,0,38,38,76
"2B083",2016,0,75,75,150
"2B083",2017,0,45,45,90
"2B083",2018,0,264,264,528
"2B083",2019,0,0,93,93
"2B083",2020,0,38,38,76
"2B084",2016,0,75,75,150
"2B084",2017,0,45,28,73
"2B084",2018,0,264,264,528
"2B084",2019,0,0,93,93
"2B084",2020,0,38,38,76
"2B086",2016,0,75,75,150
"2B086",2017,0,45,45,90
"2B086",2018,0,264,264,528
"2B086",2019,0,0,93,93
"2B086",2020,0,38,38,76
"2B087",2016,0,75,75,150
"2B087",2017,0,45,28,73
"2B087",2018,0,264,264,528
"2B087",2019,0,0,93,93
"2B087",2020,0,38,38,76
"2B088",2016,0,75,75,150
"2B088",2017,0,45,28,73
"2B088",2018,0,264,264,528
"2B088",2019,0,0,93,93
"2B088",2020,0,38,38,76
"2B093",2016,0,75,75,150
"2B093",2017,0,45,28,73
"2B093",2018,0,264,264,528
"2B093",2019,0,0,93,93
"2B093",2020,0,38,38,76
"2B095",2016,0,75,75,150
"2B095",2017,0,45,45,90
"2B095",2018,0,264,264,528
"2B095",2019,0,0,93,93
"2B095",2020,0,38,38,76
"2B096",2016,0,75,75,150
"2B096",2017,0,45,45,90
"2B096",2018,0,264,264,528
"2B096",2019,0,0,93,93
"2B096",2020,0,38,38,76
"2B097",2016,0,75,75,150
"2B097",2017,0,45,28,73
"2B097",2018,0,264,264,528
"2B097",2019,0,0,93,93
"2B097",2020,0,38,38,76
"2B101",2016,0,75,75,150
"2B101",2017,0,45,28,73
"2B101",2018,0,264,264,528
"2B101",2019,0,0,93,93
"2B101",2020,0,38,38,76
"2B102",2016,0,75,75,150
"2B102",2017,0,45,28,73
"2B102",2018,0,264,264,528
"2B102",2019,0,0,93,93
"2B102",2020,0,38,38,76
"2B105",2016,0,75,75,150
"2B105",2017,0,45,45,90
"2B105",2018,0,264,264,528
"2B105",2019,0,0,93,93
"2B105",2020,0,38,38,76
"2B106",2016,0,75,75,150
"2B106",2017,0,45,45,90
"2B106",2018,0,264,264,528
"2B106",2019,0,0,93,93
"2B106",2020,0,38,38,76
"2B107",2016,0,75,75,150
"2B107",2017,0,45,45,90
"2B107",2018,0,264,264,528
"2B107",2019,0,0,93,93
"2B107",2020,0,38,38,76
"2B109",2016,0,75,75,150
"2B109",2017,0,45,45,90
"2B109",2018,0,264,264,528
"2B109",2019,0,0,93,93
"2B109",2020,0,38,38,76
"2B110",2016,0,75,75,150
"2B110",2017,0,45,45,90
"2B110",2018,0,264,264,528
"2B110",2019,0,0,93,93
"2B110",2020,0,38,38,76
"2B111",2016,0,75,75,150
"2B111",2017,0,45,28,73
"2B111",2018,0,264,264,528
"2B111",2019,0,0,93,93
"2B111",2020,0,38,38,76
"2B112",2016,0,75,75,150
"2B112",2017,0,45,28,73
"2B112",2018,0,264,264,528
"2B112",2019,0,0,93,93
"2B112",2020,0,38,38,76
"2B113",2016,0,75,75,150
"2B113",2017,0,45,28,73
"2B113",2018,0,264,264,528
"2B113",2019,0,0,93,93
"2B113",2020,0,38,38,76
"2B116",2016,0,75,75,150
"2B116",2017,0,45,45,90
"2B116",2018,0,264,264,528
"2B116",2019,0,0,93,93
"2B116",2020,0,38,38,76
"2B120",2016,0,75,75,150
"2B120",2017,0,45,28,73
"2B120",2018,0,264,264,528
"2B120",2019,0,0,93,93
"2B120",2020,0,38,38,76
"2B121",2016,0,75,75,150
"2B121",2017,0,45,28,73
"2B121",2018,0,264,264,528
"2B121",2019,0,0,93,93
"2B121",2020,0,38,38,76
"2B122",2016,0,75,75,150
"2B122",2017,0,45,28,73
"2B122",2018,0,264,264,528
"2B122",2019,0,0,93,93
"2B122",2020,0,38,38,76
"2B123",2016,0,75,75,150
"2B123",2017,0,45,28,73
"2B123",2018,0,264,264,528
"2B123",2019,0,0,93,93
"2B123",2020,0,38,38,76
"2B124",2016,0,75,75,150
"2B124",2017,0,45,28,73
"2B124",2018,0,264,264,528
"2B124",2019,0,0,93,93
"2B124",2020,0,38,38,76
"2B125",2016,0,75,75,150
"2B125",2017,0,45,28,73
"2B125",2018,0,264,264,528
"2B125",2019,0,0,93,93
"2B125",2020,0,38,38,76
"2B126",2016,0,75,75,150
"2B126",2017,0,45,28,73
"2B126",2018,0,264,264,528
"2B126",2019,0,0,93,93
"2B126",2020,0,38,38,76
"2B134",2016,0,75,75,150
"2B134",2017,0,45,28,73
"2B134",2018,0,264,264,528
"2B134",2019,0,0,93,93
"2B134",2020,0,38,38,76
"2B135",2016,0,75,75,150
"2B135",2017,0,45,28,73
"2B135",2018,0,264,264,528
"2B135",2019,0,0,93,93
"2B135",2020,0,38,38,76
"2B136",2016,0,75,75,150
"2B136",2017,0,45,28,73
"2B136",2018,0,264,264,528
"2B136",2019,0,0,93,93
"2B136",2020,0,38,38,76
"2B137",2016,0,75,75,150
"2B137",2017,0,45,45,90
"2B137",2018,0,264,264,528
"2B137",2019,0,0,93,93
"2B137",2020,0,38,38,76
"2B138",2016,0,75,75,150
"2B138",2017,0,45,28,73
"2B138",2018,0,264,264,528
"2B138",2019,0,0,93,93
"2B138",2020,0,38,38,76
"2B140",2016,0,75,75,150
"2B140",2017,0,45,45,90
"2B140",2018,0,264,264,528
"2B140",2019,0,0,93,93
"2B140",2020,0,38,38,76
"2B143",2016,0,75,75,150
"2B143",2017,0,45,28,73
"2B143",2018,0,264,264,528
"2B143",2019,0,0,93,93
"2B143",2020,0,38,38,76
"2B145",2016,0,75,75,150
"2B145",2017,0,45,28,73
"2B145",2018,0,264,264,528
"2B145",2019,0,0,93,93
"2B145",2020,0,38,38,76
"2B147",2016,0,75,75,150
"2B147",2017,0,45,45,90
"2B147",2018,0,264,264,528
"2B147",2019,0,0,93,93
"2B147",2020,0,38,38,76
"2B148",2016,0,75,75,150
"2B148",2017,0,45,28,73
"2B148",2018,0,264,264,528
"2B148",2019,0,0,93,93
"2B148",2020,0,38,38,76
"2B149",2016,0,75,75,150
"2B149",2017,0,45,28,73
"2B149",2018,0,264,264,528
"2B149",2019,0,0,93,93
"2B149",2020,0,38,38,76
"2B150",2016,0,75,75,150
"2B150",2017,0,45,28,73
"2B150",2018,0,264,264,528
"2B150",2019,0,0,93,93
"2B150",2020,0,38,38,76
"2B152",2016,0,75,75,150
"2B152",2017,0,45,45,90
"2B152",2018,0,264,264,528
"2B152",2019,0,0,93,93
"2B152",2020,0,38,38,76
"2B153",2016,0,75,75,150
"2B153",2017,0,45,28,73
"2B153",2018,0,264,264,528
"2B153",2019,0,0,93,93
"2B153",2020,0,38,38,76
"2B155",2016,0,75,75,150
"2B155",2017,0,45,28,73
"2B155",2018,0,264,264,528
"2B155",2019,0,0,93,93
"2B155",2020,0,38,38,76
"2B156",2016,0,75,75,150
"2B156",2017,0,45,28,73
"2B156",2018,0,264,264,528
"2B156",2019,0,0,93,93
"2B156",2020,0,38,38,76
"2B157",2016,0,75,75,150
"2B157",2017,0,45,28,73
"2B157",2018,0,264,264,528
"2B157",2019,0,0,93,93
"2B157",2020,0,38,38,76
"2B159",2016,0,75,75,150
"2B159",2017,0,45,45,90
"2B159",2018,0,264,264,528
"2B159",2019,0,0,93,93
"2B159",2020,0,38,38,76
"2B161",2016,0,75,75,150
"2B161",2017,0,45,28,73
"2B161",2018,0,264,264,528
"2B161",2019,0,0,93,93
"2B161",2020,0,38,38,76
"2B162",2016,0,75,75,150
"2B162",2017,0,45,45,90
"2B162",2018,0,264,264,528
"2B162",2019,0,0,93,93
"2B162",2020,0,38,38,76
"2B164",2016,0,75,75,150
"2B164",2017,0,45,28,73
"2B164",2018,0,264,264,528
"2B164",2019,0,0,93,93
"2B164",2020,0,38,38,76
"2B165",2016,0,75,75,150
"2B165",2017,0,45,28,73
"2B165",2018,0,264,264,528
"2B165",2019,0,0,93,93
"2B165",2020,0,38,38,76
"2B166",2016,0,75,75,150
"2B166",2017,0,45,28,73
"2B166",2018,0,264,264,528
"2B166",2019,0,0,93,93
"2B166",2020,0,38,38,76
"2B167",2016,0,75,75,150
"2B167",2017,0,45,28,73
"2B167",2018,0,264,264,528
"2B167",2019,0,0,93,93
"2B167",2020,0,38,38,76
"2B168",2016,0,75,75,150
"2B168",2017,0,45,28,73
"2B168",2018,0,264,264,528
"2B168",2019,0,0,93,93
"2B168",2020,0,38,38,76
"2B169",2016,0,75,75,150
"2B169",2017,0,45,28,73
"2B169",2018,0,264,264,528
"2B169",2019,0,0,93,93
"2B169",2020,0,38,38,76
"2B170",2016,0,75,75,150
"2B170",2017,0,45,45,90
"2B170",2018,0,264,264,528
"2B170",2019,0,0,93,93
"2B170",2020,0,38,38,76
"2B171",2016,0,75,75,150
"2B171",2017,0,45,45,90
"2B171",2018,0,264,264,528
"2B171",2019,0,0,93,93
"2B171",2020,0,38,38,76
"2B172",2016,0,75,75,150
"2B172",2017,0,45,28,73
"2B172",2018,0,264,264,528
"2B172",2019,0,0,93,93
"2B172",2020,0,38,38,76
"2B173",2016,0,75,75,150
"2B173",2017,0,45,28,73
"2B173",2018,0,264,264,528
"2B173",2019,0,0,93,93
"2B173",2020,0,38,38,76
"2B175",2016,0,75,75,150
"2B175",2017,0,45,28,73
"2B175",2018,0,264,264,528
"2B175",2019,0,0,93,93
"2B175",2020,0,38,38,76
"2B176",2016,0,75,75,150
"2B176",2017,0,45,28,73
"2B176",2018,0,264,264,528
"2B176",2019,0,0,93,93
"2B176",2020,0,38,38,76
"2B177",2016,0,75,75,150
"2B177",2017,0,45,45,90
"2B177",2018,0,264,264,528
"2B177",2019,0,0,93,93
"2B177",2020,0,38,38,76
"2B178",2016,0,75,75,150
"2B178",2017,0,45,45,90
"2B178",2018,0,264,264,528
"2B178",2019,0,0,93,93
"2B178",2020,0,38,38,76
"2B179",2016,0,75,75,150
"2B179",2017,0,45,28,73
"2B179",2018,0,264,264,528
"2B179",2019,0,0,93,93
"2B179",2020,0,38,38,76
"2B180",2016,0,75,75,150
"2B180",2017,0,45,28,73
"2B180",2018,0,264,264,528
"2B180",2019,0,0,93,93
"2B180",2020,0,38,38,76
"2B182",2016,0,75,75,150
"2B182",2017,0,45,28,73
"2B182",2018,0,264,264,528
"2B182",2019,0,0,93,93
"2B182",2020,0,38,38,76
"2B183",2016,0,75,75,150
"2B183",2017,0,45,45,90
"2B183",2018,0,264,264,528
"2B183",2019,0,0,93,93
"2B183",2020,0,38,38,76
"2B184",2016,0,75,75,150
"2B184",2017,0,45,45,90
"2B184",2018,0,264,264,528
"2B184",2019,0,0,93,93
"2B184",2020,0,38,38,76
"2B185",2016,0,75,75,150
"2B185",2017,0,45,28,73
"2B185",2018,0,264,264,528
"2B185",2019,0,0,93,93
"2B185",2020,0,38,38,76
"2B187",2016,0,75,75,150
"2B187",2017,0,45,45,90
"2B187",2018,0,264,264,528
"2B187",2019,0,0,93,93
"2B187",2020,0,38,38,76
"2B188",2016,0,75,75,150
"2B188",2017,0,45,28,73
"2B188",2018,0,264,264,528
"2B188",2019,0,0,93,93
"2B188",2020,0,38,38,76
"2B190",2016,0,75,75,150
"2B190",2017,0,45,28,73
"2B190",2018,0,264,264,528
"2B190",2019,0,0,93,93
"2B190",2020,0,38,38,76
"2B192",2016,0,75,75,150
"2B192",2017,0,45,28,73
"2B192",2018,0,264,264,528
"2B192",2019,0,0,93,93
"2B192",2020,0,38,38,76
"2B193",2016,0,75,75,150
"2B193",2017,0,45,45,90
"2B193",2018,0,264,264,528
"2B193",2019,0,0,93,93
"2B193",2020,0,38,38,76
"2B194",2016,0,75,75,150
"2B194",2017,0,45,28,73
"2B194",2018,0,264,264,528
"2B194",2019,0,0,93,93
"2B194",2020,0,38,38,76
"2B195",2016,0,75,75,150
"2B195",2017,0,45,28,73
"2B195",2018,0,264,264,528
"2B195",2019,0,0,93,93
"2B195",2020,0,38,38,76
"2B199",2016,0,75,75,150
"2B199",2017,0,45,28,73
"2B199",2018,0,264,264,528
"2B199",2019,0,0,93,93
"2B199",2020,0,38,38,76
"2B201",2016,0,75,75,150
"2B201",2017,0,45,28,73
"2B201",2018,0,264,264,528
"2B201",2019,0,0,93,93
"2B201",2020,0,38,38,76
"2B202",2016,0,75,75,150
"2B202",2017,0,45,28,73
"2B202",2018,0,264,264,528
"2B202",2019,0,0,93,93
"2B202",2020,0,38,38,76
"2B205",2016,0,75,75,150
"2B205",2017,0,45,45,90
"2B205",2018,0,264,264,528
"2B205",2019,0,0,93,93
"2B205",2020,0,38,38,76
"2B206",2016,0,75,75,150
"2B206",2017,0,45,28,73
"2B206",2018,0,264,264,528
"2B206",2019,0,0,93,93
"2B206",2020,0,38,38,76
"2B207",2016,0,75,75,150
"2B207",2017,0,45,28,73
"2B207",2018,0,264,264,528
"2B207",2019,0,0,93,93
"2B207",2020,0,38,38,76
"2B208",2016,0,75,75,150
"2B208",2017,0,45,28,73
"2B208",2018,0,264,264,528
"2B208",2019,0,0,93,93
"2B208",2020,0,38,38,76
"2B210",2016,0,75,75,150
"2B210",2017,0,45,28,73
"2B210",2018,0,264,264,528
"2B210",2019,0,0,93,93
"2B210",2020,0,38,38,76
"2B213",2016,0,75,75,150
"2B213",2017,0,45,28,73
"2B213",2018,0,264,264,528
"2B213",2019,0,0,93,93
"2B213",2020,0,38,38,76
"2B214",2016,0,75,75,150
"2B214",2017,0,45,28,73
"2B214",2018,0,264,264,528
"2B214",2019,0,0,93,93
"2B214",2020,0,38,38,76
"2B216",2016,0,75,75,150
"2B216",2017,0,45,28,73
"2B216",2018,0,264,264,528
"2B216",2019,0,0,93,93
"2B216",2020,0,38,38,76
"2B217",2016,0,75,75,150
"2B217",2017,0,45,28,73
"2B217",2018,0,264,264,528
"2B217",2019,0,0,93,93
"2B217",2020,0,38,38,76
"2B218",2016,0,75,75,150
"2B218",2017,0,45,28,73
"2B218",2018,0,264,264,528
"2B218",2019,0,0,93,93
"2B218",2020,0,38,38,76
"2B219",2016,0,75,75,150
"2B219",2017,0,45,28,73
"2B219",2018,0,264,264,528
"2B219",2019,0,0,93,93
"2B219",2020,0,38,38,76
"2B220",2016,0,75,75,150
"2B220",2017,0,45,45,90
"2B220",2018,0,264,264,528
"2B220",2019,0,0,93,93
"2B220",2020,0,38,38,76
"2B221",2016,0,75,75,150
"2B221",2017,0,45,28,73
"2B221",2018,0,264,264,528
"2B221",2019,0,0,93,93
"2B221",2020,0,38,38,76
"2B222",2016,0,75,75,150
"2B222",2017,0,45,28,73
"2B222",2018,0,264,264,528
"2B222",2019,0,0,93,93
"2B222",2020,0,38,38,76
"2B223",2016,0,75,75,150
"2B223",2017,0,45,28,73
"2B223",2018,0,264,264,528
"2B223",2019,0,0,93,93
"2B223",2020,0,38,38,76
"2B224",2016,0,75,75,150
"2B224",2017,0,45,45,90
"2B224",2018,0,264,264,528
"2B224",2019,0,0,93,93
"2B224",2020,0,38,38,76
"2B225",2016,0,75,75,150
"2B225",2017,0,45,28,73
"2B225",2018,0,264,264,528
"2B225",2019,0,0,93,93
"2B225",2020,0,38,38,76
"2B226",2016,0,75,75,150
"2B226",2017,0,45,28,73
"2B226",2018,0,264,264,528
"2B226",2019,0,0,93,93
"2B226",2020,0,38,38,76
"2B227",2016,0,75,75,150
"2B227",2017,0,45,28,73
"2B227",2018,0,264,264,528
"2B227",2019,0,0,93,93
"2B227",2020,0,38,38,76
"2B229",2016,0,75,75,150
"2B229",2017,0,45,28,73
"2B229",2018,0,264,264,528
"2B229",2019,0,0,93,93
"2B229",2020,0,38,38,76
"2B230",2016,0,75,75,150
"2B230",2017,0,45,45,90
"2B230",2018,0,264,264,528
"2B230",2019,0,0,93,93
"2B230",2020,0,38,38,76
"2B231",2016,0,75,75,150
"2B231",2017,0,45,28,73
"2B231",2018,0,264,264,528
"2B231",2019,0,0,93,93
"2B231",2020,0,38,38,76
"2B233",2016,0,75,75,150
"2B233",2017,0,45,45,90
"2B233",2018,0,264,264,528
"2B233",2019,0,0,93,93
"2B233",2020,0,38,38,76
"2B234",2016,0,75,75,150
"2B234",2017,0,45,28,73
"2B234",2018,0,264,264,528
"2B234",2019,0,0,93,93
"2B234",2020,0,38,38,76
"2B235",2016,0,75,75,150
"2B235",2017,0,45,28,73
"2B235",2018,0,264,264,528
"2B235",2019,0,0,93,93
"2B235",2020,0,38,38,76
"2B236",2016,0,75,75,150
"2B236",2017,0,45,28,73
"2B236",2018,0,264,264,528
"2B236",2019,0,0,93,93
"2B236",2020,0,38,38,76
"2B238",2016,0,75,75,150
"2B238",2017,0,45,45,90
"2B238",2018,0,264,264,528
"2B238",2019,0,0,93,93
"2B238",2020,0,38,38,76
"2B239",2016,0,75,75,150
"2B239",2017,0,45,28,73
"2B239",2018,0,264,264,528
"2B239",2019,0,0,93,93
"2B239",2020,0,38,38,76
"2B241",2016,0,75,75,150
"2B241",2017,0,45,28,73
"2B241",2018,0,264,264,528
"2B241",2019,0,0,93,93
"2B241",2020,0,38,38,76
"2B242",2016,0,75,75,150
"2B242",2017,0,45,28,73
"2B242",2018,0,264,264,528
"2B242",2019,0,0,93,93
"2B242",2020,0,38,38,76
"2B243",2016,0,75,75,150
"2B243",2017,0,45,28,73
"2B243",2018,0,264,264,528
"2B243",2019,0,0,93,93
"2B243",2020,0,38,38,76
"2B244",2016,0,75,75,150
"2B244",2017,0,45,45,90
"2B244",2018,0,264,264,528
"2B244",2019,0,0,93,93
"2B244",2020,0,38,38,76
"2B245",2016,0,75,75,150
"2B245",2017,0,45,28,73
"2B245",2018,0,264,264,528
"2B245",2019,0,0,93,93
"2B245",2020,0,38,38,76
"2B246",2016,0,75,75,150
"2B246",2017,0,45,28,73
"2B246",2018,0,264,264,528
"2B246",2019,0,0,93,93
"2B246",2020,0,38,38,76
"2B248",2016,0,75,75,150
"2B248",2017,0,45,45,90
"2B248",2018,0,264,264,528
"2B248",2019,0,0,93,93
"2B248",2020,0,38,38,76
"2B250",2016,0,75,75,150
"2B250",2017,0,45,28,73
"2B250",2018,0,264,264,528
"2B250",2019,0,0,93,93
"2B250",2020,0,38,38,76
"2B251",2016,0,75,75,150
"2B251",2017,0,45,28,73
"2B251",2018,0,264,264,528
"2B251",2019,0,0,93,93
"2B251",2020,0,38,38,76
"2B252",2016,0,75,75,150
"2B252",2017,0,45,28,73
"2B252",2018,0,264,264,528
"2B252",2019,0,0,93,93
"2B252",2020,0,38,38,76
"2B255",2016,0,75,75,150
"2B255",2017,0,45,28,73
"2B255",2018,0,264,264,528
"2B255",2019,0,0,93,93
"2B255",2020,0,38,38,76
"2B256",2016,0,75,75,150
"2B256",2017,0,45,28,73
"2B256",2018,0,264,264,528
"2B256",2019,0,0,93,93
"2B256",2020,0,38,38,76
"2B257",2016,0,75,75,150
"2B257",2017,0,45,45,90
"2B257",2018,0,264,264,528
"2B257",2019,0,0,93,93
"2B257",2020,0,38,38,76
"2B260",2016,0,75,75,150
"2B260",2017,0,45,45,90
"2B260",2018,0,264,264,528
"2B260",2019,0,0,93,93
"2B260",2020,0,38,38,76
"2B261",2016,0,75,75,150
"2B261",2017,0,45,45,90
"2B261",2018,0,264,264,528
"2B261",2019,0,0,93,93
"2B261",2020,0,38,38,76
"2B263",2016,0,75,75,150
"2B263",2017,0,45,45,90
"2B263",2018,0,264,264,528
"2B263",2019,0,0,93,93
"2B263",2020,0,38,38,76
"2B264",2016,0,75,75,150
"2B264",2017,0,45,45,90
"2B264",2018,0,264,264,528
"2B264",2019,0,0,93,93
"2B264",2020,0,38,38,76
"2B265",2016,0,75,75,150
"2B265",2017,0,45,28,73
"2B265",2018,0,264,264,528
"2B265",2019,0,0,93,93
"2B265",2020,0,38,38,76
"2B267",2016,0,75,75,150
"2B267",2017,0,45,28,73
"2B267",2018,0,264,264,528
"2B267",2019,0,0,93,93
"2B267",2020,0,38,38,76
"2B273",2016,0,75,75,150
"2B273",2017,0,45,28,73
"2B273",2018,0,264,264,528
"2B273",2019,0,0,93,93
"2B273",2020,0,38,38,76
"2B274",2016,0,75,75,150
"2B274",2017,0,45,28,73
"2B274",2018,0,264,264,528
"2B274",2019,0,0,93,93
"2B274",2020,0,38,38,76
"2B275",2016,0,75,75,150
"2B275",2017,0,45,45,90
"2B275",2018,0,264,264,528
"2B275",2019,0,0,93,93
"2B275",2020,0,38,38,76
"2B277",2016,0,75,75,150
"2B277",2017,0,45,28,73
"2B277",2018,0,264,264,528
"2B277",2019,0,0,93,93
"2B277",2020,0,38,38,76
"2B280",2016,0,75,75,150
"2B280",2017,0,45,28,73
"2B280",2018,0,264,264,528
"2B280",2019,0,0,93,93
"2B280",2020,0,38,38,76
"2B281",2016,0,75,75,150
"2B281",2017,0,45,45,90
"2B281",2018,0,264,264,528
"2B281",2019,0,0,93,93
"2B281",2020,0,38,38,76
"2B283",2016,0,75,75,150
"2B283",2017,0,45,28,73
"2B283",2018,0,264,264,528
"2B283",2019,0,0,93,93
"2B283",2020,0,38,38,76
"2B286",2016,0,75,75,150
"2B286",2017,0,45,28,73
"2B286",2018,0,264,264,528
"2B286",2019,0,0,93,93
"2B286",2020,0,38,38,76
"2B287",2016,0,75,75,150
"2B287",2017,0,45,28,73
"2B287",2018,0,264,264,528
"2B287",2019,0,0,93,93
"2B287",2020,0,38,38,76
"2B289",2016,0,75,75,150
"2B289",2017,0,45,45,90
"2B289",2018,0,264,264,528
"2B289",2019,0,0,93,93
"2B289",2020,0,38,38,76
"2B290",2016,0,75,75,150
"2B290",2017,0,45,28,73
"2B290",2018,0,264,264,528
"2B290",2019,0,0,93,93
"2B290",2020,0,38,38,76
"2B291",2016,0,75,75,150
"2B291",2017,0,45,28,73
"2B291",2018,0,264,264,528
"2B291",2019,0,0,93,93
"2B291",2020,0,38,38,76
"2B292",2016,0,75,75,150
"2B292",2017,0,45,28,73
"2B292",2018,0,264,264,528
"2B292",2019,0,0,93,93
"2B292",2020,0,38,38,76
"2B293",2016,0,75,75,150
"2B293",2017,0,45,28,73
"2B293",2018,0,264,264,528
"2B293",2019,0,0,93,93
"2B293",2020,0,38,38,76
"2B296",2016,0,75,75,150
"2B296",2017,0,45,28,73
"2B296",2018,0,264,264,528
"2B296",2019,0,0,93,93
"2B296",2020,0,38,38,76
"2B297",2016,0,75,75,150
"2B297",2017,0,45,28,73
"2B297",2018,0,264,264,528
"2B297",2019,0,0,93,93
"2B297",2020,0,38,38,76
"2B298",2016,0,75,75,150
"2B298",2017,0,45,45,90
"2B298",2018,0,264,264,528
"2B298",2019,0,0,93,93
"2B298",2020,0,38,38,76
"2B299",2016,0,75,75,150
"2B299",2017,0,45,28,73
"2B299",2018,0,264,264,528
"2B299",2019,0,0,93,93
"2B299",2020,0,38,38,76
"2B301",2016,0,75,75,150
"2B301",2017,0,45,28,73
"2B301",2018,0,264,264,528
"2B301",2019,0,0,93,93
"2B301",2020,0,38,38,76
"2B302",2016,0,75,75,150
"2B302",2017,0,45,28,73
"2B302",2018,0,264,264,528
"2B302",2019,0,0,93,93
"2B302",2020,0,38,38,76
"2B303",2016,0,75,75,150
"2B303",2017,0,45,28,73
"2B303",2018,0,264,264,528
"2B303",2019,0,0,93,93
"2B303",2020,0,38,38,76
"2B304",2016,0,75,75,150
"2B304",2017,0,45,28,73
"2B304",2018,0,264,264,528
"2B304",2019,0,0,93,93
"2B304",2020,0,38,38,76
"2B305",2016,0,75,75,150
"2B305",2017,0,45,45,90
"2B305",2018,0,264,264,528
"2B305",2019,0,0,93,93
"2B305",2020,0,38,38,76
"2B306",2016,0,75,75,150
"2B306",2017,0,45,45,90
"2B306",2018,0,264,264,528
"2B306",2019,0,0,93,93
"2B306",2020,0,38,38,76
"2B307",2016,0,75,75,150
"2B307",2017,0,45,28,73
"2B307",2018,0,264,264,528
"2B307",2019,0,0,93,93
"2B307",2020,0,38,38,76
"2B309",2016,0,75,75,150
"2B309",2017,0,45,45,90
"2B309",2018,0,264,264,528
"2B309",2019,0,0,93,93
"2B309",2020,0,38,38,76
"2B311",2016,0,75,75,150
"2B311",2017,0,45,28,73
"2B311",2018,0,264,264,528
"2B311",2019,0,0,93,93
"2B311",2020,0,38,38,76
"2B313",2016,0,75,75,150
"2B313",2017,0,45,28,73
"2B313",2018,0,264,264,528
"2B313",2019,0,0,93,93
"2B313",2020,0,38,38,76
"2B314",2016,0,75,75,150
"2B314",2017,0,45,45,90
"2B314",2018,0,264,264,528
"2B314",2019,0,0,93,93
"2B314",2020,0,38,38,76
"2B315",2016,0,75,75,150
"2B315",2017,0,45,45,90
"2B315",2018,0,264,264,528
"2B315",2019,0,0,93,93
"2B315",2020,0,38,38,76
"2B316",2016,0,75,75,150
"2B316",2017,0,45,28,73
"2B316",2018,0,264,264,528
"2B316",2019,0,0,93,93
"2B316",2020,0,38,38,76
"2B317",2016,0,75,75,150
"2B317",2017,0,45,28,73
"2B317",2018,0,264,264,528
"2B317",2019,0,0,93,93
"2B317",2020,0,38,38,76
"2B318",2016,0,75,75,150
"2B318",2017,0,45,28,73
"2B318",2018,0,264,264,528
"2B318",2019,0,0,93,93
"2B318",2020,0,38,38,76
"2B319",2016,0,75,75,150
"2B319",2017,0,45,28,73
"2B319",2018,0,264,264,528
"2B319",2019,0,0,93,93
"2B319",2020,0,38,38,76
"2B320",2016,0,75,75,150
"2B320",2017,0,45,28,73
"2B320",2018,0,264,264,528
"2B320",2019,0,0,93,93
"2B320",2020,0,38,38,76
"2B321",2016,0,75,75,150
"2B321",2017,0,45,28,73
"2B321",2018,0,264,264,528
"2B321",2019,0,0,93,93
"2B321",2020,0,38,38,76
"2B327",2016,0,75,75,150
"2B327",2017,0,45,45,90
"2B327",2018,0,264,264,528
"2B327",2019,0,0,93,93
"2B327",2020,0,38,38,76
"2B328",2016,0,75,75,150
"2B328",2017,0,45,28,73
"2B328",2018,0,264,264,528
"2B328",2019,0,0,93,93
"2B328",2020,0,38,38,76
"2B329",2016,0,75,75,150
"2B329",2017,0,45,45,90
"2B329",2018,0,264,264,528
"2B329",2019,0,0,93,93
"2B329",2020,0,38,38,76
"2B332",2016,0,75,75,150
"2B332",2017,0,45,28,73
"2B332",2018,0,264,264,528
"2B332",2019,0,0,93,93
"2B332",2020,0,38,38,76
"2B333",2016,0,75,75,150
"2B333",2017,0,45,28,73
"2B333",2018,0,264,264,528
"2B333",2019,0,0,93,93
"2B333",2020,0,38,38,76
"2B334",2016,0,75,75,150
"2B334",2017,0,45,28,73
"2B334",2018,0,264,264,528
"2B334",2019,0,0,93,93
"2B334",2020,0,38,38,76
"2B335",2016,0,75,75,150
"2B335",2017,0,45,28,73
"2B335",2018,0,264,264,528
"2B335",2019,0,0,93,93
"2B335",2020,0,38,38,76
"2B337",2016,0,75,75,150
"2B337",2017,0,45,45,90
"2B337",2018,0,264,264,528
"2B337",2019,0,0,93,93
"2B337",2020,0,38,38,76
"2B338",2016,0,75,75,150
"2B338",2017,0,45,28,73
"2B338",2018,0,264,264,528
"2B338",2019,0,0,93,93
"2B338",2020,0,38,38,76
"2B339",2016,0,75,75,150
"2B339",2017,0,45,28,73
"2B339",2018,0,264,264,528
"2B339",2019,0,0,93,93
"2B339",2020,0,38,38,76
"2B340",2016,0,75,75,150
"2B340",2017,0,45,28,73
"2B340",2018,0,264,264,528
"2B340",2019,0,0,93,93
"2B340",2020,0,38,38,76
"2B341",2016,0,75,75,150
"2B341",2017,0,45,45,90
"2B341",2018,0,264,264,528
"2B341",2019,0,0,93,93
"2B341",2020,0,38,38,76
"2B342",2016,0,75,75,150
"2B342",2017,0,45,28,73
"2B342",2018,0,264,264,528
"2B342",2019,0,0,93,93
"2B342",2020,0,38,38,76
"2B343",2016,0,75,75,150
"2B343",2017,0,45,28,73
"2B343",2018,0,264,264,528
"2B343",2019,0,0,93,93
"2B343",2020,0,38,38,76
"2B344",2016,0,75,75,150
"2B344",2017,0,45,28,73
"2B344",2018,0,264,264,528
"2B344",2019,0,0,93,93
"2B344",2020,0,38,38,76
"2B346",2016,0,75,75,150
"2B346",2017,0,45,28,73
"2B346",2018,0,264,264,528
"2B346",2019,0,0,93,93
"2B346",2020,0,38,38,76
"2B347",2016,0,75,75,150
"2B347",2017,0,45,28,73
"2B347",2018,0,264,264,528
"2B347",2019,0,0,93,93
"2B347",2020,0,38,38,76
"2B350",2016,0,75,75,150
"2B350",2017,0,45,28,73
"2B350",2018,0,264,264,528
"2B350",2019,0,0,93,93
"2B350",2020,0,38,38,76
"2B352",2016,0,75,75,150
"2B352",2017,0,45,28,73
"2B352",2018,0,264,264,528
"2B352",2019,0,0,93,93
"2B352",2020,0,38,38,76
"2B353",2016,0,75,75,150
"2B353",2017,0,45,45,90
"2B353",2018,0,264,264,528
"2B353",2019,0,0,93,93
"2B353",2020,0,38,38,76
"2B354",2016,0,75,75,150
"2B354",2017,0,45,45,90
"2B354",2018,0,264,264,528
"2B354",2019,0,0,93,93
"2B354",2020,0,38,38,76
"2B355",2016,0,75,75,150
"2B355",2017,0,45,28,73
"2B355",2018,0,264,264,528
"2B355",2019,0,0,93,93
"2B355",2020,0,38,38,76
"2B356",2016,0,75,75,150
"2B356",2017,0,45,28,73
"2B356",2018,0,264,264,528
"2B356",2019,0,0,93,93
"2B356",2020,0,38,38,76
"2B361",2016,0,75,75,150
"2B361",2017,0,45,28,73
"2B361",2018,0,264,264,528
"2B361",2019,0,0,93,93
"2B361",2020,0,38,38,76
"2B364",2016,0,75,75,150
"2B364",2017,0,45,28,73
"2B364",2018,0,264,264,528
"2B364",2019,0,0,93,93
"2B364",2020,0,38,38,76
"2B365",2016,0,75,75,150
"2B365",2017,0,45,28,73
"2B365",2018,0,264,264,528
"2B365",2019,0,0,93,93
"2B365",2020,0,38,38,76
"2B366",2016,0,75,75,150
"2B366",2017,0,45,28,73
"2B366",2018,0,264,264,528
"2B366",2019,0,0,93,93
"2B366",2020,0,38,38,76
"30001",2014,0,60,37,97
"30001",2015,0,37,44,81
"30001",2016,0,97,83,180
"30001",2017,0,51,33,84
"30001",2019,0,108,98,206
"30001",2020,0,0,24,24
"30002",2014,0,0,60,60
"30002",2015,0,0,49,49
"30002",2016,0,0,97,97
"30002",2017,0,0,33,33
"30002",2019,0,0,98,98
"30002",2020,0,0,24,24
"30003",2014,0,0,82,82
"30003",2015,0,0,49,49
"30003",2016,0,0,18,18
"30003",2017,0,0,33,33
"30003",2018,0,0,76,76
"30003",2019,0,0,98,98
"30003",2020,0,0,24,24
"30004",2014,0,0,82,82
"30004",2016,0,30,18,48
"30004",2017,0,33,33,66
"30004",2018,0,76,76,152
"30004",2019,0,108,108,216
"30004",2020,0,14,33,47
"30005",2014,0,0,37,37
"30005",2015,0,0,49,49
"30005",2016,0,0,21,21
"30005",2017,0,0,14,14
"30005",2019,0,0,55,55
"30005",2020,0,0,38,38
"30006",2014,0,0,82,82
"30006",2015,0,0,49,49
"30006",2016,0,30,18,48
"30006",2017,0,33,33,66
"30006",2018,0,76,76,152
"30006",2019,0,108,98,206
"30006",2020,0,14,24,38
"30007",2014,0,0,60,60
"30007",2015,0,0,49,49
"30007",2016,0,0,97,97
"30007",2017,0,0,51,51
"30007",2019,0,0,98,98
"30007",2020,0,0,62,62
"30008",2014,0,0,37,37
"30008",2015,0,0,44,44
"30008",2016,0,0,97,97
"30008",2017,0,0,51,51
"30008",2019,0,0,98,98
"30008",2020,0,0,81,81
"30009",2014,0,0,82,82
"30009",2015,0,0,49,49
"30009",2016,0,0,97,97
"30009",2017,0,0,111,111
"30009",2019,0,0,73,73
"30009",2020,0,0,62,62
"30010",2014,0,0,60,60
"30010",2015,0,0,49,49
"30010",2016,0,0,97,97
"30010",2017,0,0,51,51
"30010",2019,0,0,98,98
"30010",2020,0,0,62,62
"30011",2014,0,0,82,82
"30011",2016,0,0,97,97
"30011",2017,0,0,187,187
"30011",2019,0,0,92,92
"30011",2020,0,0,81,81
"30012",2014,0,0,82,82
"30012",2016,0,0,97,97
"30012",2017,0,0,187,187
"30012",2019,0,0,92,92
"30012",2020,0,0,81,81
"30013",2014,0,60,82,142
"30013",2015,0,37,49,86
"30013",2016,0,97,83,180
"30013",2017,0,51,33,84
"30013",2019,0,108,98,206
"30013",2020,0,0,19,19
"30014",2014,0,60,82,142
"30014",2015,0,37,49,86
"30014",2016,0,97,83,180
"30014",2017,0,51,33,84
"30014",2019,0,108,98,206
"30014",2020,0,0,19,19
"30015",2014,0,0,82,82
"30015",2015,0,0,49,49
"30015",2016,0,0,97,97
"30015",2017,0,0,111,111
"30015",2019,0,0,73,73
"30015",2020,0,0,62,62
"30016",2014,0,0,82,82
"30016",2015,0,0,49,49
"30016",2016,0,0,97,97
"30016",2017,0,0,111,111
"30016",2019,0,0,73,73
"30016",2020,0,0,62,62
"30017",2014,0,0,82,82
"30017",2015,0,0,49,49
"30017",2016,0,0,97,97
"30017",2017,0,0,111,111
"30017",2019,0,0,73,73
"30017",2020,0,0,62,62
"30018",2014,0,82,82,164
"30018",2015,0,0,49,49
"30018",2016,0,37,97,134
"30018",2017,0,187,33,220
"30018",2019,0,10,98,108
"30018",2020,0,0,24,24
"30019",2014,0,82,82,164
"30019",2015,0,0,49,49
"30019",2016,0,37,18,55
"30019",2017,0,187,33,220
"30019",2018,0,0,76,76
"30019",2019,0,10,98,108
"30019",2020,0,0,24,24
"30020",2014,0,0,82,82
"30020",2016,0,30,18,48
"30020",2017,0,33,33,66
"30020",2018,0,76,76,152
"30020",2019,0,108,108,216
"30020",2020,0,14,33,47
"30021",2014,0,60,82,142
"30021",2015,0,37,49,86
"30021",2016,0,97,83,180
"30021",2017,0,51,33,84
"30021",2019,0,108,98,206
"30021",2020,0,0,19,19
"30022",2014,0,0,37,37
"30022",2015,0,0,44,44
"30022",2016,0,0,97,97
"30022",2017,0,0,51,51
"30022",2019,0,0,98,98
"30022",2020,0,0,81,81
"30023",2014,0,60,82,142
"30023",2015,0,37,49,86
"30023",2016,0,97,97,194
"30023",2017,0,51,33,84
"30023",2019,0,108,98,206
"30023",2020,0,0,24,24
"30024",2014,0,0,82,82
"30024",2015,0,0,49,49
"30024",2016,0,0,97,97
"30024",2017,0,0,111,111
"30024",2019,0,0,73,73
"30024",2020,0,0,62,62
"30025",2014,0,0,82,82
"30025",2015,0,0,49,49
"30025",2016,0,0,97,97
"30025",2017,0,0,111,111
"30025",2019,0,0,73,73
"30025",2020,0,0,62,62
"30026",2014,0,0,82,82
"30026",2015,0,0,49,49
"30026",2016,0,0,97,97
"30026",2017,0,0,111,111
"30026",2019,0,0,73,73
"30026",2020,0,0,62,62
"30027",2014,0,0,60,60
"30027",2015,0,0,49,49
"30027",2016,0,0,97,97
"30027",2017,0,0,51,51
"30027",2019,0,0,98,98
"30027",2020,0,0,62,62
"30028",2014,0,0,37,37
"30028",2015,0,0,49,49
"30028",2016,0,0,97,97
"30028",2017,0,0,14,14
"30028",2019,0,0,55,55
"30028",2020,0,0,81,81
"30029",2014,0,0,37,37
"30029",2015,0,0,44,44
"30029",2016,0,0,21,21
"30029",2017,0,0,14,14
"30029",2019,0,0,55,55
"30029",2020,0,0,38,38
"30030",2014,0,60,82,142
"30030",2015,0,37,49,86
"30030",2016,0,97,83,180
"30030",2017,0,51,33,84
"30030",2019,0,108,98,206
"30030",2020,0,0,19,19
"30031",2014,0,60,37,97
"30031",2015,0,37,49,86
"30031",2016,0,97,83,180
"30031",2017,0,51,14,65
"30031",2019,0,108,55,163
"30031",2020,0,0,24,24
"30032",2014,0,0,82,82
"30032",2016,0,30,97,127
"30032",2017,0,33,187,220
"30032",2018,0,76,76,152
"30032",2019,0,108,108,216
"30032",2020,0,14,38,52
"30033",2014,0,0,82,82
"30033",2016,0,30,18,48
"30033",2017,0,33,33,66
"30033",2018,0,76,76,152
"30033",2019,0,108,108,216
"30033",2020,0,14,38,52
"30034",2014,0,0,82,82
"30034",2016,0,30,97,127
"30034",2017,0,33,187,220
"30034",2018,0,76,76,152
"30034",2019,0,108,108,216
"30034",2020,0,14,38,52
"30035",2014,0,60,37,97
"30035",2015,0,37,49,86
"30035",2016,0,97,83,180
"30035",2017,0,51,14,65
"30035",2019,0,108,55,163
"30035",2020,0,0,24,24
"30036",2014,0,0,82,82
"30036",2016,0,30,18,48
"30036",2017,0,33,33,66
"30036",2018,0,76,76,152
"30036",2019,0,108,108,216
"30036",2020,0,14,33,47
"30037",2014,0,0,37,37
"30037",2015,0,0,44,44
"30037",2016,0,0,97,97
"30037",2017,0,0,51,51
"30037",2019,0,0,98,98
"30037",2020,0,0,81,81
"30038",2014,0,0,82,82
"30038",2015,0,0,49,49
"30038",2016,0,0,97,97
"30038",2017,0,0,111,111
"30038",2019,0,0,73,73
"30038",2020,0,0,62,62
"30039",2014,0,0,82,82
"30039",2016,0,30,18,48
"30039",2017,0,33,33,66
"30039",2018,0,76,76,152
"30039",2019,0,108,108,216
"30039",2020,0,14,33,47
"30040",2014,0,0,82,82
"30040",2015,0,0,49,49
"30040",2016,0,0,97,97
"30040",2017,0,0,111,111
"30040",2019,0,0,73,73
"30040",2020,0,0,62,62
"30041",2014,0,60,82,142
"30041",2015,0,37,49,86
"30041",2016,0,97,83,180
"30041",2017,0,51,33,84
"30041",2019,0,108,98,206
"30041",2020,0,0,19,19
"30042",2014,0,0,60,60
"30042",2015,0,0,49,49
"30042",2016,0,0,97,97
"30042",2017,0,0,51,51
"30042",2019,0,0,98,98
"30042",2020,0,0,62,62
"30043",2014,0,0,82,82
"30043",2016,0,0,18,18
"30043",2017,0,0,33,33
"30043",2018,0,0,76,76
"30043",2019,0,0,108,108
"30043",2020,0,0,33,33
"30044",2014,0,0,37,37
"30044",2015,0,0,44,44
"30044",2016,0,0,97,97
"30044",2017,0,0,51,51
"30044",2019,0,0,98,98
"30044",2020,0,0,81,81
"30045",2014,0,0,37,37
"30045",2015,0,0,44,44
"30045",2016,0,0,97,97
"30045",2017,0,0,51,51
"30045",2019,0,0,98,98
"30045",2020,0,0,81,81
"30046",2014,0,60,82,142
"30046",2015,0,37,49,86
"30046",2016,0,97,83,180
"30046",2017,0,51,33,84
"30046",2019,0,108,98,206
"30046",2020,0,0,19,19
"30047",2014,0,0,82,82
"30047",2016,0,30,18,48
"30047",2017,0,33,33,66
"30047",2018,0,76,76,152
"30047",2019,0,108,108,216
"30047",2020,0,14,33,47
"30048",2014,0,60,37,97
"30048",2015,0,37,44,81
"30048",2016,0,97,83,180
"30048",2017,0,51,14,65
"30048",2019,0,108,55,163
"30048",2020,0,0,24,24
"30049",2014,0,60,82,142
"30049",2015,0,37,49,86
"30049",2016,0,97,83,180
"30049",2017,0,51,33,84
"30049",2019,0,108,98,206
"30049",2020,0,0,19,19
"30050",2014,0,0,82,82
"30050",2015,0,0,49,49
"30050",2016,0,0,97,97
"30050",2017,0,0,33,33
"30050",2019,0,0,98,98
"30050",2020,0,0,24,24
"30051",2014,0,0,60,60
"30051",2015,0,0,49,49
"30051",2016,0,0,97,97
"30051",2017,0,0,51,51
"30051",2019,0,0,98,98
"30051",2020,0,0,62,62
"30052",2014,0,0,82,82
"30052",2015,0,0,49,49
"30052",2016,0,0,97,97
"30052",2017,0,0,111,111
"30052",2019,0,0,73,73
"30052",2020,0,0,62,62
"30053",2014,0,60,82,142
"30053",2015,0,37,49,86
"30053",2016,0,97,83,180
"30053",2017,0,51,33,84
"30053",2019,0,108,98,206
"30053",2020,0,0,19,19
"30054",2014,0,0,82,82
"30054",2015,0,0,49,49
"30054",2016,0,0,97,97
"30054",2017,0,0,33,33
"30054",2019,0,0,98,98
"30054",2020,0,0,24,24
"30055",2014,0,0,37,37
"30055",2015,0,0,44,44
"30055",2016,0,0,97,97
"30055",2017,0,0,51,51
"30055",2019,0,0,98,98
"30055",2020,0,0,81,81
"30056",2014,0,60,37,97
"30056",2015,0,37,49,86
"30056",2016,0,97,83,180
"30056",2017,0,51,14,65
"30056",2019,0,108,55,163
"30056",2020,0,0,24,24
"30057",2014,0,60,82,142
"30057",2015,0,37,49,86
"30057",2016,0,97,18,115
"30057",2017,0,51,33,84
"30057",2018,0,0,76,76
"30057",2019,0,108,98,206
"30057",2020,0,0,19,19
"30058",2014,0,0,82,82
"30058",2015,0,0,49,49
"30058",2016,0,0,97,97
"30058",2017,0,0,47,47
"30058",2019,0,0,73,73
"30058",2020,0,0,24,24
"30059",2014,0,0,82,82
"30059",2016,0,30,18,48
"30059",2017,0,33,33,66
"30059",2018,0,76,76,152
"30059",2019,0,108,108,216
"30059",2020,0,14,38,52
"30060",2014,0,0,82,82
"30060",2016,0,30,18,48
"30060",2017,0,33,33,66
"30060",2018,0,76,76,152
"30060",2019,0,108,108,216
"30060",2020,0,14,33,47
"30061",2014,0,60,82,142
"30061",2015,0,37,49,86
"30061",2016,0,97,83,180
"30061",2017,0,51,33,84
"30061",2019,0,108,98,206
"30061",2020,0,0,19,19
"30062",2014,0,0,82,82
"30062",2015,0,0,49,49
"30062",2016,0,0,18,18
"30062",2017,0,0,33,33
"30062",2018,0,0,76,76
"30062",2019,0,0,98,98
"30062",2020,0,0,24,24
"30064",2014,0,0,82,82
"30064",2015,0,0,49,49
"30064",2016,0,0,97,97
"30064",2017,0,0,111,111
"30064",2019,0,0,73,73
"30064",2020,0,0,62,62
"30065",2014,0,0,60,60
"30065",2015,0,0,49,49
"30065",2016,0,0,97,97
"30065",2017,0,0,33,33
"30065",2019,0,0,98,98
"30065",2020,0,0,24,24
"30066",2014,0,0,82,82
"30066",2015,0,0,49,49
"30066",2016,0,0,97,97
"30066",2017,0,0,33,33
"30066",2019,0,0,98,98
"30066",2020,0,0,24,24
"30067",2014,0,60,37,97
"30067",2015,0,37,49,86
"30067",2016,0,97,83,180
"30067",2017,0,51,14,65
"30067",2019,0,108,55,163
"30067",2020,0,0,24,24
"30068",2014,0,0,60,60
"30068",2015,0,0,49,49
"30068",2016,0,0,97,97
"30068",2017,0,0,51,51
"30068",2019,0,0,98,98
"30068",2020,0,0,62,62
"30069",2014,0,0,82,82
"30069",2015,0,0,49,49
"30069",2016,0,0,97,97
"30069",2017,0,0,33,33
"30069",2019,0,0,98,98
"30069",2020,0,0,24,24
"30070",2014,0,0,37,37
"30070",2015,0,0,49,49
"30070",2016,0,0,21,21
"30070",2017,0,0,14,14
"30070",2019,0,0,55,55
"30070",2020,0,0,38,38
"30071",2014,0,60,60,120
"30071",2015,0,37,49,86
"30071",2016,0,97,83,180
"30071",2017,0,51,33,84
"30071",2019,0,108,98,206
"30071",2020,0,0,19,19
"30072",2014,0,60,82,142
"30072",2015,0,37,49,86
"30072",2016,0,97,83,180
"30072",2017,0,51,33,84
"30072",2019,0,108,98,206
"30072",2020,0,0,19,19
"30073",2014,0,60,82,142
"30073",2015,0,37,49,86
"30073",2016,0,97,83,180
"30073",2017,0,51,33,84
"30073",2019,0,108,98,206
"30073",2020,0,0,19,19
"30074",2014,0,0,82,82
"30074",2015,0,0,49,49
"30074",2016,0,0,97,97
"30074",2017,0,0,97,97
"30074",2019,0,0,190,190
"30074",2020,0,0,62,62
"30075",2014,0,0,82,82
"30075",2015,0,0,49,49
"30075",2016,0,0,18,18
"30075",2017,0,0,33,33
"30075",2018,0,0,76,76
"30075",2019,0,0,98,98
"30075",2020,0,0,19,19
"30076",2014,0,0,37,37
"30076",2015,0,0,49,49
"30076",2016,0,0,97,97
"30076",2017,0,0,14,14
"30076",2019,0,0,55,55
"30076",2020,0,0,81,81
"30077",2014,0,0,60,60
"30077",2015,0,0,49,49
"30077",2016,0,0,97,97
"30077",2017,0,0,51,51
"30077",2019,0,0,98,98
"30077",2020,0,0,62,62
"30079",2014,0,0,37,37
"30079",2015,0,0,44,44
"30079",2016,0,0,97,97
"30079",2017,0,0,51,51
"30079",2019,0,0,98,98
"30079",2020,0,0,81,81
"30080",2014,0,0,37,37
"30080",2015,0,0,44,44
"30080",2016,0,0,97,97
"30080",2017,0,0,51,51
"30080",2019,0,0,98,98
"30080",2020,0,0,81,81
"30081",2014,0,0,37,37
"30081",2015,0,0,49,49
"30081",2016,0,0,97,97
"30081",2017,0,0,14,14
"30081",2019,0,0,55,55
"30081",2020,0,0,81,81
"30082",2014,0,0,82,82
"30082",2015,0,0,49,49
"30082",2016,0,0,18,18
"30082",2017,0,0,33,33
"30082",2018,0,0,76,76
"30082",2019,0,0,98,98
"30082",2020,0,0,19,19
"30083",2014,0,0,82,82
"30083",2016,0,30,18,48
"30083",2017,0,33,33,66
"30083",2018,0,76,76,152
"30083",2019,0,108,108,216
"30083",2020,0,14,33,47
"30084",2014,0,0,37,37
"30084",2015,0,0,49,49
"30084",2016,0,0,97,97
"30084",2017,0,0,14,14
"30084",2019,0,0,55,55
"30084",2020,0,0,81,81
"30085",2014,0,60,82,142
"30085",2015,0,37,49,86
"30085",2016,0,97,18,115
"30085",2017,0,51,33,84
"30085",2018,0,0,76,76
"30085",2019,0,108,98,206
"30085",2020,0,0,19,19
"30086",2014,0,60,82,142
"30086",2015,0,37,49,86
"30086",2016,0,97,83,180
"30086",2017,0,51,33,84
"30086",2019,0,108,98,206
"30086",2020,0,0,19,19
"30087",2014,0,0,60,60
"30087",2015,0,0,49,49
"30087",2016,0,0,97,97
"30087",2017,0,0,47,47
"30087",2019,0,0,73,73
"30087",2020,0,0,24,24
"30088",2014,0,60,82,142
"30088",2015,0,37,49,86
"30088",2016,0,97,83,180
"30088",2017,0,51,33,84
"30088",2019,0,108,98,206
"30088",2020,0,0,24,24
"30089",2014,0,0,82,82
"30089",2015,0,0,49,49
"30089",2016,0,30,83,113
"30089",2017,0,33,33,66
"30089",2018,0,76,76,152
"30089",2019,0,108,98,206
"30089",2020,0,14,24,38
"30090",2014,0,0,37,37
"30090",2015,0,0,44,44
"30090",2016,0,0,97,97
"30090",2017,0,0,51,51
"30090",2019,0,0,98,98
"30090",2020,0,0,81,81
"30091",2014,0,0,82,82
"30091",2015,0,0,49,49
"30091",2016,0,0,18,18
"30091",2017,0,0,33,33
"30091",2018,0,0,76,76
"30091",2019,0,0,98,98
"30091",2020,0,0,24,24
"30092",2014,0,0,37,37
"30092",2015,0,0,49,49
"30092",2016,0,0,97,97
"30092",2017,0,0,14,14
"30092",2019,0,0,55,55
"30092",2020,0,0,81,81
"30093",2014,0,0,82,82
"30093",2015,0,0,49,49
"30093",2016,0,0,97,97
"30093",2017,0,0,33,33
"30093",2019,0,0,98,98
"30093",2020,0,0,24,24
"30094",2014,0,0,60,60
"30094",2015,0,0,49,49
"30094",2016,0,0,97,97
"30094",2017,0,0,51,51
"30094",2019,0,0,98,98
"30094",2020,0,0,62,62
"30095",2014,0,0,82,82
"30095",2015,0,0,49,49
"30095",2016,0,0,97,97
"30095",2017,0,0,33,33
"30095",2019,0,0,98,98
"30095",2020,0,0,24,24
"30096",2014,0,0,37,37
"30096",2015,0,0,49,49
"30096",2016,0,0,97,97
"30096",2017,0,0,14,14
"30096",2019,0,0,55,55
"30096",2020,0,0,81,81
"30097",2014,0,0,37,37
"30097",2015,0,0,44,44
"30097",2016,0,0,97,97
"30097",2017,0,0,51,51
"30097",2019,0,0,98,98
"30097",2020,0,0,81,81
"30098",2014,0,60,82,142
"30098",2015,0,37,49,86
"30098",2016,0,97,83,180
"30098",2017,0,51,33,84
"30098",2019,0,108,98,206
"30098",2020,0,0,24,24
"30099",2014,0,0,60,60
"30099",2015,0,0,49,49
"30099",2016,0,0,97,97
"30099",2017,0,0,47,47
"30099",2019,0,0,73,73
"30099",2020,0,0,24,24
"30100",2014,0,60,82,142
"30100",2015,0,37,49,86
"30100",2016,0,97,83,180
"30100",2017,0,51,33,84
"30100",2019,0,108,98,206
"30100",2020,0,0,19,19
"30101",2014,0,60,60,120
"30101",2015,0,37,49,86
"30101",2016,0,97,83,180
"30101",2017,0,51,33,84
"30101",2019,0,108,98,206
"30101",2020,0,0,19,19
"30102",2014,0,60,82,142
"30102",2015,0,37,49,86
"30102",2016,0,97,83,180
"30102",2017,0,51,33,84
"30102",2019,0,108,98,206
"30102",2020,0,0,19,19
"30103",2014,0,0,82,82
"30103",2015,0,0,49,49
"30103",2016,0,0,83,83
"30103",2017,0,0,33,33
"30103",2019,0,0,98,98
"30103",2020,0,0,24,24
"30104",2014,0,60,82,142
"30104",2015,0,37,49,86
"30104",2016,0,97,83,180
"30104",2017,0,51,33,84
"30104",2019,0,108,98,206
"30104",2020,0,0,24,24
"30105",2014,0,0,82,82
"30105",2015,0,0,49,49
"30105",2016,0,0,97,97
"30105",2017,0,0,111,111
"30105",2019,0,0,73,73
"30105",2020,0,0,62,62
"30106",2014,0,0,82,82
"30106",2015,0,0,49,49
"30106",2016,0,0,97,97
"30106",2017,0,0,33,33
"30106",2019,0,0,98,98
"30106",2020,0,0,24,24
"30107",2014,0,0,82,82
"30107",2015,0,0,49,49
"30107",2016,0,0,83,83
"30107",2017,0,0,33,33
"30107",2019,0,0,98,98
"30107",2020,0,0,19,19
"30108",2014,0,0,60,60
"30108",2015,0,0,49,49
"30108",2016,0,0,97,97
"30108",2017,0,0,65,65
"30108",2019,0,0,73,73
"30108",2020,0,0,62,62
"30109",2014,0,60,82,142
"30109",2015,0,37,49,86
"30109",2016,0,97,83,180
"30109",2017,0,51,33,84
"30109",2019,0,108,98,206
"30109",2020,0,0,19,19
"30110",2014,0,60,82,142
"30110",2015,0,37,49,86
"30110",2016,0,97,83,180
"30110",2017,0,51,33,84
"30110",2019,0,108,98,206
"30110",2020,0,0,19,19
"30111",2014,0,60,82,142
"30111",2015,0,37,49,86
"30111",2016,0,97,83,180
"30111",2017,0,51,33,84
"30111",2019,0,108,98,206
"30111",2020,0,0,19,19
"30112",2014,0,60,82,142
"30112",2015,0,37,49,86
"30112",2016,0,97,83,180
"30112",2017,0,51,33,84
"30112",2019,0,108,98,206
"30112",2020,0,0,19,19
"30113",2014,0,0,37,37
"30113",2015,0,0,44,44
"30113",2016,0,0,97,97
"30113",2017,0,0,14,14
"30113",2019,0,0,55,55
"30113",2020,0,0,81,81
"30114",2014,0,60,82,142
"30114",2015,0,37,49,86
"30114",2016,0,97,97,194
"30114",2017,0,51,33,84
"30114",2019,0,108,98,206
"30114",2020,0,0,24,24
"30115",2014,0,60,37,97
"30115",2015,0,37,49,86
"30115",2016,0,97,83,180
"30115",2017,0,51,14,65
"30115",2019,0,108,55,163
"30115",2020,0,0,24,24
"30116",2014,0,60,82,142
"30116",2015,0,37,49,86
"30116",2016,0,97,83,180
"30116",2017,0,51,33,84
"30116",2019,0,108,98,206
"30116",2020,0,0,19,19
"30117",2014,0,0,82,82
"30117",2016,0,0,97,97
"30117",2017,0,0,187,187
"30117",2019,0,0,92,92
"30117",2020,0,0,81,81
"30119",2014,0,0,82,82
"30119",2015,0,0,49,49
"30119",2016,0,0,97,97
"30119",2017,0,0,33,33
"30119",2019,0,0,98,98
"30119",2020,0,0,24,24
"30120",2014,0,0,37,37
"30120",2015,0,0,44,44
"30120",2016,0,0,97,97
"30120",2017,0,0,51,51
"30120",2019,0,0,98,98
"30120",2020,0,0,81,81
"30121",2014,0,0,82,82
"30121",2015,0,0,49,49
"30121",2016,0,0,97,97
"30121",2017,0,0,33,33
"30121",2019,0,0,98,98
"30121",2020,0,0,24,24
"30122",2014,0,60,82,142
"30122",2015,0,37,49,86
"30122",2016,0,97,83,180
"30122",2017,0,51,33,84
"30122",2019,0,108,98,206
"30122",2020,0,0,19,19
"30123",2014,0,0,82,82
"30123",2015,0,0,49,49
"30123",2016,0,30,18,48
"30123",2017,0,33,33,66
"30123",2018,0,76,76,152
"30123",2019,0,108,98,206
"30123",2020,0,14,24,38
"30124",2014,0,0,37,37
"30124",2015,0,0,49,49
"30124",2016,0,0,21,21
"30124",2017,0,0,14,14
"30124",2019,0,0,55,55
"30124",2020,0,0,38,38
"30125",2014,0,0,82,82
"30125",2016,0,30,18,48
"30125",2017,0,33,33,66
"30125",2018,0,76,76,152
"30125",2019,0,108,108,216
"30125",2020,0,14,33,47
"30126",2014,0,60,82,142
"30126",2015,0,37,49,86
"30126",2016,0,97,83,180
"30126",2017,0,51,33,84
"30126",2019,0,108,98,206
"30126",2020,0,0,19,19
"30127",2014,0,60,37,97
"30127",2015,0,37,49,86
"30127",2016,0,97,97,194
"30127",2017,0,51,14,65
"30127",2019,0,108,55,163
"30127",2020,0,0,81,81
"30128",2014,0,0,82,82
"30128",2016,0,30,18,48
"30128",2017,0,33,33,66
"30128",2018,0,76,76,152
"30128",2019,0,108,108,216
"30128",2020,0,14,33,47
"30129",2014,0,0,60,60
"30129",2015,0,0,49,49
"30129",2016,0,0,97,97
"30129",2017,0,0,51,51
"30129",2019,0,0,98,98
"30129",2020,0,0,62,62
"30130",2014,0,0,37,37
"30130",2015,0,0,44,44
"30130",2016,0,0,97,97
"30130",2017,0,0,51,51
"30130",2019,0,0,98,98
"30130",2020,0,0,81,81
"30131",2014,0,0,37,37
"30131",2015,0,0,49,49
"30131",2016,0,0,97,97
"30131",2017,0,0,14,14
"30131",2019,0,0,55,55
"30131",2020,0,0,81,81
"30132",2014,0,0,37,37
"30132",2015,0,0,44,44
"30132",2016,0,0,97,97
"30132",2017,0,0,51,51
"30132",2019,0,0,98,98
"30132",2020,0,0,81,81
"30133",2014,0,0,82,82
"30133",2016,0,0,18,18
"30133",2017,0,0,33,33
"30133",2018,0,0,76,76
"30133",2019,0,0,108,108
"30133",2020,0,0,38,38
"30134",2014,0,0,37,37
"30134",2015,0,0,49,49
"30134",2016,0,0,21,21
"30134",2017,0,0,14,14
"30134",2019,0,0,55,55
"30134",2020,0,0,38,38
"30135",2014,0,0,82,82
"30135",2015,0,0,49,49
"30135",2016,0,30,18,48
"30135",2017,0,33,33,66
"30135",2018,0,76,76,152
"30135",2019,0,108,98,206
"30135",2020,0,14,24,38
"30136",2014,0,60,82,142
"30136",2015,0,37,49,86
"30136",2016,0,97,97,194
"30136",2017,0,51,33,84
"30136",2019,0,108,98,206
"30136",2020,0,0,24,24
"30137",2014,0,0,60,60
"30137",2015,0,0,49,49
"30137",2016,0,0,97,97
"30137",2017,0,0,51,51
"30137",2019,0,0,98,98
"30137",2020,0,0,62,62
"30138",2014,0,0,82,82
"30138",2016,0,0,18,18
"30138",2017,0,0,33,33
"30138",2018,0,0,76,76
"30138",2019,0,0,108,108
"30138",2020,0,0,33,33
"30139",2014,0,0,82,82
"30139",2015,0,0,49,49
"30139",2016,0,0,97,97
"30139",2017,0,0,97,97
"30139",2019,0,0,190,190
"30139",2020,0,0,62,62
"30140",2014,0,0,60,60
"30140",2015,0,0,49,49
"30140",2016,0,0,97,97
"30140",2017,0,0,33,33
"30140",2019,0,0,98,98
"30140",2020,0,0,24,24
"30141",2014,0,0,37,37
"30141",2015,0,0,49,49
"30141",2016,0,0,97,97
"30141",2017,0,0,14,14
"30141",2019,0,0,55,55
"30141",2020,0,0,81,81
"30142",2014,0,0,37,37
"30142",2015,0,0,44,44
"30142",2016,0,0,97,97
"30142",2017,0,0,51,51
"30142",2019,0,0,98,98
"30142",2020,0,0,81,81
"30143",2014,0,0,60,60
"30143",2015,0,0,49,49
"30143",2016,0,0,21,21
"30143",2017,0,0,46,46
"30143",2019,0,0,73,73
"30143",2020,0,0,38,38
"30144",2014,0,82,82,164
"30144",2015,0,0,49,49
"30144",2016,0,37,97,134
"30144",2017,0,187,33,220
"30144",2019,0,10,98,108
"30144",2020,0,0,24,24
"30145",2014,0,0,82,82
"30145",2015,0,37,49,86
"30145",2016,0,30,18,48
"30145",2017,0,33,33,66
"30145",2018,0,76,76,152
"30145",2019,0,108,98,206
"30145",2020,0,14,19,33
"30146",2014,0,0,60,60
"30146",2015,0,0,49,49
"30146",2016,0,0,97,97
"30146",2017,0,0,33,33
"30146",2019,0,0,98,98
"30146",2020,0,0,24,24
"30147",2014,0,0,60,60
"30147",2015,0,0,49,49
"30147",2016,0,0,97,97
"30147",2017,0,0,33,33
"30147",2019,0,0,98,98
"30147",2020,0,0,24,24
"30148",2014,0,0,82,82
"30148",2015,0,0,49,49
"30148",2016,0,0,97,97
"30148",2017,0,0,33,33
"30148",2019,0,0,98,98
"30148",2020,0,0,24,24
"30149",2014,0,0,82,82
"30149",2016,0,0,97,97
"30149",2017,0,0,187,187
"30149",2019,0,0,92,92
"30149",2020,0,0,81,81
"30150",2014,0,0,82,82
"30150",2015,0,0,49,49
"30150",2016,0,0,97,97
"30150",2017,0,0,33,33
"30150",2019,0,0,98,98
"30150",2020,0,0,24,24
"30151",2014,0,0,37,37
"30151",2015,0,0,44,44
"30151",2016,0,0,97,97
"30151",2017,0,0,14,14
"30151",2019,0,0,55,55
"30151",2020,0,0,81,81
"30152",2014,0,0,37,37
"30152",2015,0,0,44,44
"30152",2016,0,0,97,97
"30152",2017,0,0,51,51
"30152",2019,0,0,98,98
"30152",2020,0,0,81,81
"30153",2014,0,0,37,37
"30153",2015,0,0,44,44
"30153",2016,0,0,21,21
"30153",2019,0,0,73,73
"30153",2020,0,0,38,38
"30154",2014,0,0,82,82
"30154",2015,0,0,49,49
"30154",2016,0,0,97,97
"30154",2017,0,0,111,111
"30154",2019,0,0,73,73
"30154",2020,0,0,62,62
"30155",2014,0,0,82,82
"30155",2016,0,30,18,48
"30155",2017,0,33,33,66
"30155",2018,0,76,76,152
"30155",2019,0,108,108,216
"30155",2020,0,14,33,47
"30156",2014,0,0,82,82
"30156",2015,0,37,0,37
"30156",2016,0,30,18,48
"30156",2017,0,33,33,66
"30156",2018,0,76,76,152
"30156",2019,0,108,108,216
"30156",2020,0,14,33,47
"30158",2014,0,60,82,142
"30158",2015,0,37,49,86
"30158",2016,0,97,83,180
"30158",2017,0,51,33,84
"30158",2019,0,108,98,206
"30158",2020,0,0,19,19
"30159",2014,0,0,37,37
"30159",2015,0,0,44,44
"30159",2016,0,0,97,97
"30159",2017,0,0,51,51
"30159",2019,0,0,98,98
"30159",2020,0,0,81,81
"30160",2014,0,60,60,120
"30160",2015,0,37,49,86
"30160",2016,0,97,83,180
"30160",2017,0,51,33,84
"30160",2019,0,108,98,206
"30160",2020,0,0,19,19
"30161",2014,0,60,60,120
"30161",2015,0,37,49,86
"30161",2016,0,97,83,180
"30161",2017,0,51,33,84
"30161",2019,0,108,98,206
"30161",2020,0,0,19,19
"30162",2014,0,0,60,60
"30162",2015,0,0,49,49
"30162",2016,0,0,97,97
"30162",2017,0,0,33,33
"30162",2019,0,0,98,98
"30162",2020,0,0,24,24
"30163",2014,0,60,82,142
"30163",2015,0,37,49,86
"30163",2016,0,97,83,180
"30163",2017,0,51,33,84
"30163",2019,0,108,98,206
"30163",2020,0,0,24,24
"30164",2014,0,0,37,37
"30164",2015,0,0,44,44
"30164",2016,0,0,97,97
"30164",2017,0,0,14,14
"30164",2019,0,0,55,55
"30164",2020,0,0,81,81
"30165",2014,0,60,60,120
"30165",2015,0,37,49,86
"30165",2016,0,97,83,180
"30165",2017,0,51,33,84
"30165",2019,0,108,98,206
"30165",2020,0,0,19,19
"30166",2014,0,0,82,82
"30166",2015,0,0,49,49
"30166",2016,0,30,18,48
"30166",2017,0,33,33,66
"30166",2018,0,76,76,152
"30166",2019,0,108,98,206
"30166",2020,0,14,19,33
"30167",2014,0,0,37,37
"30167",2015,0,0,44,44
"30167",2016,0,0,97,97
"30167",2017,0,0,51,51
"30167",2019,0,0,98,98
"30167",2020,0,0,81,81
"30168",2014,0,0,60,60
"30168",2015,0,0,49,49
"30168",2016,0,0,97,97
"30168",2017,0,0,51,51
"30168",2019,0,0,98,98
"30168",2020,0,0,62,62
"30169",2014,0,0,82,82
"30169",2016,0,30,18,48
"30169",2017,0,33,33,66
"30169",2018,0,76,76,152
"30169",2019,0,108,108,216
"30169",2020,0,14,33,47
"30170",2014,0,0,82,82
"30170",2015,0,0,49,49
"30170",2016,0,0,97,97
"30170",2017,0,0,111,111
"30170",2019,0,0,73,73
"30170",2020,0,0,62,62
"30171",2014,0,0,37,37
"30171",2015,0,0,44,44
"30171",2016,0,0,97,97
"30171",2017,0,0,51,51
"30171",2019,0,0,98,98
"30171",2020,0,0,81,81
"30172",2014,0,0,60,60
"30172",2015,0,0,49,49
"30172",2016,0,0,97,97
"30172",2017,0,0,33,33
"30172",2019,0,0,98,98
"30172",2020,0,0,24,24
"30173",2014,0,60,37,97
"30173",2015,0,37,44,81
"30173",2016,0,97,83,180
"30173",2017,0,51,33,84
"30173",2019,0,108,98,206
"30173",2020,0,0,24,24
"30174",2014,0,60,37,97
"30174",2015,0,37,49,86
"30174",2016,0,97,83,180
"30174",2017,0,51,14,65
"30174",2019,0,108,55,163
"30174",2020,0,0,24,24
"30175",2014,0,0,37,37
"30175",2015,0,0,49,49
"30175",2016,0,0,97,97
"30175",2017,0,0,14,14
"30175",2019,0,0,55,55
"30175",2020,0,0,81,81
"30176",2014,0,0,82,82
"30176",2015,0,0,49,49
"30176",2016,0,0,97,97
"30176",2017,0,0,111,111
"30176",2019,0,0,73,73
"30176",2020,0,0,62,62
"30177",2014,0,60,82,142
"30177",2015,0,37,49,86
"30177",2016,0,97,83,180
"30177",2017,0,51,33,84
"30177",2019,0,108,98,206
"30177",2020,0,0,19,19
"30178",2014,0,0,82,82
"30178",2016,0,0,97,97
"30178",2017,0,0,187,187
"30178",2019,0,0,92,92
"30178",2020,0,0,81,81
"30179",2014,0,0,82,82
"30179",2015,0,0,49,49
"30179",2016,0,30,83,113
"30179",2017,0,33,33,66
"30179",2018,0,76,76,152
"30179",2019,0,108,98,206
"30179",2020,0,14,19,33
"30180",2014,0,60,82,142
"30180",2015,0,37,49,86
"30180",2016,0,97,83,180
"30180",2017,0,51,33,84
"30180",2019,0,108,98,206
"30180",2020,0,0,19,19
"30181",2014,0,60,82,142
"30181",2015,0,37,49,86
"30181",2016,0,97,83,180
"30181",2017,0,51,33,84
"30181",2019,0,108,98,206
"30181",2020,0,0,24,24
"30182",2014,0,60,82,142
"30182",2015,0,37,49,86
"30182",2016,0,97,83,180
"30182",2017,0,51,33,84
"30182",2019,0,108,98,206
"30182",2020,0,0,24,24
"30183",2014,0,60,82,142
"30183",2015,0,37,49,86
"30183",2016,0,97,83,180
"30183",2017,0,51,33,84
"30183",2019,0,108,98,206
"30183",2020,0,0,24,24
"30184",2014,0,60,82,142
"30184",2015,0,37,49,86
"30184",2016,0,97,83,180
"30184",2017,0,51,33,84
"30184",2019,0,108,98,206
"30184",2020,0,0,19,19
"30185",2014,0,0,82,82
"30185",2016,0,30,18,48
"30185",2017,0,33,33,66
"30185",2018,0,76,76,152
"30185",2019,0,108,108,216
"30185",2020,0,14,33,47
"30186",2014,0,0,82,82
"30186",2016,0,0,18,18
"30186",2017,0,0,33,33
"30186",2018,0,0,76,76
"30186",2019,0,0,108,108
"30186",2020,0,0,33,33
"30187",2014,0,0,37,37
"30187",2015,0,0,44,44
"30187",2016,0,0,97,97
"30187",2017,0,0,51,51
"30187",2019,0,0,98,98
"30187",2020,0,0,81,81
"30188",2014,0,60,82,142
"30188",2015,0,37,49,86
"30188",2016,0,97,83,180
"30188",2017,0,51,33,84
"30188",2019,0,108,98,206
"30188",2020,0,0,19,19
"30189",2014,0,0,82,82
"30189",2015,0,37,49,86
"30189",2016,0,30,18,48
"30189",2017,0,33,33,66
"30189",2018,0,76,76,152
"30189",2019,0,108,98,206
"30189",2020,0,14,19,33
"30191",2014,0,0,37,37
"30191",2015,0,0,49,49
"30191",2016,0,0,97,97
"30191",2017,0,0,14,14
"30191",2019,0,0,55,55
"30191",2020,0,0,81,81
"30192",2014,0,0,82,82
"30192",2015,0,0,49,49
"30192",2016,0,0,97,97
"30192",2017,0,0,33,33
"30192",2019,0,0,98,98
"30192",2020,0,0,24,24
"30193",2014,0,60,82,142
"30193",2015,0,37,49,86
"30193",2016,0,97,83,180
"30193",2017,0,51,33,84
"30193",2019,0,108,98,206
"30193",2020,0,0,19,19
"30194",2014,0,0,37,37
"30194",2015,0,0,44,44
"30194",2016,0,0,97,97
"30194",2017,0,0,51,51
"30194",2019,0,0,98,98
"30194",2020,0,0,81,81
"30195",2014,0,0,60,60
"30195",2015,0,0,49,49
"30195",2016,0,0,97,97
"30195",2017,0,0,51,51
"30195",2019,0,0,98,98
"30195",2020,0,0,62,62
"30196",2014,0,0,37,37
"30196",2015,0,0,49,49
"30196",2016,0,0,97,97
"30196",2017,0,0,14,14
"30196",2019,0,0,55,55
"30196",2020,0,0,81,81
"30197",2014,0,0,37,37
"30197",2015,0,0,44,44
"30197",2016,0,0,97,97
"30197",2017,0,0,51,51
"30197",2019,0,0,98,98
"30197",2020,0,0,81,81
"30198",2014,0,0,60,60
"30198",2015,0,0,49,49
"30198",2016,0,0,97,97
"30198",2017,0,0,65,65
"30198",2019,0,0,73,73
"30198",2020,0,0,62,62
"30199",2014,0,0,82,82
"30199",2015,0,0,49,49
"30199",2016,0,0,97,97
"30199",2017,0,0,111,111
"30199",2019,0,0,73,73
"30199",2020,0,0,62,62
"30200",2014,0,0,82,82
"30200",2015,0,0,49,49
"30200",2016,0,0,97,97
"30200",2017,0,0,33,33
"30200",2019,0,0,98,98
"30200",2020,0,0,24,24
"30201",2014,0,0,37,37
"30201",2015,0,0,44,44
"30201",2016,0,0,21,21
"30201",2019,0,0,73,73
"30201",2020,0,0,38,38
"30202",2014,0,0,60,60
"30202",2015,0,0,49,49
"30202",2016,0,0,21,21
"30202",2017,0,0,46,46
"30202",2019,0,0,73,73
"30202",2020,0,0,38,38
"30203",2014,0,0,37,37
"30203",2015,0,0,44,44
"30203",2016,0,0,97,97
"30203",2017,0,0,51,51
"30203",2019,0,0,98,98
"30203",2020,0,0,81,81
"30204",2014,0,0,37,37
"30204",2015,0,0,44,44
"30204",2016,0,0,97,97
"30204",2017,0,0,51,51
"30204",2019,0,0,98,98
"30204",2020,0,0,81,81
"30205",2014,0,60,37,97
"30205",2015,0,37,49,86
"30205",2016,0,97,83,180
"30205",2017,0,51,14,65
"30205",2019,0,108,55,163
"30205",2020,0,0,24,24
"30206",2014,0,60,82,142
"30206",2015,0,37,49,86
"30206",2016,0,97,18,115
"30206",2017,0,51,33,84
"30206",2018,0,0,76,76
"30206",2019,0,108,98,206
"30206",2020,0,0,19,19
"30207",2014,0,60,37,97
"30207",2015,0,37,49,86
"30207",2016,0,97,83,180
"30207",2017,0,51,14,65
"30207",2019,0,108,55,163
"30207",2020,0,0,24,24
"30208",2014,0,0,82,82
"30208",2015,0,0,49,49
"30208",2016,0,0,97,97
"30208",2017,0,0,33,33
"30208",2019,0,0,98,98
"30208",2020,0,0,24,24
"30209",2014,0,0,82,82
"30209",2016,0,0,97,97
"30209",2017,0,0,187,187
"30209",2019,0,0,92,92
"30209",2020,0,0,81,81
"30210",2014,0,0,82,82
"30210",2015,0,0,49,49
"30210",2016,0,0,97,97
"30210",2017,0,0,33,33
"30210",2019,0,0,98,98
"30210",2020,0,0,24,24
"30211",2014,0,0,82,82
"30211",2016,0,30,18,48
"30211",2017,0,33,33,66
"30211",2018,0,76,76,152
"30211",2019,0,108,108,216
"30211",2020,0,14,33,47
"30212",2014,0,60,82,142
"30212",2015,0,37,49,86
"30212",2016,0,97,83,180
"30212",2017,0,51,33,84
"30212",2019,0,108,98,206
"30212",2020,0,0,19,19
"30213",2014,0,0,82,82
"30213",2015,0,0,49,49
"30213",2016,0,0,97,97
"30213",2017,0,0,97,97
"30213",2019,0,0,190,190
"30213",2020,0,0,62,62
"30214",2014,0,60,60,120
"30214",2015,0,37,49,86
"30214",2016,0,97,97,194
"30214",2017,0,51,51,102
"30214",2019,0,108,98,206
"30214",2020,0,0,62,62
"30215",2014,0,0,37,37
"30215",2015,0,0,44,44
"30215",2016,0,0,97,97
"30215",2017,0,0,14,14
"30215",2019,0,0,55,55
"30215",2020,0,0,81,81
"30216",2014,0,0,37,37
"30216",2015,0,0,44,44
"30216",2016,0,0,97,97
"30216",2017,0,0,51,51
"30216",2019,0,0,98,98
"30216",2020,0,0,81,81
"30217",2014,0,0,82,82
"30217",2015,0,0,49,49
"30217",2016,0,0,83,83
"30217",2017,0,0,33,33
"30217",2019,0,0,98,98
"30217",2020,0,0,24,24
"30218",2014,0,0,37,37
"30218",2015,0,0,44,44
"30218",2016,0,0,97,97
"30218",2017,0,0,51,51
"30218",2019,0,0,98,98
"30218",2020,0,0,81,81
"30219",2014,0,0,82,82
"30219",2015,0,0,49,49
"30219",2016,0,0,97,97
"30219",2017,0,0,111,111
"30219",2019,0,0,73,73
"30219",2020,0,0,62,62
"30220",2014,0,0,82,82
"30220",2015,0,0,49,49
"30220",2016,0,0,97,97
"30220",2017,0,0,111,111
"30220",2019,0,0,73,73
"30220",2020,0,0,62,62
"30221",2014,0,0,82,82
"30221",2016,0,0,97,97
"30221",2017,0,0,187,187
"30221",2019,0,0,92,92
"30221",2020,0,0,81,81
"30222",2014,0,0,37,37
"30222",2015,0,0,49,49
"30222",2016,0,0,97,97
"30222",2017,0,0,14,14
"30222",2019,0,0,55,55
"30222",2020,0,0,81,81
"30223",2014,0,0,37,37
"30223",2015,0,0,44,44
"30223",2016,0,0,97,97
"30223",2017,0,0,51,51
"30223",2019,0,0,98,98
"30223",2020,0,0,81,81
"30224",2014,0,60,82,142
"30224",2015,0,37,49,86
"30224",2016,0,97,83,180
"30224",2017,0,51,33,84
"30224",2019,0,108,98,206
"30224",2020,0,0,19,19
"30225",2014,0,0,37,37
"30225",2015,0,0,49,49
"30225",2016,0,0,97,97
"30225",2017,0,0,14,14
"30225",2019,0,0,55,55
"30225",2020,0,0,81,81
"30226",2014,0,0,37,37
"30226",2015,0,0,49,49
"30226",2016,0,0,21,21
"30226",2017,0,0,14,14
"30226",2019,0,0,55,55
"30226",2020,0,0,38,38
"30227",2014,0,0,37,37
"30227",2015,0,0,44,44
"30227",2016,0,0,97,97
"30227",2017,0,0,51,51
"30227",2019,0,0,98,98
"30227",2020,0,0,81,81
"30228",2014,0,60,82,142
"30228",2015,0,37,49,86
"30228",2016,0,97,83,180
"30228",2017,0,51,33,84
"30228",2019,0,108,98,206
"30228",2020,0,0,19,19
"30229",2014,0,0,82,82
"30229",2015,0,0,49,49
"30229",2016,0,0,97,97
"30229",2017,0,0,111,111
"30229",2019,0,0,73,73
"30229",2020,0,0,62,62
"30230",2014,0,0,37,37
"30230",2015,0,0,49,49
"30230",2016,0,0,97,97
"30230",2017,0,0,14,14
"30230",2019,0,0,55,55
"30230",2020,0,0,81,81
"30231",2014,0,0,60,60
"30231",2015,0,0,49,49
"30231",2016,0,0,97,97
"30231",2017,0,0,65,65
"30231",2019,0,0,73,73
"30231",2020,0,0,62,62
"30232",2014,0,0,37,37
"30232",2015,0,0,49,49
"30232",2016,0,0,97,97
"30232",2017,0,0,14,14
"30232",2019,0,0,55,55
"30232",2020,0,0,81,81
"30233",2014,0,60,82,142
"30233",2015,0,37,49,86
"30233",2016,0,97,83,180
"30233",2017,0,51,33,84
"30233",2019,0,108,98,206
"30233",2020,0,0,19,19
"30234",2014,0,60,60,120
"30234",2015,0,37,49,86
"30234",2016,0,97,83,180
"30234",2017,0,51,33,84
"30234",2019,0,108,98,206
"30234",2020,0,0,24,24
"30235",2014,0,60,82,142
"30235",2015,0,37,49,86
"30235",2016,0,97,83,180
"30235",2017,0,51,33,84
"30235",2019,0,108,98,206
"30235",2020,0,0,19,19
"30236",2014,0,0,60,60
"30236",2015,0,0,49,49
"30236",2016,0,0,97,97
"30236",2017,0,0,51,51
"30236",2019,0,0,98,98
"30236",2020,0,0,62,62
"30237",2014,0,0,37,37
"30237",2015,0,0,44,44
"30237",2016,0,0,97,97
"30237",2017,0,0,51,51
"30237",2019,0,0,98,98
"30237",2020,0,0,81,81
"30238",2014,0,0,82,82
"30238",2015,0,0,49,49
"30238",2016,0,0,97,97
"30238",2017,0,0,111,111
"30238",2019,0,0,73,73
"30238",2020,0,0,62,62
"30239",2014,0,0,37,37
"30239",2015,0,0,44,44
"30239",2016,0,0,97,97
"30239",2017,0,0,51,51
"30239",2019,0,0,98,98
"30239",2020,0,0,81,81
"30240",2014,0,60,82,142
"30240",2015,0,37,49,86
"30240",2016,0,97,83,180
"30240",2017,0,51,33,84
"30240",2019,0,108,98,206
"30240",2020,0,0,19,19
"30241",2014,0,60,82,142
"30241",2015,0,37,49,86
"30241",2016,0,97,83,180
"30241",2017,0,51,33,84
"30241",2019,0,108,98,206
"30241",2020,0,0,19,19
"30242",2014,0,0,37,37
"30242",2015,0,0,49,49
"30242",2016,0,0,21,21
"30242",2017,0,0,14,14
"30242",2019,0,0,55,55
"30242",2020,0,0,38,38
"30243",2014,0,0,60,60
"30243",2015,0,0,49,49
"30243",2016,0,0,97,97
"30243",2017,0,0,51,51
"30243",2019,0,0,98,98
"30243",2020,0,0,62,62
"30244",2014,0,0,82,82
"30244",2015,0,0,49,49
"30244",2016,0,0,97,97
"30244",2017,0,0,33,33
"30244",2019,0,0,98,98
"30244",2020,0,0,24,24
"30245",2014,0,60,82,142
"30245",2015,0,37,49,86
"30245",2016,0,97,18,115
"30245",2017,0,51,33,84
"30245",2018,0,0,76,76
"30245",2019,0,108,98,206
"30245",2020,0,0,24,24
"30246",2014,0,0,60,60
"30246",2015,0,0,49,49
"30246",2016,0,0,97,97
"30246",2017,0,0,51,51
"30246",2019,0,0,98,98
"30246",2020,0,0,62,62
"30247",2014,0,0,37,37
"30247",2015,0,0,44,44
"30247",2016,0,0,97,97
"30247",2017,0,0,51,51
"30247",2019,0,0,98,98
"30247",2020,0,0,81,81
"30248",2014,0,60,82,142
"30248",2015,0,37,49,86
"30248",2016,0,97,83,180
"30248",2017,0,51,33,84
"30248",2019,0,108,98,206
"30248",2020,0,0,19,19
"30249",2014,0,0,82,82
"30249",2016,0,0,18,18
"30249",2017,0,0,33,33
"30249",2018,0,0,76,76
"30249",2019,0,0,108,108
"30249",2020,0,0,33,33
"30250",2014,0,60,82,142
"30250",2015,0,37,49,86
"30250",2016,0,97,83,180
"30250",2017,0,51,33,84
"30250",2019,0,108,98,206
"30250",2020,0,0,19,19
"30251",2014,0,0,82,82
"30251",2016,0,0,97,97
"30251",2017,0,0,187,187
"30251",2019,0,0,92,92
"30251",2020,0,0,81,81
"30252",2014,0,0,60,60
"30252",2015,0,0,49,49
"30252",2016,0,0,97,97
"30252",2017,0,0,33,33
"30252",2019,0,0,98,98
"30252",2020,0,0,24,24
"30253",2014,0,0,37,37
"30253",2015,0,0,44,44
"30253",2016,0,0,97,97
"30253",2017,0,0,51,51
"30253",2019,0,0,98,98
"30253",2020,0,0,81,81
"30254",2014,0,0,82,82
"30254",2016,0,0,97,97
"30254",2017,0,0,187,187
"30254",2019,0,0,92,92
"30254",2020,0,0,81,81
"30255",2014,0,60,82,142
"30255",2015,0,37,49,86
"30255",2016,0,97,83,180
"30255",2017,0,51,33,84
"30255",2019,0,108,98,206
"30255",2020,0,0,19,19
"30256",2014,0,0,37,37
"30256",2015,0,0,49,49
"30256",2016,0,0,97,97
"30256",2017,0,0,14,14
"30256",2019,0,0,55,55
"30256",2020,0,0,81,81
"30257",2014,0,0,82,82
"30257",2016,0,30,18,48
"30257",2017,0,33,33,66
"30257",2018,0,76,76,152
"30257",2019,0,108,108,216
"30257",2020,0,14,33,47
"30258",2014,0,0,82,82
"30258",2016,0,30,18,48
"30258",2017,0,33,33,66
"30258",2018,0,76,76,152
"30258",2019,0,108,108,216
"30258",2020,0,14,38,52
"30259",2014,0,60,60,120
"30259",2015,0,37,49,86
"30259",2016,0,97,83,180
"30259",2017,0,51,33,84
"30259",2019,0,108,98,206
"30259",2020,0,0,19,19
"30260",2014,0,60,82,142
"30260",2015,0,37,49,86
"30260",2016,0,97,83,180
"30260",2017,0,51,33,84
"30260",2019,0,108,98,206
"30260",2020,0,0,19,19
"30261",2014,0,60,82,142
"30261",2015,0,37,49,86
"30261",2016,0,97,83,180
"30261",2017,0,51,33,84
"30261",2019,0,108,98,206
"30261",2020,0,0,19,19
"30262",2014,0,60,82,142
"30262",2015,0,37,49,86
"30262",2016,0,97,83,180
"30262",2017,0,51,33,84
"30262",2019,0,108,98,206
"30262",2020,0,0,19,19
"30263",2014,0,0,82,82
"30263",2015,0,0,49,49
"30263",2016,0,0,97,97
"30263",2017,0,0,47,47
"30263",2019,0,0,73,73
"30263",2020,0,0,24,24
"30264",2014,0,60,82,142
"30264",2015,0,37,49,86
"30264",2016,0,97,83,180
"30264",2017,0,51,33,84
"30264",2019,0,108,98,206
"30264",2020,0,0,19,19
"30265",2014,0,0,82,82
"30265",2015,0,0,49,49
"30265",2016,0,0,97,97
"30265",2017,0,0,33,33
"30265",2019,0,0,98,98
"30265",2020,0,0,24,24
"30266",2014,0,0,37,37
"30266",2015,0,0,44,44
"30266",2016,0,0,97,97
"30266",2017,0,0,14,14
"30266",2019,0,0,55,55
"30266",2020,0,0,81,81
"30267",2014,0,0,60,60
"30267",2015,0,0,49,49
"30267",2016,0,0,97,97
"30267",2017,0,0,33,33
"30267",2019,0,0,98,98
"30267",2020,0,0,24,24
"30268",2014,0,0,37,37
"30268",2015,0,0,44,44
"30268",2016,0,0,97,97
"30268",2017,0,0,51,51
"30268",2019,0,0,98,98
"30268",2020,0,0,81,81
"30269",2014,0,0,60,60
"30269",2015,0,0,49,49
"30269",2016,0,0,97,97
"30269",2017,0,0,51,51
"30269",2019,0,0,98,98
"30269",2020,0,0,62,62
"30270",2014,0,0,60,60
"30270",2015,0,0,49,49
"30270",2016,0,0,97,97
"30270",2017,0,0,51,51
"30270",2019,0,0,98,98
"30270",2020,0,0,62,62
"30271",2014,0,0,37,37
"30271",2015,0,0,44,44
"30271",2016,0,0,97,97
"30271",2017,0,0,51,51
"30271",2019,0,0,98,98
"30271",2020,0,0,81,81
"30272",2014,0,0,82,82
"30272",2015,0,0,49,49
"30272",2016,0,0,97,97
"30272",2017,0,0,111,111
"30272",2019,0,0,73,73
"30272",2020,0,0,62,62
"30273",2014,0,0,60,60
"30273",2015,0,0,49,49
"30273",2016,0,0,21,21
"30273",2017,0,0,46,46
"30273",2019,0,0,73,73
"30273",2020,0,0,38,38
"30274",2014,0,0,60,60
"30274",2015,0,0,49,49
"30274",2016,0,0,97,97
"30274",2017,0,0,51,51
"30274",2019,0,0,98,98
"30274",2020,0,0,62,62
"30275",2014,0,60,37,97
"30275",2015,0,37,44,81
"30275",2016,0,97,83,180
"30275",2017,0,51,33,84
"30275",2019,0,108,98,206
"30275",2020,0,0,24,24
"30276",2014,0,0,82,82
"30276",2015,0,0,49,49
"30276",2016,0,30,18,48
"30276",2017,0,33,33,66
"30276",2018,0,76,76,152
"30276",2019,0,108,98,206
"30276",2020,0,14,24,38
"30277",2014,0,0,37,37
"30277",2015,0,0,49,49
"30277",2016,0,0,21,21
"30277",2017,0,0,14,14
"30277",2019,0,0,55,55
"30277",2020,0,0,38,38
"30278",2014,0,0,37,37
"30278",2015,0,0,49,49
"30278",2016,0,0,97,97
"30278",2017,0,0,14,14
"30278",2019,0,0,55,55
"30278",2020,0,0,81,81
"30279",2014,0,60,37,97
"30279",2015,0,37,49,86
"30279",2016,0,97,83,180
"30279",2017,0,51,14,65
"30279",2019,0,108,55,163
"30279",2020,0,0,24,24
"30280",2014,0,0,82,82
"30280",2015,0,0,49,49
"30280",2016,0,0,97,97
"30280",2017,0,0,111,111
"30280",2019,0,0,73,73
"30280",2020,0,0,62,62
"30281",2014,0,60,82,142
"30281",2015,0,37,49,86
"30281",2016,0,97,83,180
"30281",2017,0,51,33,84
"30281",2019,0,108,98,206
"30281",2020,0,0,19,19
"30282",2014,0,0,37,37
"30282",2015,0,0,49,49
"30282",2016,0,0,97,97
"30282",2017,0,0,14,14
"30282",2019,0,0,55,55
"30282",2020,0,0,81,81
"30283",2014,0,0,60,60
"30283",2015,0,0,49,49
"30283",2016,0,0,97,97
"30283",2017,0,0,65,65
"30283",2019,0,0,73,73
"30283",2020,0,0,62,62
"30284",2014,0,0,60,60
"30284",2015,0,0,49,49
"30284",2016,0,0,97,97
"30284",2017,0,0,51,51
"30284",2019,0,0,98,98
"30284",2020,0,0,62,62
"30285",2014,0,60,82,142
"30285",2015,0,37,49,86
"30285",2016,0,97,83,180
"30285",2017,0,51,33,84
"30285",2019,0,108,98,206
"30285",2020,0,0,19,19
"30286",2014,0,60,82,142
"30286",2015,0,37,49,86
"30286",2016,0,97,83,180
"30286",2017,0,51,33,84
"30286",2019,0,108,98,206
"30286",2020,0,0,19,19
"30287",2014,0,0,37,37
"30287",2015,0,0,49,49
"30287",2016,0,0,21,21
"30287",2017,0,0,14,14
"30287",2019,0,0,55,55
"30287",2020,0,0,38,38
"30288",2014,0,0,37,37
"30288",2015,0,0,49,49
"30288",2016,0,0,97,97
"30288",2017,0,0,14,14
"30288",2019,0,0,55,55
"30288",2020,0,0,81,81
"30289",2014,0,0,82,82
"30289",2015,0,0,49,49
"30289",2016,0,0,97,97
"30289",2017,0,0,33,33
"30289",2019,0,0,98,98
"30289",2020,0,0,24,24
"30290",2014,0,0,60,60
"30290",2015,0,0,49,49
"30290",2016,0,0,21,21
"30290",2017,0,0,46,46
"30290",2019,0,0,73,73
"30290",2020,0,0,38,38
"30291",2014,0,0,60,60
"30291",2015,0,0,49,49
"30291",2016,0,0,97,97
"30291",2017,0,0,51,51
"30291",2019,0,0,98,98
"30291",2020,0,0,62,62
"30292",2014,0,0,37,37
"30292",2015,0,0,49,49
"30292",2016,0,0,97,97
"30292",2017,0,0,14,14
"30292",2019,0,0,55,55
"30292",2020,0,0,81,81
"30293",2014,0,0,37,37
"30293",2015,0,0,44,44
"30293",2016,0,0,97,97
"30293",2017,0,0,14,14
"30293",2019,0,0,55,55
"30293",2020,0,0,81,81
"30294",2014,0,0,60,60
"30294",2015,0,0,49,49
"30294",2016,0,0,83,83
"30294",2017,0,0,33,33
"30294",2019,0,0,98,98
"30294",2020,0,0,19,19
"30295",2014,0,60,37,97
"30295",2015,0,37,49,86
"30295",2016,0,97,83,180
"30295",2017,0,51,14,65
"30295",2019,0,108,55,163
"30295",2020,0,0,24,24
"30296",2014,0,0,60,60
"30296",2015,0,0,49,49
"30296",2016,0,0,97,97
"30296",2017,0,0,47,47
"30296",2019,0,0,73,73
"30296",2020,0,0,24,24
"30297",2014,0,0,82,82
"30297",2015,0,0,49,49
"30297",2016,0,0,97,97
"30297",2017,0,0,111,111
"30297",2019,0,0,73,73
"30297",2020,0,0,62,62
"30298",2014,0,0,60,60
"30298",2015,0,0,49,49
"30298",2016,0,0,97,97
"30298",2017,0,0,51,51
"30298",2019,0,0,98,98
"30298",2020,0,0,62,62
"30299",2014,0,60,82,142
"30299",2015,0,37,49,86
"30299",2016,0,97,83,180
"30299",2017,0,51,33,84
"30299",2019,0,108,98,206
"30299",2020,0,0,19,19
"30300",2014,0,0,82,82
"30300",2015,0,0,49,49
"30300",2016,0,0,97,97
"30300",2017,0,0,33,33
"30300",2019,0,0,98,98
"30300",2020,0,0,24,24
"30301",2014,0,60,82,142
"30301",2015,0,37,49,86
"30301",2016,0,97,83,180
"30301",2017,0,51,33,84
"30301",2019,0,108,98,206
"30301",2020,0,0,19,19
"30302",2014,0,0,37,37
"30302",2015,0,0,49,49
"30302",2016,0,0,83,83
"30302",2017,0,0,14,14
"30302",2019,0,0,55,55
"30302",2020,0,0,24,24
"30303",2014,0,0,37,37
"30303",2015,0,0,44,44
"30303",2016,0,0,97,97
"30303",2017,0,0,51,51
"30303",2019,0,0,98,98
"30303",2020,0,0,81,81
"30304",2014,0,0,37,37
"30304",2015,0,0,49,49
"30304",2016,0,0,21,21
"30304",2017,0,0,14,14
"30304",2019,0,0,55,55
"30304",2020,0,0,38,38
"30305",2014,0,0,37,37
"30305",2015,0,0,44,44
"30305",2016,0,0,97,97
"30305",2017,0,0,51,51
"30305",2019,0,0,98,98
"30305",2020,0,0,81,81
"30306",2014,0,60,82,142
"30306",2015,0,37,49,86
"30306",2016,0,97,97,194
"30306",2017,0,51,33,84
"30306",2019,0,108,98,206
"30306",2020,0,0,24,24
"30307",2014,0,0,60,60
"30307",2015,0,0,49,49
"30307",2016,0,0,97,97
"30307",2017,0,0,51,51
"30307",2019,0,0,98,98
"30307",2020,0,0,62,62
"30308",2014,0,60,82,142
"30308",2015,0,37,49,86
"30308",2016,0,97,83,180
"30308",2017,0,51,33,84
"30308",2019,0,108,98,206
"30308",2020,0,0,19,19
"30309",2014,0,0,82,82
"30309",2015,0,0,49,49
"30309",2016,0,0,97,97
"30309",2017,0,0,33,33
"30309",2019,0,0,98,98
"30309",2020,0,0,24,24
"30310",2014,0,0,60,60
"30310",2015,0,0,49,49
"30310",2016,0,0,97,97
"30310",2017,0,0,51,51
"30310",2019,0,0,98,98
"30310",2020,0,0,62,62
"30311",2014,0,0,82,82
"30311",2015,0,0,49,49
"30311",2016,0,0,97,97
"30311",2017,0,0,33,33
"30311",2019,0,0,98,98
"30311",2020,0,0,24,24
"30312",2014,0,0,82,82
"30312",2016,0,0,97,97
"30312",2017,0,0,187,187
"30312",2019,0,0,92,92
"30312",2020,0,0,81,81
"30313",2014,0,60,82,142
"30313",2015,0,37,49,86
"30313",2016,0,97,83,180
"30313",2017,0,51,33,84
"30313",2019,0,108,98,206
"30313",2020,0,0,19,19
"30314",2014,0,0,82,82
"30314",2015,0,0,49,49
"30314",2016,0,0,97,97
"30314",2017,0,0,33,33
"30314",2019,0,0,98,98
"30314",2020,0,0,24,24
"30315",2014,0,0,82,82
"30315",2015,0,0,49,49
"30315",2016,0,0,83,83
"30315",2017,0,0,33,33
"30315",2019,0,0,98,98
"30315",2020,0,0,24,24
"30316",2014,0,0,37,37
"30316",2015,0,0,44,44
"30316",2016,0,0,97,97
"30316",2017,0,0,51,51
"30316",2019,0,0,98,98
"30316",2020,0,0,81,81
"30317",2014,0,0,82,82
"30317",2015,0,0,49,49
"30317",2016,0,30,83,113
"30317",2017,0,33,33,66
"30317",2018,0,76,76,152
"30317",2019,0,108,98,206
"30317",2020,0,14,19,33
"30318",2014,0,0,37,37
"30318",2015,0,0,44,44
"30318",2016,0,0,97,97
"30318",2017,0,0,51,51
"30318",2019,0,0,98,98
"30318",2020,0,0,81,81
"30319",2014,0,60,82,142
"30319",2015,0,37,49,86
"30319",2016,0,97,83,180
"30319",2017,0,51,33,84
"30319",2019,0,108,98,206
"30319",2020,0,0,19,19
"30320",2014,0,60,37,97
"30320",2015,0,37,44,81
"30320",2016,0,97,83,180
"30320",2017,0,51,33,84
"30320",2019,0,108,98,206
"30320",2020,0,0,24,24
"30321",2014,0,60,82,142
"30321",2015,0,37,49,86
"30321",2016,0,97,97,194
"30321",2017,0,51,33,84
"30321",2019,0,108,98,206
"30321",2020,0,0,24,24
"30322",2014,0,0,60,60
"30322",2015,0,0,49,49
"30322",2016,0,0,97,97
"30322",2017,0,0,65,65
"30322",2019,0,0,73,73
"30322",2020,0,0,62,62
"30323",2014,0,0,60,60
"30323",2015,0,0,49,49
"30323",2016,0,0,97,97
"30323",2017,0,0,51,51
"30323",2019,0,0,98,98
"30323",2020,0,0,62,62
"30324",2014,0,60,82,142
"30324",2015,0,37,49,86
"30324",2016,0,97,97,194
"30324",2017,0,51,33,84
"30324",2019,0,108,98,206
"30324",2020,0,0,24,24
"30325",2014,0,0,82,82
"30325",2015,0,0,49,49
"30325",2016,0,0,97,97
"30325",2017,0,0,47,47
"30325",2019,0,0,73,73
"30325",2020,0,0,24,24
"30326",2014,0,0,82,82
"30326",2016,0,0,97,97
"30326",2017,0,0,187,187
"30326",2019,0,0,92,92
"30326",2020,0,0,81,81
"30327",2014,0,0,37,37
"30327",2015,0,0,44,44
"30327",2016,0,0,97,97
"30327",2017,0,0,14,14
"30327",2019,0,0,55,55
"30327",2020,0,0,81,81
"30328",2014,0,0,82,82
"30328",2015,0,0,49,49
"30328",2016,0,0,83,83
"30328",2017,0,0,33,33
"30328",2019,0,0,98,98
"30328",2020,0,0,24,24
"30329",2014,0,0,60,60
"30329",2015,0,0,49,49
"30329",2016,0,0,97,97
"30329",2017,0,0,51,51
"30329",2019,0,0,98,98
"30329",2020,0,0,62,62
"30330",2014,0,0,60,60
"30330",2015,0,0,49,49
"30330",2016,0,0,97,97
"30330",2017,0,0,33,33
"30330",2019,0,0,98,98
"30330",2020,0,0,24,24
"30331",2014,0,0,37,37
"30331",2015,0,0,49,49
"30331",2016,0,0,97,97
"30331",2017,0,0,14,14
"30331",2019,0,0,55,55
"30331",2020,0,0,81,81
"30332",2014,0,0,82,82
"30332",2015,0,0,49,49
"30332",2016,0,0,97,97
"30332",2017,0,0,97,97
"30332",2019,0,0,190,190
"30332",2020,0,0,62,62
"30333",2014,0,0,82,82
"30333",2016,0,30,18,48
"30333",2017,0,33,33,66
"30333",2018,0,76,76,152
"30333",2019,0,108,108,216
"30333",2020,0,14,33,47
"30334",2014,0,60,37,97
"30334",2015,0,37,49,86
"30334",2016,0,97,83,180
"30334",2017,0,51,14,65
"30334",2019,0,108,55,163
"30334",2020,0,0,24,24
"30335",2014,0,0,60,60
"30335",2015,0,0,49,49
"30335",2016,0,0,97,97
"30335",2017,0,0,33,33
"30335",2019,0,0,98,98
"30335",2020,0,0,24,24
"30336",2014,0,0,82,82
"30336",2015,0,0,49,49
"30336",2016,0,0,83,83
"30336",2017,0,0,33,33
"30336",2019,0,0,98,98
"30336",2020,0,0,24,24
"30337",2014,0,60,37,97
"30337",2015,0,37,49,86
"30337",2016,0,97,83,180
"30337",2017,0,51,14,65
"30337",2019,0,108,55,163
"30337",2020,0,0,24,24
"30338",2014,0,60,37,97
"30338",2015,0,37,49,86
"30338",2016,0,97,83,180
"30338",2017,0,51,14,65
"30338",2019,0,108,55,163
"30338",2020,0,0,24,24
"30339",2014,0,0,60,60
"30339",2015,0,0,49,49
"30339",2016,0,0,97,97
"30339",2017,0,0,65,65
"30339",2019,0,0,73,73
"30339",2020,0,0,62,62
"30340",2014,0,0,82,82
"30340",2015,0,0,49,49
"30340",2016,0,0,83,83
"30340",2017,0,0,33,33
"30340",2019,0,0,98,98
"30340",2020,0,0,24,24
"30341",2014,0,0,82,82
"30341",2016,0,30,18,48
"30341",2017,0,33,33,66
"30341",2018,0,76,76,152
"30341",2019,0,108,108,216
"30341",2020,0,14,38,52
"30342",2014,0,0,37,37
"30342",2015,0,0,49,49
"30342",2016,0,0,97,97
"30342",2017,0,0,14,14
"30342",2019,0,0,55,55
"30342",2020,0,0,81,81
"30343",2014,0,0,37,37
"30343",2015,0,0,49,49
"30343",2016,0,0,97,97
"30343",2017,0,0,14,14
"30343",2019,0,0,55,55
"30343",2020,0,0,81,81
"30344",2014,0,0,82,82
"30344",2016,0,30,18,48
"30344",2017,0,33,33,66
"30344",2018,0,76,76,152
"30344",2019,0,108,108,216
"30344",2020,0,14,33,47
"30345",2014,0,0,37,37
"30345",2015,0,0,44,44
"30345",2016,0,0,97,97
"30345",2017,0,0,51,51
"30345",2019,0,0,98,98
"30345",2020,0,0,81,81
"30346",2014,0,60,82,142
"30346",2015,0,37,49,86
"30346",2016,0,97,83,180
"30346",2017,0,51,33,84
"30346",2019,0,108,98,206
"30346",2020,0,0,19,19
"30347",2014,0,0,82,82
"30347",2016,0,30,18,48
"30347",2017,0,33,33,66
"30347",2018,0,76,76,152
"30347",2019,0,108,108,216
"30347",2020,0,14,33,47
"30348",2014,0,60,60,120
"30348",2015,0,37,49,86
"30348",2016,0,97,83,180
"30348",2017,0,51,33,84
"30348",2019,0,108,98,206
"30348",2020,0,0,19,19
"30349",2014,0,60,82,142
"30349",2015,0,37,49,86
"30349",2016,0,97,97,194
"30349",2017,0,51,33,84
"30349",2019,0,108,98,206
"30349",2020,0,0,24,24
"30350",2014,0,0,82,82
"30350",2015,0,0,49,49
"30350",2016,0,0,97,97
"30350",2017,0,0,111,111
"30350",2019,0,0,73,73
"30350",2020,0,0,62,62
"30351",2014,0,0,82,82
"30351",2016,0,0,97,97
"30351",2017,0,0,187,187
"30351",2019,0,0,92,92
"30351",2020,0,0,81,81
"30352",2014,0,60,82,142
"30352",2015,0,37,49,86
"30352",2016,0,97,97,194
"30352",2017,0,51,33,84
"30352",2019,0,108,98,206
"30352",2020,0,0,24,24
"30353",2014,0,0,82,82
"30353",2015,0,0,49,49
"30353",2016,0,0,97,97
"30353",2017,0,0,111,111
"30353",2019,0,0,73,73
"30353",2020,0,0,62,62
"30354",2014,0,60,82,142
"30354",2015,0,37,49,86
"30354",2016,0,97,83,180
"30354",2017,0,51,33,84
"30354",2019,0,108,98,206
"30354",2020,0,0,24,24
"30355",2014,0,0,37,37
"30355",2015,0,0,49,49
"30355",2016,0,0,97,97
"30355",2017,0,0,14,14
"30355",2019,0,0,55,55
"30355",2020,0,0,81,81
"30356",2014,0,0,82,82
"30356",2016,0,30,18,48
"30356",2017,0,33,33,66
"30356",2018,0,76,76,152
"30356",2019,0,108,108,216
"30356",2020,0,14,33,47
"31005",2020,0,0,15,15
"31008",2020,0,0,15,15
"31018",2020,0,0,15,15
"31023",2020,0,0,15,15
"31028",2020,0,0,15,15
"31031",2020,0,0,15,15
"31034",2020,0,0,15,15
"31039",2020,0,0,15,15
"31043",2020,0,0,15,15
"31061",2020,0,0,15,15
"31063",2020,0,0,15,15
"31070",2020,0,0,15,15
"31072",2020,0,0,15,15
"31076",2020,0,0,15,15
"31077",2020,0,0,15,15
"31078",2020,0,0,15,15
"31080",2020,0,0,15,15
"31083",2020,0,0,15,15
"31086",2020,0,0,15,15
"31089",2020,0,0,15,15
"31098",2020,0,0,15,15
"31108",2020,0,0,15,15
"31109",2020,0,0,15,15
"31120",2020,0,0,15,15
"31121",2020,0,0,15,15
"31124",2020,0,0,15,15
"31126",2020,0,0,15,15
"31130",2020,0,0,15,15
"31134",2020,0,0,15,15
"31138",2020,0,0,15,15
"31141",2020,0,0,15,15
"31147",2020,0,0,15,15
"31158",2020,0,0,15,15
"31159",2020,0,0,15,15
"31160",2020,0,0,15,15
"31168",2020,0,0,15,15
"31170",2020,0,0,15,15
"31172",2020,0,0,15,15
"31193",2020,0,0,15,15
"31196",2020,0,0,15,15
"31197",2020,0,0,15,15
"31198",2020,0,0,15,15
"31204",2020,0,0,15,15
"31218",2020,0,0,15,15
"31232",2020,0,0,15,15
"31239",2020,0,0,15,15
"31260",2020,0,0,15,15
"31268",2020,0,0,15,15
"31274",2020,0,0,15,15
"31276",2020,0,0,15,15
"31277",2020,0,0,15,15
"31278",2020,0,0,15,15
"31281",2020,0,0,15,15
"31289",2020,0,0,15,15
"31292",2020,0,0,15,15
"31295",2020,0,0,15,15
"31297",2020,0,0,15,15
"31300",2020,0,0,15,15
"31301",2020,0,0,15,15
"31302",2020,0,0,15,15
"31305",2020,0,0,15,15
"31309",2020,0,0,15,15
"31314",2020,0,0,15,15
"31322",2020,0,0,15,15
"31338",2020,0,0,15,15
"31339",2020,0,0,15,15
"31341",2020,0,0,15,15
"31343",2020,0,0,15,15
"31347",2020,0,0,15,15
"31349",2020,0,0,15,15
"31350",2020,0,0,15,15
"31351",2020,0,0,15,15
"31356",2020,0,0,15,15
"31363",2020,0,0,15,15
"31370",2020,0,0,15,15
"31373",2020,0,0,15,15
"31378",2020,0,0,15,15
"31385",2020,0,0,15,15
"31386",2020,0,0,15,15
"31387",2020,0,0,15,15
"31390",2020,0,0,15,15
"31397",2020,0,0,15,15
"31398",2020,0,0,15,15
"31403",2020,0,0,15,15
"31412",2020,0,0,15,15
"31414",2020,0,0,15,15
"31415",2020,0,0,15,15
"31430",2020,0,0,15,15
"31440",2020,0,0,15,15
"31443",2020,0,0,15,15
"31468",2020,0,0,15,15
"31477",2020,0,0,15,15
"31479",2020,0,0,15,15
"31482",2020,0,0,15,15
"31483",2020,0,0,15,15
"31487",2020,0,0,15,15
"31493",2020,0,0,15,15
"31494",2020,0,0,15,15
"31496",2020,0,0,15,15
"31498",2020,0,0,15,15
"31502",2020,0,0,15,15
"31503",2020,0,0,15,15
"31507",2020,0,0,15,15
"31510",2020,0,0,15,15
"31513",2020,0,0,15,15
"31522",2020,0,0,15,15
"31528",2020,0,0,15,15
"31529",2020,0,0,15,15
"31530",2020,0,0,15,15
"31531",2020,0,0,15,15
"31532",2020,0,0,15,15
"31536",2020,0,0,15,15
"31539",2020,0,0,15,15
"31545",2020,0,0,15,15
"31552",2020,0,0,15,15
"31553",2020,0,0,15,15
"31556",2020,0,0,15,15
"31584",2020,0,0,15,15
"31585",2020,0,0,15,15
"31586",2020,0,0,15,15
"31592",2020,0,0,15,15
"32002",2017,0,0,16,16
"32002",2020,0,0,61,61
"32003",2017,0,0,16,16
"32004",2017,0,0,42,42
"32008",2017,0,0,16,16
"32010",2017,0,0,16,16
"32010",2020,0,0,61,61
"32012",2017,0,0,16,16
"32012",2020,0,0,61,61
"32013",2017,0,0,16,16
"32013",2020,0,0,61,61
"32015",2017,0,0,16,16
"32015",2020,0,0,61,61
"32016",2017,0,0,16,16
"32016",2020,0,0,61,61
"32017",2017,0,0,56,56
"32017",2020,0,0,36,36
"32018",2017,0,0,16,16
"32018",2020,0,0,61,61
"32019",2017,0,0,16,16
"32019",2020,0,0,61,61
"32020",2017,0,0,16,16
"32020",2020,0,0,61,61
"32021",2017,0,0,16,16
"32021",2020,0,0,61,61
"32023",2017,0,0,16,16
"32023",2020,0,0,61,61
"32024",2017,0,0,16,16
"32027",2015,0,0,56,56
"32027",2016,0,0,8,8
"32027",2017,0,0,56,56
"32027",2020,0,0,36,36
"32028",2017,0,0,16,16
"32028",2020,0,0,61,61
"32029",2017,0,0,16,16
"32029",2020,0,0,61,61
"32030",2017,0,0,16,16
"32030",2020,0,0,61,61
"32032",2017,0,0,4,4
"32032",2020,0,0,61,61
"32033",2017,0,0,16,16
"32033",2020,0,0,61,61
"32034",2017,0,0,16,16
"32034",2020,0,0,61,61
"32035",2017,0,0,16,16
"32035",2020,0,0,61,61
"32036",2017,0,0,4,4
"32036",2020,0,0,61,61
"32037",2017,0,0,16,16
"32037",2020,0,0,61,61
"32039",2017,0,0,16,16
"32040",2017,0,0,16,16
"32040",2020,0,0,61,61
"32041",2017,0,0,16,16
"32041",2020,0,0,61,61
"32042",2017,0,0,16,16
"32042",2020,0,0,61,61
"32043",2017,0,0,4,4
"32043",2020,0,0,61,61
"32045",2017,0,0,16,16
"32045",2020,0,0,61,61
"32046",2015,0,0,56,56
"32046",2016,0,0,8,8
"32046",2017,0,0,56,56
"32046",2020,0,0,36,36
"32048",2017,0,0,16,16
"32048",2020,0,0,61,61
"32050",2017,0,0,16,16
"32051",2017,0,0,16,16
"32051",2020,0,0,61,61
"32052",2017,0,0,16,16
"32052",2020,0,0,61,61
"32053",2017,0,0,16,16
"32053",2020,0,0,61,61
"32054",2017,0,0,16,16
"32054",2020,0,0,61,61
"32055",2017,0,0,16,16
"32055",2020,0,0,61,61
"32056",2017,0,0,16,16
"32056",2020,0,0,61,61
"32059",2017,0,0,16,16
"32059",2020,0,0,61,61
"32060",2017,0,0,16,16
"32060",2020,0,0,61,61
"32061",2017,0,0,16,16
"32061",2020,0,0,61,61
"32065",2017,0,0,16,16
"32065",2020,0,0,61,61
"32067",2017,0,0,16,16
"32067",2020,0,0,61,61
"32069",2017,0,0,16,16
"32069",2020,0,0,61,61
"32070",2015,0,0,56,56
"32070",2016,0,0,8,8
"32070",2017,0,0,42,42
"32070",2020,0,0,36,36
"32071",2017,0,0,16,16
"32071",2020,0,0,61,61
"32072",2017,0,0,16,16
"32072",2020,0,0,61,61
"32075",2017,0,0,16,16
"32075",2020,0,0,61,61
"32076",2017,0,0,16,16
"32076",2020,0,0,61,61
"32077",2017,0,0,16,16
"32077",2020,0,0,61,61
"32078",2017,0,0,16,16
"32078",2020,0,0,61,61
"32082",2017,0,0,16,16
"32082",2020,0,0,61,61
"32083",2017,0,0,16,16
"32083",2020,0,0,61,61
"32086",2017,0,0,16,16
"32086",2020,0,0,61,61
"32088",2017,0,0,4,4
"32088",2020,0,0,61,61
"32090",2017,0,0,16,16
"32090",2020,0,0,61,61
"32093",2015,0,0,56,56
"32093",2016,0,0,8,8
"32093",2017,0,0,2,2
"32093",2020,0,0,36,36
"32097",2017,0,0,4,4
"32097",2020,0,0,61,61
"32098",2017,0,0,16,16
"32098",2020,0,0,61,61
"32099",2017,0,0,16,16
"32101",2017,0,0,16,16
"32101",2020,0,0,61,61
"32103",2017,0,0,16,16
"32103",2020,0,0,61,61
"32107",2017,0,0,16,16
"32107",2020,0,0,61,61
"32108",2015,0,0,56,56
"32108",2016,0,0,8,8
"32108",2017,0,0,42,42
"32108",2020,0,0,36,36
"32110",2017,0,0,4,4
"32110",2020,0,0,61,61
"32114",2017,0,0,16,16
"32114",2020,0,0,61,61
"32116",2017,0,0,16,16
"32116",2020,0,0,61,61
"32121",2017,0,0,16,16
"32121",2020,0,0,61,61
"32123",2017,0,0,16,16
"32123",2020,0,0,61,61
"32124",2017,0,0,16,16
"32124",2020,0,0,61,61
"32126",2017,0,0,16,16
"32126",2020,0,0,61,61
"32128",2017,0,0,16,16
"32128",2020,0,0,61,61
"32129",2017,0,0,16,16
"32129",2020,0,0,61,61
"32130",2017,0,0,16,16
"32130",2020,0,0,61,61
"32132",2017,0,0,16,16
"32132",2020,0,0,61,61
"32136",2015,0,0,56,56
"32136",2016,0,0,8,8
"32136",2017,0,0,2,2
"32136",2020,0,0,36,36
"32138",2017,0,0,16,16
"32138",2020,0,0,61,61
"32140",2017,0,0,16,16
"32140",2020,0,0,61,61
"32141",2017,0,0,16,16
"32141",2020,0,0,61,61
"32142",2017,0,0,16,16
"32142",2020,0,0,61,61
"32145",2015,0,0,56,56
"32145",2016,0,0,8,8
"32145",2017,0,0,42,42
"32145",2020,0,0,36,36
"32147",2017,0,0,16,16
"32147",2020,0,0,61,61
"32149",2017,0,0,4,4
"32149",2020,0,0,61,61
"32151",2015,0,0,56,56
"32151",2016,0,0,8,8
"32151",2017,0,0,42,42
"32151",2020,0,0,36,36
"32152",2017,0,0,16,16
"32152",2020,0,0,17,17
"32153",2017,0,0,16,16
"32153",2020,0,0,61,61
"32154",2017,0,0,16,16
"32154",2020,0,0,61,61
"32155",2017,0,0,2,2
"32156",2017,0,0,16,16
"32156",2020,0,0,61,61
"32157",2017,0,0,16,16
"32157",2020,0,0,61,61
"32158",2017,0,0,16,16
"32158",2020,0,0,61,61
"32159",2017,0,0,16,16
"32159",2020,0,0,61,61
"32160",2017,0,0,16,16
"32160",2020,0,0,61,61
"32161",2015,0,0,56,56
"32161",2016,0,0,8,8
"32161",2017,0,0,16,16
"32161",2020,0,0,17,17
"32162",2017,0,0,16,16
"32162",2020,0,0,61,61
"32163",2015,0,0,56,56
"32163",2016,0,0,8,8
"32163",2017,0,0,2,2
"32163",2020,0,0,36,36
"32164",2017,0,0,16,16
"32164",2020,0,0,61,61
"32165",2017,0,0,16,16
"32165",2020,0,0,61,61
"32166",2017,0,0,16,16
"32166",2020,0,0,61,61
"32167",2017,0,0,16,16
"32167",2020,0,0,61,61
"32169",2017,0,0,16,16
"32169",2020,0,0,61,61
"32170",2017,0,0,42,42
"32171",2017,0,0,16,16
"32171",2020,0,0,61,61
"32173",2017,0,0,16,16
"32173",2020,0,0,61,61
"32174",2017,0,0,16,16
"32175",2015,0,0,56,56
"32175",2016,0,0,8,8
"32175",2017,0,0,2,2
"32175",2020,0,0,36,36
"32177",2017,0,0,16,16
"32177",2020,0,0,61,61
"32181",2017,0,0,16,16
"32181",2020,0,0,61,61
"32182",2017,0,0,16,16
"32182",2020,0,0,61,61
"32184",2017,0,0,16,16
"32184",2020,0,0,61,61
"32185",2017,0,0,16,16
"32185",2020,0,0,61,61
"32186",2017,0,0,16,16
"32186",2020,0,0,61,61
"32187",2017,0,0,16,16
"32187",2020,0,0,61,61
"32191",2017,0,0,2,2
"32192",2017,0,0,56,56
"32192",2020,0,0,36,36
"32194",2017,0,0,16,16
"32194",2020,0,0,61,61
"32196",2017,0,0,16,16
"32197",2017,0,0,16,16
"32197",2020,0,0,61,61
"32198",2017,0,0,16,16
"32198",2020,0,0,61,61
"32199",2017,0,0,4,4
"32200",2017,0,0,16,16
"32201",2017,0,0,16,16
"32201",2020,0,0,61,61
"32205",2017,0,0,16,16
"32205",2020,0,0,61,61
"32208",2017,0,0,16,16
"32208",2020,0,0,61,61
"32209",2017,0,0,2,2
"32213",2017,0,0,16,16
"32213",2020,0,0,61,61
"32220",2017,0,0,2,2
"32221",2017,0,0,16,16
"32221",2020,0,0,61,61
"32224",2017,0,0,16,16
"32224",2020,0,0,61,61
"32225",2017,0,0,16,16
"32228",2017,0,0,16,16
"32228",2020,0,0,61,61
"32231",2017,0,0,16,16
"32231",2020,0,0,61,61
"32233",2017,0,0,16,16
"32233",2020,0,0,61,61
"32234",2017,0,0,16,16
"32234",2020,0,0,61,61
"32238",2017,0,0,16,16
"32238",2020,0,0,61,61
"32242",2017,0,0,16,16
"32242",2020,0,0,61,61
"32244",2015,0,0,56,56
"32244",2016,0,0,8,8
"32244",2017,0,0,2,2
"32244",2020,0,0,36,36
"32245",2017,0,0,42,42
"32247",2017,0,0,16,16
"32247",2020,0,0,61,61
"32249",2017,0,0,16,16
"32249",2020,0,0,61,61
"32250",2017,0,0,16,16
"32250",2020,0,0,61,61
"32252",2017,0,0,16,16
"32252",2020,0,0,61,61
"32253",2017,0,0,16,16
"32253",2020,0,0,61,61
"32254",2017,0,0,16,16
"32254",2020,0,0,61,61
"32256",2017,0,0,16,16
"32256",2020,0,0,61,61
"32257",2017,0,0,16,16
"32257",2020,0,0,61,61
"32260",2017,0,0,16,16
"32260",2020,0,0,61,61
"32263",2017,0,0,16,16
"32263",2020,0,0,61,61
"32265",2017,0,0,16,16
"32265",2020,0,0,61,61
"32266",2017,0,0,16,16
"32266",2020,0,0,61,61
"32267",2017,0,0,16,16
"32267",2020,0,0,61,61
"32269",2017,0,0,16,16
"32269",2020,0,0,61,61
"32270",2017,0,0,16,16
"32270",2020,0,0,61,61
"32273",2017,0,0,16,16
"32273",2020,0,0,61,61
"32278",2017,0,0,16,16
"32278",2020,0,0,61,61
"32280",2017,0,0,16,16
"32280",2020,0,0,61,61
"32283",2017,0,0,16,16
"32284",2017,0,0,16,16
"32284",2020,0,0,61,61
"32285",2017,0,0,16,16
"32285",2020,0,0,61,61
"32286",2017,0,0,16,16
"32286",2020,0,0,61,61
"32287",2017,0,0,16,16
"32287",2020,0,0,61,61
"32288",2017,0,0,16,16
"32288",2020,0,0,61,61
"32292",2017,0,0,16,16
"32292",2020,0,0,61,61
"32293",2017,0,0,16,16
"32293",2020,0,0,61,61
"32294",2017,0,0,16,16
"32294",2020,0,0,61,61
"32295",2017,0,0,16,16
"32295",2020,0,0,61,61
"32297",2017,0,0,16,16
"32297",2020,0,0,61,61
"32300",2017,0,0,16,16
"32300",2020,0,0,61,61
"32301",2017,0,0,16,16
"32302",2017,0,0,16,16
"32302",2020,0,0,61,61
"32303",2017,0,0,16,16
"32303",2020,0,0,61,61
"32304",2017,0,0,16,16
"32304",2020,0,0,61,61
"32306",2017,0,0,16,16
"32306",2020,0,0,61,61
"32307",2017,0,0,16,16
"32307",2020,0,0,61,61
"32309",2017,0,0,16,16
"32309",2020,0,0,61,61
"32311",2017,0,0,16,16
"32311",2020,0,0,61,61
"32314",2017,0,0,16,16
"32314",2020,0,0,61,61
"32319",2015,0,0,56,56
"32319",2016,0,0,8,8
"32319",2017,0,0,16,16
"32319",2020,0,0,17,17
"32320",2017,0,0,16,16
"32320",2020,0,0,61,61
"32321",2017,0,0,16,16
"32321",2020,0,0,61,61
"32322",2017,0,0,16,16
"32322",2020,0,0,61,61
"32324",2017,0,0,16,16
"32324",2020,0,0,61,61
"32327",2017,0,0,16,16
"32327",2020,0,0,61,61
"32330",2015,0,0,56,56
"32330",2016,0,0,8,8
"32330",2017,0,0,2,2
"32330",2020,0,0,36,36
"32331",2017,0,0,16,16
"32331",2020,0,0,61,61
"32332",2017,0,0,4,4
"32332",2020,0,0,61,61
"32333",2017,0,0,56,56
"32333",2020,0,0,36,36
"32336",2017,0,0,16,16
"32336",2020,0,0,61,61
"32337",2017,0,0,16,16
"32337",2020,0,0,61,61
"32343",2017,0,0,16,16
"32343",2020,0,0,61,61
"32344",2015,0,0,56,56
"32344",2016,0,0,8,8
"32344",2017,0,0,42,42
"32344",2020,0,0,36,36
"32346",2017,0,0,16,16
"32346",2020,0,0,61,61
"32347",2017,0,0,16,16
"32347",2020,0,0,61,61
"32348",2017,0,0,16,16
"32348",2020,0,0,61,61
"32351",2017,0,0,16,16
"32351",2020,0,0,61,61
"32352",2017,0,0,16,16
"32352",2020,0,0,61,61
"32353",2017,0,0,16,16
"32353",2020,0,0,61,61
"32356",2017,0,0,16,16
"32356",2020,0,0,61,61
"32358",2017,0,0,16,16
"32358",2020,0,0,61,61
"32359",2017,0,0,16,16
"32359",2020,0,0,61,61
"32360",2017,0,0,16,16
"32360",2020,0,0,61,61
"32362",2015,0,0,56,56
"32362",2016,0,0,8,8
"32362",2017,0,0,2,2
"32362",2020,0,0,36,36
"32363",2017,0,0,16,16
"32363",2020,0,0,61,61
"32365",2017,0,0,16,16
"32365",2020,0,0,61,61
"32367",2017,0,0,16,16
"32367",2020,0,0,61,61
"32368",2017,0,0,16,16
"32368",2020,0,0,61,61
"32370",2017,0,0,16,16
"32370",2020,0,0,61,61
"32371",2017,0,0,16,16
"32371",2020,0,0,61,61
"32373",2017,0,0,16,16
"32373",2020,0,0,61,61
"32374",2017,0,0,16,16
"32374",2020,0,0,61,61
"32375",2017,0,0,16,16
"32375",2020,0,0,61,61
"32377",2017,0,0,16,16
"32377",2020,0,0,61,61
"32378",2015,0,0,56,56
"32378",2016,0,0,8,8
"32378",2017,0,0,42,42
"32378",2020,0,0,36,36
"32379",2017,0,0,16,16
"32379",2020,0,0,61,61
"32380",2017,0,0,2,2
"32381",2017,0,0,16,16
"32382",2017,0,0,16,16
"32382",2020,0,0,61,61
"32383",2017,0,0,16,16
"32385",2017,0,0,16,16
"32385",2020,0,0,61,61
"32386",2017,0,0,16,16
"32386",2020,0,0,61,61
"32388",2017,0,0,16,16
"32388",2020,0,0,61,61
"32390",2017,0,0,2,2
"32391",2017,0,0,16,16
"32391",2020,0,0,61,61
"32392",2017,0,0,16,16
"32392",2020,0,0,61,61
"32393",2017,0,0,16,16
"32393",2020,0,0,61,61
"32394",2017,0,0,16,16
"32394",2020,0,0,61,61
"32396",2017,0,0,16,16
"32396",2020,0,0,61,61
"32397",2017,0,0,16,16
"32397",2020,0,0,61,61
"32398",2015,0,0,56,56
"32398",2016,0,0,8,8
"32398",2017,0,0,42,42
"32398",2020,0,0,36,36
"32399",2017,0,0,16,16
"32399",2020,0,0,61,61
"32401",2017,0,0,16,16
"32401",2020,0,0,61,61
"32402",2017,0,0,16,16
"32402",2020,0,0,61,61
"32404",2017,0,0,16,16
"32406",2017,0,0,16,16
"32406",2020,0,0,61,61
"32407",2017,0,0,16,16
"32407",2020,0,0,61,61
"32410",2017,0,0,16,16
"32410",2020,0,0,61,61
"32411",2017,0,0,16,16
"32411",2020,0,0,61,61
"32412",2017,0,0,16,16
"32412",2020,0,0,61,61
"32413",2017,0,0,16,16
"32413",2020,0,0,61,61
"32414",2015,0,0,56,56
"32414",2016,0,0,8,8
"32414",2017,0,0,2,2
"32414",2020,0,0,36,36
"32416",2017,0,0,16,16
"32416",2020,0,0,61,61
"32418",2017,0,0,16,16
"32418",2020,0,0,61,61
"32419",2017,0,0,16,16
"32419",2020,0,0,61,61
"32420",2017,0,0,16,16
"32420",2020,0,0,61,61
"32424",2017,0,0,56,56
"32424",2020,0,0,36,36
"32425",2017,0,0,16,16
"32425",2020,0,0,61,61
"32426",2017,0,0,16,16
"32426",2020,0,0,61,61
"32427",2017,0,0,16,16
"32429",2017,0,0,16,16
"32429",2020,0,0,61,61
"32430",2017,0,0,16,16
"32430",2020,0,0,61,61
"32433",2017,0,0,16,16
"32433",2020,0,0,61,61
"32436",2017,0,0,16,16
"32436",2020,0,0,61,61
"32438",2017,0,0,16,16
"32438",2020,0,0,61,61
"32439",2015,0,0,56,56
"32439",2016,0,0,8,8
"32439",2017,0,0,42,42
"32439",2020,0,0,36,36
"32440",2015,0,0,56,56
"32440",2016,0,0,8,8
"32440",2017,0,0,16,16
"32440",2020,0,0,17,17
"32443",2015,0,0,56,56
"32443",2016,0,0,8,8
"32443",2017,0,0,16,16
"32443",2020,0,0,17,17
"32445",2015,0,0,56,56
"32445",2016,0,0,8,8
"32445",2017,0,0,2,2
"32445",2020,0,0,36,36
"32446",2017,0,0,16,16
"32446",2020,0,0,61,61
"32447",2017,0,0,16,16
"32447",2020,0,0,61,61
"32448",2017,0,0,16,16
"32448",2020,0,0,61,61
"32450",2017,0,0,16,16
"32450",2020,0,0,61,61
"32451",2017,0,0,16,16
"32451",2020,0,0,61,61
"32452",2017,0,0,16,16
"32452",2020,0,0,61,61
"32456",2017,0,0,16,16
"32456",2020,0,0,61,61
"32459",2017,0,0,16,16
"32459",2020,0,0,61,61
"32460",2017,0,0,2,2
"32461",2017,0,0,56,56
"32461",2020,0,0,36,36
"32462",2017,0,0,4,4
"32462",2020,0,0,61,61
"32463",2017,0,0,42,42
"32464",2017,0,0,16,16
"32465",2017,0,0,16,16
"32465",2020,0,0,61,61
"32466",2017,0,0,16,16
"32466",2020,0,0,61,61
"32467",2017,0,0,16,16
"32467",2020,0,0,61,61
"32468",2017,0,0,16,16
"32468",2020,0,0,61,61
"33015",2015,0,0,37,37
"33088",2015,0,0,37,37
"33166",2015,0,0,37,37
"33174",2015,0,0,37,37
"33191",2015,0,0,37,37
"33332",2015,0,0,37,37
"33451",2015,0,0,37,37
"33478",2015,0,0,37,37
"34001",2014,0,0,33,33
"34001",2015,0,0,18,18
"34001",2016,0,0,95,95
"34001",2017,0,0,97,97
"34001",2019,0,0,20,20
"34001",2020,0,0,50,50
"34002",2014,0,0,33,33
"34002",2015,0,0,18,18
"34002",2016,0,0,95,95
"34002",2017,0,0,97,97
"34002",2019,0,0,20,20
"34002",2020,0,0,50,50
"34003",2014,0,33,33,66
"34003",2015,0,45,18,63
"34003",2016,0,25,95,120
"34003",2017,0,97,97,194
"34003",2019,0,111,20,131
"34003",2020,0,0,50,50
"34004",2014,0,0,159,159
"34004",2015,0,0,45,45
"34004",2016,0,0,73,73
"34004",2017,0,0,97,97
"34004",2019,0,0,111,111
"34004",2020,0,0,50,50
"34005",2014,0,0,33,33
"34005",2015,0,0,18,18
"34005",2016,0,0,95,95
"34005",2017,0,0,43,43
"34005",2019,0,0,20,20
"34005",2020,0,0,50,50
"34006",2014,0,0,159,159
"34006",2015,0,0,45,45
"34006",2016,0,0,28,28
"34006",2017,0,0,15,15
"34006",2019,0,0,77,77
"34007",2014,0,0,159,159
"34007",2015,0,0,45,45
"34007",2016,0,0,73,73
"34007",2017,0,0,97,97
"34007",2019,0,0,111,111
"34007",2020,0,0,50,50
"34008",2014,0,0,33,33
"34008",2020,0,0,13,13
"34009",2014,0,0,33,33
"34009",2015,0,0,18,18
"34009",2016,0,0,95,95
"34009",2017,0,0,97,97
"34009",2019,0,0,20,20
"34009",2020,0,0,50,50
"34010",2014,0,0,33,33
"34010",2015,0,0,18,18
"34010",2016,0,0,95,95
"34010",2017,0,0,43,43
"34010",2019,0,0,20,20
"34010",2020,0,0,50,50
"34011",2014,0,0,33,33
"34011",2015,0,0,18,18
"34011",2016,0,0,95,95
"34011",2017,0,0,97,97
"34011",2019,0,0,20,20
"34011",2020,0,0,50,50
"34012",2014,0,0,33,33
"34012",2015,0,0,18,18
"34012",2016,0,0,95,95
"34012",2017,0,0,43,43
"34012",2019,0,0,20,20
"34012",2020,0,0,50,50
"34013",2014,0,0,33,33
"34013",2015,0,0,18,18
"34013",2016,0,0,95,95
"34013",2017,0,0,97,97
"34013",2019,0,0,20,20
"34013",2020,0,0,50,50
"34014",2014,0,0,33,33
"34014",2015,0,0,45,45
"34014",2016,0,0,95,95
"34014",2017,0,0,43,43
"34014",2019,0,0,77,77
"34014",2020,0,0,24,24
"34015",2014,0,0,97,97
"34015",2016,0,0,35,35
"34015",2020,0,0,13,13
"34016",2014,0,0,33,33
"34016",2015,0,0,18,18
"34016",2016,0,0,95,95
"34016",2017,0,0,43,43
"34016",2019,0,0,20,20
"34016",2020,0,0,50,50
"34017",2014,0,0,33,33
"34017",2015,0,0,18,18
"34017",2016,0,0,95,95
"34017",2017,0,0,97,97
"34017",2019,0,0,20,20
"34017",2020,0,0,50,50
"34018",2014,0,0,33,33
"34018",2016,0,0,25,25
"34018",2017,0,0,15,15
"34018",2020,0,0,13,13
"34019",2014,0,0,34,34
"34019",2020,0,0,13,13
"34020",2014,0,0,159,159
"34020",2015,0,0,45,45
"34020",2016,0,0,28,28
"34020",2017,0,0,15,15
"34020",2019,0,0,77,77
"34021",2014,0,0,97,97
"34021",2016,0,0,28,28
"34021",2020,0,0,13,13
"34022",2014,0,159,33,192
"34022",2015,0,45,45,90
"34022",2016,0,95,95,190
"34022",2017,0,97,97,194
"34022",2019,0,0,77,77
"34023",2014,0,0,33,33
"34023",2015,0,0,18,18
"34023",2016,0,0,95,95
"34023",2017,0,0,97,97
"34023",2019,0,0,20,20
"34023",2020,0,0,50,50
"34024",2014,0,0,33,33
"34024",2015,0,0,18,18
"34024",2016,0,0,95,95
"34024",2017,0,0,97,97
"34024",2019,0,0,20,20
"34024",2020,0,0,50,50
"34025",2014,0,33,33,66
"34025",2015,0,45,0,45
"34025",2016,0,25,25,50
"34025",2017,0,97,15,112
"34025",2019,0,111,0,111
"34025",2020,0,0,13,13
"34026",2014,0,0,159,159
"34026",2015,0,0,45,45
"34026",2016,0,0,28,28
"34026",2017,0,0,15,15
"34026",2019,0,0,77,77
"34027",2014,0,159,33,192
"34027",2015,0,45,18,63
"34027",2016,0,95,95,190
"34027",2017,0,97,43,140
"34027",2019,0,111,48,159
"34027",2020,0,0,13,13
"34028",2014,0,0,34,34
"34028",2020,0,0,13,13
"34029",2014,0,0,33,33
"34029",2015,0,0,18,18
"34029",2016,0,0,95,95
"34029",2017,0,0,97,97
"34029",2019,0,0,20,20
"34029",2020,0,0,50,50
"34030",2014,0,0,97,97
"34030",2016,0,0,25,25
"34030",2020,0,0,13,13
"34031",2014,0,33,33,66
"34031",2015,0,45,0,45
"34031",2016,0,25,25,50
"34031",2017,0,97,15,112
"34031",2019,0,111,0,111
"34031",2020,0,0,13,13
"34032",2014,0,33,33,66
"34032",2015,0,45,0,45
"34032",2016,0,25,35,60
"34032",2017,0,97,15,112
"34032",2019,0,111,0,111
"34032",2020,0,0,13,13
"34033",2014,0,159,159,318
"34033",2015,0,45,18,63
"34033",2016,0,95,95,190
"34033",2017,0,97,43,140
"34033",2019,0,0,48,48
"34033",2020,0,0,13,13
"34034",2014,0,0,159,159
"34034",2015,0,0,45,45
"34034",2016,0,0,73,73
"34034",2017,0,0,97,97
"34034",2019,0,0,111,111
"34034",2020,0,0,50,50
"34035",2014,0,0,33,33
"34035",2015,0,0,18,18
"34035",2016,0,0,95,95
"34035",2017,0,0,43,43
"34035",2019,0,0,20,20
"34035",2020,0,0,50,50
"34036",2014,0,0,33,33
"34036",2015,0,0,18,18
"34036",2016,0,0,95,95
"34036",2017,0,0,43,43
"34036",2020,0,0,50,50
"34037",2014,0,33,33,66
"34037",2015,0,45,0,45
"34037",2016,0,25,25,50
"34037",2017,0,97,15,112
"34037",2019,0,111,0,111
"34037",2020,0,0,13,13
"34038",2014,0,0,34,34
"34038",2020,0,0,13,13
"34039",2014,0,0,33,33
"34039",2015,0,0,18,18
"34039",2016,0,0,95,95
"34039",2017,0,0,97,97
"34039",2019,0,0,20,20
"34039",2020,0,0,50,50
"34040",2014,0,0,33,33
"34040",2020,0,0,13,13
"34041",2014,0,0,33,33
"34041",2015,0,0,18,18
"34041",2016,0,0,95,95
"34041",2017,0,0,43,43
"34041",2020,0,0,50,50
"34042",2014,0,0,33,33
"34042",2015,0,0,18,18
"34042",2016,0,0,95,95
"34042",2017,0,0,43,43
"34042",2019,0,0,20,20
"34042",2020,0,0,50,50
"34043",2014,0,159,159,318
"34043",2015,0,45,18,63
"34043",2016,0,95,95,190
"34043",2017,0,97,43,140
"34043",2019,0,0,48,48
"34043",2020,0,0,13,13
"34044",2014,0,0,33,33
"34044",2020,0,0,13,13
"34045",2014,0,0,33,33
"34045",2015,0,0,18,18
"34045",2016,0,0,95,95
"34045",2017,0,0,97,97
"34045",2019,0,0,20,20
"34045",2020,0,0,50,50
"34046",2014,0,0,97,97
"34046",2020,0,0,13,13
"34047",2014,0,0,33,33
"34047",2015,0,0,18,18
"34047",2016,0,0,95,95
"34047",2017,0,0,97,97
"34047",2019,0,0,20,20
"34047",2020,0,0,50,50
"34048",2014,0,159,159,318
"34048",2015,0,45,18,63
"34048",2016,0,95,95,190
"34048",2017,0,97,43,140
"34048",2019,0,0,48,48
"34048",2020,0,0,13,13
"34049",2014,0,0,98,98
"34049",2020,0,0,13,13
"34050",2014,0,0,33,33
"34050",2015,0,0,45,45
"34050",2016,0,0,95,95
"34050",2017,0,0,97,97
"34050",2019,0,0,77,77
"34051",2014,0,0,33,33
"34051",2015,0,0,18,18
"34051",2016,0,0,95,95
"34051",2017,0,0,43,43
"34051",2020,0,0,50,50
"34052",2014,0,0,33,33
"34052",2016,0,0,35,35
"34052",2017,0,0,15,15
"34052",2020,0,0,13,13
"34053",2014,0,0,33,33
"34053",2020,0,0,13,13
"34054",2014,0,0,159,159
"34054",2015,0,0,45,45
"34054",2016,0,0,28,28
"34054",2017,0,0,15,15
"34054",2019,0,0,77,77
"34055",2014,0,0,98,98
"34055",2020,0,0,13,13
"34056",2014,0,0,33,33
"34056",2015,0,0,18,18
"34056",2016,0,0,95,95
"34056",2017,0,0,97,97
"34056",2019,0,0,20,20
"34056",2020,0,0,50,50
"34057",2014,0,0,33,33
"34057",2015,0,0,45,45
"34057",2016,0,0,95,95
"34057",2017,0,0,43,43
"34057",2019,0,0,77,77
"34057",2020,0,0,24,24
"34058",2014,0,159,33,192
"34058",2015,0,45,45,90
"34058",2016,0,95,95,190
"34058",2017,0,97,97,194
"34058",2019,0,111,77,188
"34059",2014,0,0,159,159
"34059",2015,0,0,45,45
"34059",2016,0,0,73,73
"34059",2017,0,0,97,97
"34059",2019,0,0,111,111
"34059",2020,0,0,50,50
"34060",2014,0,0,33,33
"34060",2015,0,0,18,18
"34060",2016,0,0,95,95
"34060",2017,0,0,43,43
"34060",2019,0,0,20,20
"34060",2020,0,0,50,50
"34061",2014,0,0,33,33
"34061",2016,0,0,25,25
"34061",2017,0,0,15,15
"34061",2020,0,0,13,13
"34062",2014,0,0,33,33
"34062",2020,0,0,13,13
"34063",2014,0,0,33,33
"34063",2015,0,0,18,18
"34063",2016,0,0,95,95
"34063",2017,0,0,97,97
"34063",2019,0,0,20,20
"34063",2020,0,0,50,50
"34064",2014,0,0,33,33
"34064",2015,0,0,18,18
"34064",2016,0,0,95,95
"34064",2017,0,0,43,43
"34064",2020,0,0,50,50
"34065",2014,0,0,33,33
"34065",2016,0,0,25,25
"34065",2020,0,0,13,13
"34066",2014,0,0,33,33
"34066",2015,0,0,18,18
"34066",2016,0,0,95,95
"34066",2017,0,0,43,43
"34066",2019,0,0,20,20
"34066",2020,0,0,50,50
"34067",2014,0,0,33,33
"34067",2015,0,0,18,18
"34067",2016,0,0,95,95
"34067",2017,0,0,43,43
"34067",2019,0,0,20,20
"34067",2020,0,0,50,50
"34068",2014,0,0,33,33
"34068",2015,0,0,18,18
"34068",2016,0,0,95,95
"34068",2017,0,0,97,97
"34068",2019,0,0,20,20
"34068",2020,0,0,50,50
"34069",2014,0,0,33,33
"34069",2016,0,0,25,25
"34069",2017,0,0,15,15
"34069",2020,0,0,13,13
"34070",2014,0,0,33,33
"34070",2016,0,0,25,25
"34070",2020,0,0,13,13
"34071",2014,0,0,98,98
"34071",2020,0,0,13,13
"34072",2014,0,0,33,33
"34072",2015,0,0,18,18
"34072",2016,0,0,95,95
"34072",2017,0,0,43,43
"34072",2020,0,0,50,50
"34073",2014,0,33,33,66
"34073",2015,0,45,0,45
"34073",2016,0,25,25,50
"34073",2017,0,97,15,112
"34073",2019,0,111,0,111
"34073",2020,0,0,13,13
"34074",2014,0,0,33,33
"34074",2016,0,0,25,25
"34074",2020,0,0,13,13
"34075",2014,0,0,159,159
"34075",2015,0,0,45,45
"34075",2016,0,0,28,28
"34075",2017,0,0,15,15
"34075",2019,0,0,77,77
"34076",2014,0,0,33,33
"34076",2015,0,0,18,18
"34076",2016,0,0,95,95
"34076",2017,0,0,43,43
"34076",2020,0,0,50,50
"34077",2014,0,0,33,33
"34077",2015,0,0,45,45
"34077",2016,0,0,95,95
"34077",2017,0,0,43,43
"34077",2019,0,0,77,77
"34077",2020,0,0,24,24
"34078",2014,0,0,33,33
"34078",2015,0,0,18,18
"34078",2016,0,0,95,95
"34078",2017,0,0,43,43
"34078",2019,0,0,20,20
"34078",2020,0,0,13,13
"34079",2014,0,0,33,33
"34079",2015,0,0,18,18
"34079",2016,0,0,95,95
"34079",2017,0,0,43,43
"34079",2020,0,0,50,50
"34080",2014,0,0,34,34
"34080",2020,0,0,13,13
"34081",2014,0,0,33,33
"34081",2016,0,0,35,35
"34081",2017,0,0,15,15
"34081",2020,0,0,13,13
"34082",2014,0,0,33,33
"34082",2015,0,0,45,45
"34082",2016,0,0,95,95
"34082",2017,0,0,43,43
"34082",2019,0,0,77,77
"34082",2020,0,0,24,24
"34083",2014,0,0,98,98
"34083",2020,0,0,13,13
"34084",2014,0,33,33,66
"34084",2015,0,45,0,45
"34084",2016,0,25,25,50
"34084",2017,0,97,15,112
"34084",2019,0,111,0,111
"34084",2020,0,0,13,13
"34085",2014,0,0,33,33
"34085",2015,0,0,18,18
"34085",2016,0,0,95,95
"34085",2017,0,0,97,97
"34085",2019,0,0,20,20
"34085",2020,0,0,50,50
"34086",2014,0,0,97,97
"34086",2016,0,0,25,25
"34086",2020,0,0,13,13
"34087",2014,0,0,33,33
"34087",2015,0,0,18,18
"34087",2016,0,0,95,95
"34087",2017,0,0,43,43
"34087",2019,0,0,20,20
"34087",2020,0,0,50,50
"34088",2014,0,0,33,33
"34088",2015,0,0,18,18
"34088",2016,0,0,95,95
"34088",2017,0,0,43,43
"34088",2019,0,0,20,20
"34088",2020,0,0,50,50
"34089",2014,0,0,33,33
"34089",2016,0,0,25,25
"34089",2017,0,0,15,15
"34089",2020,0,0,13,13
"34090",2014,0,0,33,33
"34090",2015,0,0,45,45
"34090",2016,0,0,95,95
"34090",2017,0,0,97,97
"34090",2019,0,0,77,77
"34091",2014,0,0,33,33
"34091",2015,0,0,18,18
"34091",2016,0,0,95,95
"34091",2017,0,0,43,43
"34091",2019,0,0,20,20
"34091",2020,0,0,50,50
"34092",2014,0,0,33,33
"34092",2016,0,0,35,35
"34092",2017,0,0,15,15
"34092",2020,0,0,13,13
"34093",2014,0,0,33,33
"34093",2020,0,0,13,13
"34094",2014,0,0,33,33
"34094",2016,0,0,25,25
"34094",2017,0,0,15,15
"34094",2020,0,0,13,13
"34095",2014,0,0,33,33
"34095",2015,0,0,18,18
"34095",2016,0,0,95,95
"34095",2017,0,0,43,43
"34095",2019,0,0,20,20
"34095",2020,0,0,50,50
"34096",2014,0,0,33,33
"34096",2020,0,0,13,13
"34097",2014,0,0,159,159
"34097",2015,0,0,45,45
"34097",2016,0,0,28,28
"34097",2017,0,0,15,15
"34097",2019,0,0,77,77
"34098",2014,0,0,159,159
"34098",2015,0,0,45,45
"34098",2016,0,0,73,73
"34098",2017,0,0,97,97
"34098",2019,0,0,111,111
"34098",2020,0,0,50,50
"34099",2014,0,0,33,33
"34099",2015,0,0,18,18
"34099",2016,0,0,95,95
"34099",2017,0,0,43,43
"34099",2019,0,0,20,20
"34099",2020,0,0,50,50
"34100",2014,0,0,97,97
"34100",2016,0,0,25,25
"34100",2020,0,0,13,13
"34101",2014,0,33,33,66
"34101",2015,0,45,18,63
"34101",2016,0,25,95,120
"34101",2017,0,97,97,194
"34101",2019,0,111,20,131
"34101",2020,0,0,50,50
"34102",2014,0,0,159,159
"34102",2015,0,0,18,18
"34102",2016,0,0,95,95
"34102",2017,0,0,43,43
"34102",2019,0,0,48,48
"34102",2020,0,0,13,13
"34103",2014,0,0,33,33
"34103",2015,0,0,18,18
"34103",2016,0,0,95,95
"34103",2017,0,0,97,97
"34103",2019,0,0,20,20
"34103",2020,0,0,50,50
"34104",2014,0,0,33,33
"34104",2015,0,0,18,18
"34104",2016,0,0,95,95
"34104",2017,0,0,97,97
"34104",2019,0,0,20,20
"34104",2020,0,0,50,50
"34105",2014,0,0,33,33
"34105",2016,0,0,25,25
"34105",2017,0,0,15,15
"34105",2020,0,0,13,13
"34106",2014,0,0,33,33
"34106",2015,0,0,18,18
"34106",2016,0,0,95,95
"34106",2017,0,0,43,43
"34106",2020,0,0,50,50
"34107",2014,0,0,97,97
"34107",2016,0,0,25,25
"34107",2020,0,0,13,13
"34108",2014,0,0,33,33
"34108",2015,0,0,18,18
"34108",2016,0,0,95,95
"34108",2017,0,0,43,43
"34108",2019,0,0,20,20
"34108",2020,0,0,50,50
"34109",2014,0,0,33,33
"34109",2016,0,0,25,25
"34109",2017,0,0,15,15
"34109",2020,0,0,13,13
"34110",2014,0,159,159,318
"34110",2015,0,45,18,63
"34110",2016,0,95,95,190
"34110",2017,0,97,43,140
"34110",2019,0,0,48,48
"34110",2020,0,0,13,13
"34111",2014,0,0,33,33
"34111",2015,0,0,18,18
"34111",2016,0,0,95,95
"34111",2017,0,0,43,43
"34111",2019,0,0,20,20
"34111",2020,0,0,50,50
"34112",2014,0,159,159,318
"34112",2015,0,45,18,63
"34112",2016,0,95,95,190
"34112",2017,0,97,43,140
"34112",2019,0,0,48,48
"34112",2020,0,0,13,13
"34113",2014,0,0,33,33
"34113",2015,0,0,18,18
"34113",2016,0,0,95,95
"34113",2017,0,0,97,97
"34113",2019,0,0,20,20
"34113",2020,0,0,50,50
"34114",2014,0,0,33,33
"34114",2015,0,0,18,18
"34114",2016,0,0,95,95
"34114",2017,0,0,43,43
"34114",2019,0,0,20,20
"34114",2020,0,0,50,50
"34115",2014,0,0,33,33
"34115",2015,0,0,18,18
"34115",2016,0,0,95,95
"34115",2017,0,0,43,43
"34115",2019,0,0,20,20
"34115",2020,0,0,50,50
"34116",2014,0,0,33,33
"34116",2015,0,0,45,45
"34116",2016,0,0,95,95
"34116",2017,0,0,43,43
"34116",2019,0,0,77,77
"34116",2020,0,0,24,24
"34117",2014,0,0,98,98
"34117",2020,0,0,13,13
"34118",2014,0,0,33,33
"34118",2015,0,0,45,45
"34118",2016,0,0,95,95
"34118",2017,0,0,43,43
"34118",2019,0,0,77,77
"34118",2020,0,0,24,24
"34119",2014,0,0,34,34
"34119",2020,0,0,13,13
"34120",2014,0,0,33,33
"34120",2015,0,0,45,45
"34120",2016,0,0,95,95
"34120",2017,0,0,43,43
"34120",2019,0,0,77,77
"34120",2020,0,0,24,24
"34121",2014,0,0,33,33
"34121",2020,0,0,13,13
"34122",2014,0,0,33,33
"34122",2015,0,0,18,18
"34122",2016,0,0,95,95
"34122",2017,0,0,97,97
"34122",2019,0,0,20,20
"34122",2020,0,0,50,50
"34123",2014,0,0,33,33
"34123",2015,0,0,45,45
"34123",2016,0,0,95,95
"34123",2017,0,0,43,43
"34123",2019,0,0,77,77
"34123",2020,0,0,24,24
"34124",2014,0,0,33,33
"34124",2015,0,0,18,18
"34124",2016,0,0,95,95
"34124",2017,0,0,43,43
"34124",2020,0,0,50,50
"34125",2014,0,0,33,33
"34125",2015,0,0,18,18
"34125",2016,0,0,95,95
"34125",2017,0,0,97,97
"34125",2019,0,0,20,20
"34125",2020,0,0,50,50
"34126",2014,0,0,34,34
"34126",2020,0,0,13,13
"34127",2014,0,0,33,33
"34127",2015,0,0,45,45
"34127",2016,0,0,95,95
"34127",2017,0,0,97,97
"34127",2019,0,0,77,77
"34128",2014,0,0,33,33
"34128",2015,0,0,18,18
"34128",2016,0,0,95,95
"34128",2017,0,0,43,43
"34128",2019,0,0,20,20
"34128",2020,0,0,50,50
"34129",2014,0,0,33,33
"34129",2015,0,0,45,45
"34129",2016,0,0,95,95
"34129",2017,0,0,43,43
"34129",2019,0,0,77,77
"34129",2020,0,0,24,24
"34130",2014,0,0,33,33
"34130",2016,0,0,25,25
"34130",2017,0,0,15,15
"34130",2020,0,0,13,13
"34131",2014,0,0,33,33
"34131",2015,0,0,18,18
"34131",2016,0,0,95,95
"34131",2017,0,0,43,43
"34131",2019,0,0,20,20
"34131",2020,0,0,13,13
"34132",2014,0,0,33,33
"34132",2020,0,0,13,13
"34133",2014,0,0,33,33
"34133",2020,0,0,13,13
"34134",2014,0,0,33,33
"34134",2015,0,0,45,45
"34134",2016,0,0,95,95
"34134",2017,0,0,43,43
"34134",2019,0,0,77,77
"34134",2020,0,0,24,24
"34135",2014,0,0,33,33
"34135",2016,0,0,35,35
"34135",2017,0,0,15,15
"34135",2020,0,0,13,13
"34136",2014,0,0,33,33
"34136",2015,0,0,18,18
"34136",2016,0,0,95,95
"34136",2017,0,0,97,97
"34136",2019,0,0,20,20
"34136",2020,0,0,50,50
"34137",2014,0,0,33,33
"34137",2015,0,0,18,18
"34137",2016,0,0,95,95
"34137",2017,0,0,43,43
"34137",2020,0,0,50,50
"34138",2014,0,0,33,33
"34138",2015,0,0,18,18
"34138",2016,0,0,95,95
"34138",2017,0,0,97,97
"34138",2019,0,0,20,20
"34138",2020,0,0,50,50
"34139",2014,0,33,33,66
"34139",2015,0,45,0,45
"34139",2016,0,25,25,50
"34139",2017,0,97,15,112
"34139",2019,0,111,0,111
"34139",2020,0,0,13,13
"34140",2014,0,0,33,33
"34140",2016,0,0,25,25
"34140",2017,0,0,15,15
"34140",2020,0,0,13,13
"34141",2014,0,0,159,159
"34141",2015,0,0,45,45
"34141",2016,0,0,28,28
"34141",2017,0,0,15,15
"34141",2019,0,0,77,77
"34142",2014,0,0,33,33
"34142",2020,0,0,13,13
"34143",2014,0,33,33,66
"34143",2015,0,45,18,63
"34143",2016,0,25,95,120
"34143",2017,0,97,97,194
"34143",2019,0,111,20,131
"34143",2020,0,0,50,50
"34144",2014,0,0,33,33
"34144",2020,0,0,13,13
"34145",2014,0,159,33,192
"34145",2015,0,45,18,63
"34145",2016,0,95,95,190
"34145",2017,0,97,43,140
"34145",2019,0,0,48,48
"34145",2020,0,0,13,13
"34146",2014,0,159,33,192
"34146",2015,0,45,45,90
"34146",2016,0,95,95,190
"34146",2017,0,97,97,194
"34146",2019,0,0,77,77
"34147",2014,0,0,33,33
"34147",2016,0,0,25,25
"34147",2017,0,0,15,15
"34147",2020,0,0,13,13
"34148",2014,0,0,33,33
"34148",2016,0,0,25,25
"34148",2017,0,0,15,15
"34148",2020,0,0,13,13
"34149",2014,0,0,33,33
"34149",2015,0,0,18,18
"34149",2016,0,0,95,95
"34149",2017,0,0,97,97
"34149",2019,0,0,20,20
"34149",2020,0,0,50,50
"34150",2014,0,33,33,66
"34150",2015,0,45,18,63
"34150",2016,0,25,95,120
"34150",2017,0,97,97,194
"34150",2019,0,111,20,131
"34150",2020,0,0,50,50
"34151",2014,0,0,33,33
"34151",2015,0,0,18,18
"34151",2016,0,0,95,95
"34151",2017,0,0,43,43
"34151",2019,0,0,48,48
"34151",2020,0,0,13,13
"34152",2014,0,0,33,33
"34152",2015,0,0,18,18
"34152",2016,0,0,95,95
"34152",2017,0,0,43,43
"34152",2019,0,0,20,20
"34152",2020,0,0,50,50
"34153",2014,0,0,33,33
"34153",2015,0,0,45,45
"34153",2016,0,0,95,95
"34153",2017,0,0,43,43
"34153",2019,0,0,77,77
"34153",2020,0,0,24,24
"34154",2014,0,0,33,33
"34154",2015,0,0,45,45
"34154",2016,0,0,95,95
"34154",2017,0,0,43,43
"34154",2019,0,0,77,77
"34154",2020,0,0,24,24
"34155",2014,0,0,33,33
"34155",2016,0,0,35,35
"34155",2017,0,0,15,15
"34155",2020,0,0,13,13
"34156",2014,0,0,33,33
"34156",2015,0,0,18,18
"34156",2016,0,0,95,95
"34156",2017,0,0,43,43
"34156",2020,0,0,50,50
"34157",2014,0,33,33,66
"34157",2015,0,45,18,63
"34157",2016,0,25,95,120
"34157",2017,0,97,97,194
"34157",2019,0,111,20,131
"34157",2020,0,0,50,50
"34158",2014,0,0,159,159
"34158",2015,0,0,45,45
"34158",2016,0,0,28,28
"34158",2017,0,0,15,15
"34158",2019,0,0,77,77
"34159",2014,0,0,33,33
"34159",2015,0,0,18,18
"34159",2016,0,0,95,95
"34159",2017,0,0,43,43
"34159",2019,0,0,20,20
"34159",2020,0,0,50,50
"34160",2014,0,0,33,33
"34160",2020,0,0,13,13
"34161",2014,0,0,33,33
"34161",2016,0,0,35,35
"34161",2017,0,0,15,15
"34161",2020,0,0,13,13
"34162",2014,0,0,33,33
"34162",2015,0,0,18,18
"34162",2016,0,0,95,95
"34162",2017,0,0,97,97
"34162",2019,0,0,20,20
"34162",2020,0,0,50,50
"34163",2014,0,0,33,33
"34163",2015,0,0,18,18
"34163",2016,0,0,95,95
"34163",2017,0,0,43,43
"34163",2019,0,0,20,20
"34163",2020,0,0,50,50
"34164",2014,0,159,33,192
"34164",2015,0,45,18,63
"34164",2016,0,95,95,190
"34164",2017,0,97,43,140
"34164",2019,0,0,48,48
"34164",2020,0,0,13,13
"34165",2014,0,0,33,33
"34165",2015,0,0,18,18
"34165",2016,0,0,95,95
"34165",2017,0,0,43,43
"34165",2019,0,0,20,20
"34165",2020,0,0,50,50
"34166",2014,0,33,33,66
"34166",2015,0,45,0,45
"34166",2016,0,25,25,50
"34166",2017,0,97,15,112
"34166",2019,0,111,0,111
"34166",2020,0,0,13,13
"34167",2014,0,0,159,159
"34167",2015,0,0,45,45
"34167",2016,0,0,35,35
"34167",2017,0,0,97,97
"34167",2019,0,0,77,77
"34168",2014,0,0,33,33
"34168",2015,0,0,18,18
"34168",2016,0,0,95,95
"34168",2017,0,0,97,97
"34168",2019,0,0,20,20
"34168",2020,0,0,50,50
"34169",2014,0,0,33,33
"34169",2015,0,0,45,45
"34169",2016,0,0,95,95
"34169",2017,0,0,43,43
"34169",2019,0,0,77,77
"34169",2020,0,0,24,24
"34170",2014,0,0,159,159
"34170",2015,0,0,45,45
"34170",2016,0,0,35,35
"34170",2017,0,0,97,97
"34170",2019,0,0,77,77
"34170",2020,0,0,50,50
"34171",2014,0,0,33,33
"34171",2015,0,0,18,18
"34171",2016,0,0,95,95
"34171",2017,0,0,43,43
"34171",2019,0,0,20,20
"34171",2020,0,0,50,50
"34172",2014,0,0,33,33
"34172",2015,0,0,45,45
"34172",2016,0,0,95,95
"34172",2017,0,0,43,43
"34172",2019,0,0,77,77
"34172",2020,0,0,24,24
"34173",2014,0,0,33,33
"34173",2015,0,0,18,18
"34173",2016,0,0,95,95
"34173",2017,0,0,43,43
"34173",2019,0,0,20,20
"34173",2020,0,0,50,50
"34174",2014,0,0,33,33
"34174",2015,0,0,18,18
"34174",2016,0,0,95,95
"34174",2017,0,0,43,43
"34174",2019,0,0,20,20
"34174",2020,0,0,50,50
"34175",2014,0,0,33,33
"34175",2015,0,0,18,18
"34175",2016,0,0,95,95
"34175",2017,0,0,43,43
"34175",2020,0,0,50,50
"34176",2014,0,0,33,33
"34176",2015,0,0,45,45
"34176",2016,0,0,95,95
"34176",2017,0,0,97,97
"34176",2019,0,0,77,77
"34177",2014,0,0,33,33
"34177",2015,0,0,45,45
"34177",2016,0,0,95,95
"34177",2017,0,0,43,43
"34177",2019,0,0,77,77
"34177",2020,0,0,24,24
"34178",2014,0,0,33,33
"34178",2016,0,0,25,25
"34178",2017,0,0,15,15
"34178",2020,0,0,13,13
"34179",2014,0,0,33,33
"34179",2015,0,0,45,45
"34179",2016,0,0,95,95
"34179",2017,0,0,43,43
"34179",2019,0,0,77,77
"34179",2020,0,0,24,24
"34180",2014,0,0,33,33
"34180",2015,0,0,18,18
"34180",2016,0,0,95,95
"34180",2017,0,0,97,97
"34180",2019,0,0,20,20
"34180",2020,0,0,50,50
"34181",2014,0,0,33,33
"34181",2015,0,0,18,18
"34181",2016,0,0,95,95
"34181",2017,0,0,97,97
"34181",2019,0,0,20,20
"34181",2020,0,0,50,50
"34182",2014,0,33,33,66
"34182",2015,0,45,18,63
"34182",2016,0,25,95,120
"34182",2017,0,97,97,194
"34182",2019,0,111,20,131
"34182",2020,0,0,50,50
"34183",2014,0,0,159,159
"34183",2015,0,0,45,45
"34183",2016,0,0,35,35
"34183",2017,0,0,97,97
"34183",2019,0,0,35,35
"34183",2020,0,0,24,24
"34184",2014,0,0,33,33
"34184",2015,0,0,18,18
"34184",2016,0,0,95,95
"34184",2017,0,0,97,97
"34184",2019,0,0,20,20
"34184",2020,0,0,50,50
"34185",2014,0,0,33,33
"34185",2015,0,0,18,18
"34185",2016,0,0,95,95
"34185",2017,0,0,43,43
"34185",2019,0,0,20,20
"34185",2020,0,0,50,50
"34186",2014,0,0,33,33
"34186",2020,0,0,13,13
"34187",2014,0,0,97,97
"34187",2016,0,0,25,25
"34187",2020,0,0,13,13
"34188",2014,0,0,33,33
"34188",2015,0,0,18,18
"34188",2016,0,0,95,95
"34188",2017,0,0,43,43
"34188",2020,0,0,50,50
"34189",2014,0,0,159,159
"34189",2015,0,0,45,45
"34189",2016,0,0,28,28
"34189",2017,0,0,15,15
"34189",2019,0,0,77,77
"34190",2014,0,0,159,159
"34190",2015,0,0,45,45
"34190",2016,0,0,28,28
"34190",2017,0,0,15,15
"34190",2019,0,0,77,77
"34191",2014,0,0,33,33
"34191",2016,0,0,25,25
"34191",2017,0,0,15,15
"34191",2020,0,0,13,13
"34192",2014,0,0,33,33
"34192",2015,0,0,45,45
"34192",2016,0,0,95,95
"34192",2017,0,0,43,43
"34192",2019,0,0,77,77
"34192",2020,0,0,24,24
"34193",2014,0,0,97,97
"34193",2016,0,0,28,28
"34193",2020,0,0,13,13
"34194",2014,0,0,33,33
"34194",2015,0,0,18,18
"34194",2016,0,0,95,95
"34194",2017,0,0,97,97
"34194",2019,0,0,20,20
"34194",2020,0,0,50,50
"34195",2014,0,0,33,33
"34195",2015,0,0,18,18
"34195",2016,0,0,95,95
"34195",2017,0,0,43,43
"34195",2019,0,0,20,20
"34195",2020,0,0,50,50
"34196",2014,0,0,33,33
"34196",2015,0,0,18,18
"34196",2016,0,0,95,95
"34196",2017,0,0,43,43
"34196",2020,0,0,50,50
"34197",2014,0,0,33,33
"34197",2015,0,0,18,18
"34197",2016,0,0,95,95
"34197",2017,0,0,97,97
"34197",2019,0,0,20,20
"34197",2020,0,0,50,50
"34198",2014,0,0,33,33
"34198",2015,0,0,45,45
"34198",2016,0,0,95,95
"34198",2017,0,0,43,43
"34198",2019,0,0,77,77
"34198",2020,0,0,24,24
"34199",2014,0,33,33,66
"34199",2015,0,45,18,63
"34199",2016,0,25,95,120
"34199",2017,0,97,97,194
"34199",2019,0,111,20,131
"34199",2020,0,0,50,50
"34200",2014,0,0,33,33
"34200",2020,0,0,13,13
"34201",2014,0,0,33,33
"34201",2016,0,0,25,25
"34201",2020,0,0,13,13
"34202",2014,0,0,33,33
"34202",2015,0,0,45,45
"34202",2016,0,0,95,95
"34202",2017,0,0,43,43
"34202",2019,0,0,77,77
"34202",2020,0,0,24,24
"34203",2014,0,33,33,66
"34203",2015,0,45,18,63
"34203",2016,0,25,95,120
"34203",2017,0,97,97,194
"34203",2019,0,111,20,131
"34203",2020,0,0,50,50
"34204",2014,0,0,33,33
"34204",2015,0,0,18,18
"34204",2016,0,0,95,95
"34204",2017,0,0,97,97
"34204",2019,0,0,20,20
"34204",2020,0,0,50,50
"34205",2014,0,0,33,33
"34205",2020,0,0,13,13
"34206",2014,0,0,159,159
"34206",2015,0,0,45,45
"34206",2016,0,0,35,35
"34206",2017,0,0,97,97
"34206",2019,0,0,35,35
"34206",2020,0,0,24,24
"34207",2014,0,33,33,66
"34207",2015,0,45,18,63
"34207",2016,0,25,95,120
"34207",2017,0,97,97,194
"34207",2019,0,111,20,131
"34207",2020,0,0,50,50
"34208",2014,0,0,33,33
"34208",2015,0,0,18,18
"34208",2016,0,0,95,95
"34208",2017,0,0,97,97
"34208",2019,0,0,20,20
"34208",2020,0,0,50,50
"34209",2014,0,33,33,66
"34209",2015,0,45,0,45
"34209",2016,0,25,25,50
"34209",2017,0,97,15,112
"34209",2019,0,111,0,111
"34209",2020,0,0,13,13
"34210",2014,0,0,33,33
"34210",2015,0,0,18,18
"34210",2016,0,0,95,95
"34210",2017,0,0,97,97
"34210",2019,0,0,20,20
"34210",2020,0,0,50,50
"34211",2014,0,0,34,34
"34211",2020,0,0,13,13
"34212",2014,0,0,33,33
"34212",2015,0,0,18,18
"34212",2016,0,0,95,95
"34212",2017,0,0,43,43
"34212",2020,0,0,50,50
"34213",2014,0,0,33,33
"34213",2015,0,0,18,18
"34213",2016,0,0,95,95
"34213",2017,0,0,97,97
"34213",2019,0,0,20,20
"34213",2020,0,0,50,50
"34214",2014,0,0,33,33
"34214",2015,0,0,18,18
"34214",2016,0,0,95,95
"34214",2017,0,0,97,97
"34214",2019,0,0,20,20
"34214",2020,0,0,50,50
"34215",2014,0,0,33,33
"34215",2015,0,0,18,18
"34215",2016,0,0,95,95
"34215",2017,0,0,97,97
"34215",2019,0,0,20,20
"34215",2020,0,0,50,50
"34216",2014,0,0,98,98
"34216",2020,0,0,13,13
"34217",2014,0,0,33,33
"34217",2015,0,0,45,45
"34217",2016,0,0,95,95
"34217",2017,0,0,43,43
"34217",2019,0,0,77,77
"34217",2020,0,0,24,24
"34218",2014,0,0,97,97
"34218",2016,0,0,25,25
"34218",2020,0,0,13,13
"34219",2014,0,0,97,97
"34219",2016,0,0,25,25
"34219",2020,0,0,13,13
"34220",2014,0,0,33,33
"34220",2015,0,0,18,18
"34220",2016,0,0,95,95
"34220",2017,0,0,43,43
"34220",2020,0,0,50,50
"34221",2014,0,0,33,33
"34221",2015,0,0,18,18
"34221",2016,0,0,95,95
"34221",2017,0,0,43,43
"34221",2019,0,0,20,20
"34221",2020,0,0,50,50
"34222",2014,0,0,33,33
"34222",2015,0,0,18,18
"34222",2016,0,0,95,95
"34222",2017,0,0,97,97
"34222",2019,0,0,20,20
"34222",2020,0,0,50,50
"34223",2014,0,0,33,33
"34223",2016,0,0,25,25
"34223",2017,0,0,15,15
"34223",2020,0,0,13,13
"34224",2014,0,0,33,33
"34224",2016,0,0,25,25
"34224",2017,0,0,15,15
"34224",2020,0,0,13,13
"34225",2014,0,0,33,33
"34225",2016,0,0,35,35
"34225",2017,0,0,15,15
"34225",2020,0,0,13,13
"34226",2014,0,0,33,33
"34226",2016,0,0,35,35
"34226",2017,0,0,15,15
"34226",2020,0,0,13,13
"34227",2014,0,159,33,192
"34227",2015,0,45,18,63
"34227",2016,0,95,95,190
"34227",2017,0,97,43,140
"34227",2019,0,111,48,159
"34227",2020,0,0,13,13
"34228",2014,0,0,97,97
"34228",2016,0,0,28,28
"34228",2020,0,0,13,13
"34229",2014,0,0,97,97
"34229",2016,0,0,28,28
"34229",2020,0,0,13,13
"34230",2014,0,0,33,33
"34230",2015,0,0,18,18
"34230",2016,0,0,95,95
"34230",2017,0,0,43,43
"34230",2020,0,0,50,50
"34231",2014,0,0,33,33
"34231",2020,0,0,13,13
"34232",2014,0,0,33,33
"34232",2016,0,0,25,25
"34232",2020,0,0,13,13
"34233",2014,0,0,33,33
"34233",2020,0,0,13,13
"34234",2014,0,0,33,33
"34234",2016,0,0,25,25
"34234",2017,0,0,15,15
"34234",2020,0,0,13,13
"34235",2014,0,0,98,98
"34235",2020,0,0,13,13
"34236",2014,0,0,33,33
"34236",2015,0,0,18,18
"34236",2016,0,0,95,95
"34236",2017,0,0,43,43
"34236",2019,0,0,20,20
"34236",2020,0,0,50,50
"34237",2014,0,0,33,33
"34237",2015,0,0,18,18
"34237",2016,0,0,95,95
"34237",2017,0,0,97,97
"34237",2019,0,0,20,20
"34237",2020,0,0,50,50
"34238",2014,0,0,33,33
"34238",2015,0,0,18,18
"34238",2016,0,0,95,95
"34238",2017,0,0,43,43
"34238",2019,0,0,20,20
"34238",2020,0,0,50,50
"34239",2014,0,0,33,33
"34239",2015,0,0,18,18
"34239",2016,0,0,95,95
"34239",2017,0,0,43,43
"34239",2020,0,0,50,50
"34240",2014,0,0,33,33
"34240",2015,0,0,45,45
"34240",2016,0,0,95,95
"34240",2017,0,0,43,43
"34240",2019,0,0,77,77
"34241",2014,0,0,33,33
"34241",2015,0,0,18,18
"34241",2016,0,0,95,95
"34241",2017,0,0,97,97
"34241",2019,0,0,20,20
"34241",2020,0,0,50,50
"34242",2014,0,159,33,192
"34242",2015,0,45,18,63
"34242",2016,0,95,95,190
"34242",2017,0,97,43,140
"34242",2019,0,0,48,48
"34242",2020,0,0,13,13
"34243",2014,0,0,33,33
"34243",2015,0,0,18,18
"34243",2016,0,0,95,95
"34243",2017,0,0,43,43
"34243",2019,0,0,20,20
"34243",2020,0,0,50,50
"34244",2014,0,159,33,192
"34244",2015,0,45,45,90
"34244",2016,0,95,95,190
"34244",2017,0,97,97,194
"34244",2019,0,0,77,77
"34245",2014,0,0,33,33
"34245",2016,0,0,35,35
"34245",2020,0,0,13,13
"34246",2014,0,159,33,192
"34246",2015,0,45,18,63
"34246",2016,0,95,95,190
"34246",2017,0,97,43,140
"34246",2019,0,0,48,48
"34246",2020,0,0,13,13
"34247",2014,0,0,33,33
"34247",2015,0,0,45,45
"34247",2016,0,0,95,95
"34247",2017,0,0,43,43
"34247",2019,0,0,77,77
"34247",2020,0,0,24,24
"34248",2014,0,0,33,33
"34248",2015,0,0,18,18
"34248",2016,0,0,95,95
"34248",2017,0,0,43,43
"34248",2019,0,0,48,48
"34248",2020,0,0,13,13
"34249",2014,0,159,33,192
"34249",2015,0,45,18,63
"34249",2016,0,95,95,190
"34249",2017,0,97,43,140
"34249",2019,0,0,48,48
"34249",2020,0,0,13,13
"34250",2014,0,0,97,97
"34250",2016,0,0,25,25
"34250",2020,0,0,13,13
"34251",2014,0,0,33,33
"34251",2015,0,0,18,18
"34251",2016,0,0,95,95
"34251",2017,0,0,43,43
"34251",2020,0,0,50,50
"34252",2014,0,0,98,98
"34252",2020,0,0,13,13
"34253",2014,0,0,33,33
"34253",2015,0,0,18,18
"34253",2016,0,0,95,95
"34253",2017,0,0,43,43
"34253",2020,0,0,50,50
"34254",2014,0,0,33,33
"34254",2015,0,0,18,18
"34254",2016,0,0,95,95
"34254",2017,0,0,43,43
"34254",2020,0,0,50,50
"34255",2014,0,0,33,33
"34255",2015,0,0,45,45
"34255",2016,0,0,95,95
"34255",2017,0,0,43,43
"34255",2019,0,0,77,77
"34255",2020,0,0,24,24
"34256",2014,0,159,33,192
"34256",2015,0,45,45,90
"34256",2016,0,95,95,190
"34256",2017,0,97,97,194
"34256",2019,0,111,77,188
"34257",2014,0,0,98,98
"34257",2020,0,0,13,13
"34258",2014,0,0,33,33
"34258",2016,0,0,25,25
"34258",2017,0,0,15,15
"34258",2020,0,0,13,13
"34259",2014,0,0,33,33
"34259",2015,0,0,45,45
"34259",2016,0,0,95,95
"34259",2017,0,0,43,43
"34259",2019,0,0,77,77
"34259",2020,0,0,24,24
"34260",2014,0,0,98,98
"34260",2020,0,0,13,13
"34261",2014,0,0,33,33
"34261",2015,0,0,18,18
"34261",2016,0,0,95,95
"34261",2017,0,0,43,43
"34261",2019,0,0,20,20
"34261",2020,0,0,50,50
"34262",2014,0,0,33,33
"34262",2015,0,0,18,18
"34262",2016,0,0,95,95
"34262",2017,0,0,43,43
"34262",2020,0,0,50,50
"34263",2014,0,159,159,318
"34263",2015,0,45,18,63
"34263",2016,0,95,95,190
"34263",2017,0,97,43,140
"34263",2019,0,0,48,48
"34263",2020,0,0,13,13
"34264",2014,0,0,33,33
"34264",2015,0,0,18,18
"34264",2016,0,0,95,95
"34264",2017,0,0,43,43
"34264",2019,0,0,20,20
"34264",2020,0,0,50,50
"34265",2014,0,159,33,192
"34265",2015,0,45,18,63
"34265",2016,0,95,95,190
"34265",2017,0,97,43,140
"34265",2019,0,0,48,48
"34265",2020,0,0,13,13
"34266",2014,0,0,33,33
"34266",2015,0,0,45,45
"34266",2016,0,0,95,95
"34266",2017,0,0,43,43
"34266",2019,0,0,77,77
"34266",2020,0,0,24,24
"34267",2014,0,0,33,33
"34267",2015,0,0,18,18
"34267",2016,0,0,95,95
"34267",2017,0,0,97,97
"34267",2019,0,0,20,20
"34267",2020,0,0,50,50
"34268",2014,0,0,33,33
"34268",2015,0,0,18,18
"34268",2016,0,0,95,95
"34268",2017,0,0,43,43
"34268",2020,0,0,50,50
"34269",2014,0,0,159,159
"34269",2015,0,0,45,45
"34269",2016,0,0,73,73
"34269",2017,0,0,97,97
"34269",2019,0,0,111,111
"34269",2020,0,0,50,50
"34270",2014,0,0,33,33
"34270",2015,0,0,45,45
"34270",2016,0,0,95,95
"34270",2017,0,0,43,43
"34270",2019,0,0,77,77
"34270",2020,0,0,24,24
"34271",2014,0,0,97,97
"34271",2016,0,0,25,25
"34271",2020,0,0,13,13
"34272",2014,0,0,33,33
"34272",2015,0,0,45,45
"34272",2016,0,0,95,95
"34272",2017,0,0,97,97
"34272",2019,0,0,77,77
"34273",2014,0,0,34,34
"34273",2020,0,0,13,13
"34274",2014,0,0,33,33
"34274",2015,0,0,18,18
"34274",2016,0,0,95,95
"34274",2017,0,0,43,43
"34274",2019,0,0,20,20
"34274",2020,0,0,50,50
"34276",2014,0,0,33,33
"34276",2015,0,0,18,18
"34276",2016,0,0,95,95
"34276",2017,0,0,43,43
"34276",2019,0,0,48,48
"34276",2020,0,0,13,13
"34277",2014,0,0,33,33
"34277",2015,0,0,18,18
"34277",2016,0,0,95,95
"34277",2017,0,0,43,43
"34277",2019,0,0,20,20
"34277",2020,0,0,50,50
"34278",2014,0,0,33,33
"34278",2015,0,0,18,18
"34278",2016,0,0,95,95
"34278",2017,0,0,43,43
"34278",2020,0,0,50,50
"34279",2014,0,0,33,33
"34279",2020,0,0,13,13
"34280",2014,0,0,33,33
"34280",2015,0,0,45,45
"34280",2016,0,0,95,95
"34280",2017,0,0,97,97
"34280",2019,0,0,77,77
"34281",2014,0,0,33,33
"34281",2015,0,0,18,18
"34281",2016,0,0,95,95
"34281",2017,0,0,97,97
"34281",2019,0,0,20,20
"34281",2020,0,0,50,50
"34282",2014,0,0,33,33
"34282",2015,0,0,45,45
"34282",2016,0,0,95,95
"34282",2017,0,0,43,43
"34282",2019,0,0,77,77
"34282",2020,0,0,24,24
"34283",2014,0,0,33,33
"34283",2015,0,0,18,18
"34283",2016,0,0,95,95
"34283",2017,0,0,43,43
"34283",2020,0,0,50,50
"34284",2014,0,0,97,97
"34284",2016,0,0,28,28
"34284",2020,0,0,13,13
"34285",2014,0,0,33,33
"34285",2015,0,0,18,18
"34285",2016,0,0,95,95
"34285",2017,0,0,97,97
"34285",2019,0,0,20,20
"34285",2020,0,0,50,50
"34286",2014,0,0,33,33
"34286",2015,0,0,18,18
"34286",2016,0,0,95,95
"34286",2017,0,0,43,43
"34286",2020,0,0,50,50
"34287",2014,0,0,33,33
"34287",2015,0,0,18,18
"34287",2016,0,0,95,95
"34287",2017,0,0,43,43
"34287",2020,0,0,50,50
"34288",2014,0,159,33,192
"34288",2015,0,45,18,63
"34288",2016,0,95,95,190
"34288",2017,0,97,43,140
"34288",2019,0,0,48,48
"34288",2020,0,0,13,13
"34289",2014,0,33,33,66
"34289",2015,0,45,0,45
"34289",2016,0,25,25,50
"34289",2017,0,97,15,112
"34289",2019,0,111,0,111
"34289",2020,0,0,13,13
"34290",2014,0,0,33,33
"34290",2015,0,0,45,45
"34290",2016,0,0,95,95
"34290",2017,0,0,43,43
"34290",2019,0,0,77,77
"34290",2020,0,0,24,24
"34291",2014,0,0,97,97
"34291",2016,0,0,25,25
"34291",2020,0,0,13,13
"34292",2014,0,0,33,33
"34292",2015,0,0,18,18
"34292",2016,0,0,95,95
"34292",2017,0,0,43,43
"34292",2020,0,0,50,50
"34293",2017,0,0,82,82
"34293",2019,0,0,111,111
"34294",2014,0,159,33,192
"34294",2015,0,45,18,63
"34294",2016,0,95,95,190
"34294",2017,0,97,43,140
"34294",2019,0,0,48,48
"34294",2020,0,0,13,13
"34295",2014,0,0,33,33
"34295",2015,0,0,45,45
"34295",2016,0,0,95,95
"34295",2017,0,0,43,43
"34295",2019,0,0,77,77
"34295",2020,0,0,24,24
"34296",2014,0,159,159,318
"34296",2015,0,45,18,63
"34296",2016,0,95,95,190
"34296",2017,0,97,43,140
"34296",2019,0,0,48,48
"34296",2020,0,0,13,13
"34297",2014,0,0,159,159
"34297",2015,0,0,18,18
"34297",2016,0,0,95,95
"34297",2017,0,0,43,43
"34297",2019,0,0,48,48
"34297",2020,0,0,13,13
"34298",2014,0,33,33,66
"34298",2015,0,45,0,45
"34298",2016,0,25,28,53
"34298",2017,0,97,15,112
"34298",2019,0,111,0,111
"34298",2020,0,0,13,13
"34299",2014,0,33,33,66
"34299",2015,0,45,0,45
"34299",2016,0,25,25,50
"34299",2017,0,97,15,112
"34299",2019,0,111,0,111
"34299",2020,0,0,13,13
"34300",2014,0,33,33,66
"34300",2015,0,45,0,45
"34300",2016,0,25,25,50
"34300",2017,0,97,15,112
"34300",2019,0,111,0,111
"34300",2020,0,0,13,13
"34301",2014,0,33,33,66
"34301",2015,0,45,18,63
"34301",2016,0,25,95,120
"34301",2017,0,97,97,194
"34301",2019,0,111,20,131
"34301",2020,0,0,50,50
"34302",2014,0,0,159,159
"34302",2015,0,0,45,45
"34302",2016,0,0,28,28
"34302",2017,0,0,15,15
"34302",2019,0,0,77,77
"34303",2014,0,0,33,33
"34303",2015,0,0,18,18
"34303",2016,0,0,95,95
"34303",2017,0,0,43,43
"34303",2019,0,0,20,20
"34303",2020,0,0,50,50
"34304",2014,0,0,33,33
"34304",2015,0,0,18,18
"34304",2016,0,0,95,95
"34304",2017,0,0,43,43
"34304",2020,0,0,50,50
"34305",2014,0,0,97,97
"34305",2016,0,0,25,25
"34305",2020,0,0,13,13
"34306",2014,0,0,33,33
"34306",2015,0,0,18,18
"34306",2016,0,0,95,95
"34306",2017,0,0,43,43
"34306",2020,0,0,50,50
"34307",2014,0,159,33,192
"34307",2015,0,45,45,90
"34307",2016,0,95,95,190
"34307",2017,0,97,97,194
"34307",2019,0,111,77,188
"34308",2014,0,0,98,98
"34308",2020,0,0,13,13
"34309",2014,0,159,33,192
"34309",2015,0,45,45,90
"34309",2016,0,95,95,190
"34309",2017,0,97,97,194
"34309",2019,0,0,77,77
"34310",2014,0,33,33,66
"34310",2015,0,45,0,45
"34310",2016,0,25,25,50
"34310",2017,0,97,15,112
"34310",2019,0,111,0,111
"34310",2020,0,0,13,13
"34311",2014,0,0,33,33
"34311",2015,0,0,18,18
"34311",2016,0,0,95,95
"34311",2017,0,0,97,97
"34311",2019,0,0,20,20
"34311",2020,0,0,50,50
"34312",2014,0,0,34,34
"34312",2020,0,0,13,13
"34313",2014,0,0,33,33
"34313",2015,0,0,18,18
"34313",2016,0,0,95,95
"34313",2017,0,0,97,97
"34313",2019,0,0,20,20
"34313",2020,0,0,50,50
"34314",2014,0,0,33,33
"34314",2015,0,0,45,45
"34314",2016,0,0,95,95
"34314",2017,0,0,43,43
"34314",2019,0,0,77,77
"34314",2020,0,0,24,24
"34315",2014,0,0,33,33
"34315",2015,0,0,18,18
"34315",2016,0,0,95,95
"34315",2017,0,0,97,97
"34315",2019,0,0,20,20
"34315",2020,0,0,50,50
"34316",2014,0,0,33,33
"34316",2015,0,0,18,18
"34316",2016,0,0,95,95
"34316",2017,0,0,43,43
"34316",2020,0,0,50,50
"34317",2014,0,0,33,33
"34317",2015,0,0,18,18
"34317",2016,0,0,95,95
"34317",2017,0,0,43,43
"34317",2020,0,0,50,50
"34318",2014,0,0,159,159
"34318",2015,0,0,18,18
"34318",2016,0,0,95,95
"34318",2017,0,0,43,43
"34318",2019,0,0,48,48
"34318",2020,0,0,13,13
"34319",2014,0,0,33,33
"34319",2015,0,0,18,18
"34319",2016,0,0,95,95
"34319",2017,0,0,97,97
"34319",2019,0,0,20,20
"34319",2020,0,0,50,50
"34320",2014,0,0,33,33
"34320",2015,0,0,45,45
"34320",2016,0,0,95,95
"34320",2017,0,0,43,43
"34320",2019,0,0,77,77
"34320",2020,0,0,24,24
"34321",2014,0,159,33,192
"34321",2015,0,45,45,90
"34321",2016,0,95,95,190
"34321",2017,0,97,97,194
"34321",2019,0,0,77,77
"34322",2014,0,0,33,33
"34322",2015,0,0,18,18
"34322",2016,0,0,95,95
"34322",2017,0,0,43,43
"34322",2019,0,0,20,20
"34322",2020,0,0,13,13
"34323",2014,0,0,33,33
"34323",2015,0,0,18,18
"34323",2016,0,0,95,95
"34323",2017,0,0,43,43
"34323",2020,0,0,50,50
"34324",2014,0,33,33,66
"34324",2015,0,45,0,45
"34324",2016,0,25,25,50
"34324",2017,0,97,15,112
"34324",2019,0,111,0,111
"34324",2020,0,0,13,13
"34325",2014,0,33,33,66
"34325",2015,0,45,18,63
"34325",2016,0,25,95,120
"34325",2017,0,97,97,194
"34325",2019,0,111,20,131
"34325",2020,0,0,50,50
"34326",2014,0,0,159,159
"34326",2015,0,0,45,45
"34326",2016,0,0,73,73
"34326",2017,0,0,97,97
"34326",2019,0,0,111,111
"34326",2020,0,0,50,50
"34327",2014,0,159,33,192
"34327",2015,0,45,45,90
"34327",2016,0,95,95,190
"34327",2017,0,97,97,194
"34327",2019,0,111,77,188
"34328",2014,0,0,33,33
"34328",2015,0,0,18,18
"34328",2016,0,0,95,95
"34328",2017,0,0,97,97
"34328",2019,0,0,20,20
"34328",2020,0,0,50,50
"34329",2014,0,33,33,66
"34329",2015,0,45,0,45
"34329",2016,0,25,35,60
"34329",2017,0,97,15,112
"34329",2019,0,111,0,111
"34329",2020,0,0,13,13
"34331",2014,0,0,97,97
"34331",2016,0,0,28,28
"34331",2020,0,0,13,13
"34332",2014,0,33,33,66
"34332",2015,0,45,0,45
"34332",2016,0,25,25,50
"34332",2017,0,97,15,112
"34332",2019,0,111,0,111
"34332",2020,0,0,13,13
"34333",2014,0,0,33,33
"34333",2015,0,0,18,18
"34333",2016,0,0,95,95
"34333",2017,0,0,43,43
"34333",2019,0,0,20,20
"34333",2020,0,0,50,50
"34334",2014,0,0,33,33
"34334",2020,0,0,13,13
"34335",2014,0,0,98,98
"34335",2020,0,0,13,13
"34336",2014,0,33,33,66
"34336",2015,0,45,0,45
"34336",2016,0,25,25,50
"34336",2017,0,97,15,112
"34336",2019,0,111,0,111
"34336",2020,0,0,13,13
"34337",2014,0,0,33,33
"34337",2015,0,0,18,18
"34337",2016,0,0,95,95
"34337",2017,0,0,43,43
"34337",2019,0,0,20,20
"34337",2020,0,0,50,50
"34338",2014,0,0,33,33
"34338",2015,0,0,18,18
"34338",2016,0,0,95,95
"34338",2017,0,0,97,97
"34338",2020,0,0,50,50
"34339",2014,0,0,33,33
"34339",2016,0,0,35,35
"34339",2020,0,0,13,13
"34340",2014,0,159,33,192
"34340",2015,0,45,18,63
"34340",2016,0,95,95,190
"34340",2017,0,97,43,140
"34340",2019,0,0,48,48
"34340",2020,0,0,13,13
"34341",2014,0,0,33,33
"34341",2015,0,0,18,18
"34341",2016,0,0,95,95
"34341",2017,0,0,97,97
"34341",2019,0,0,20,20
"34341",2020,0,0,50,50
"34342",2014,0,0,33,33
"34342",2015,0,0,45,45
"34342",2016,0,0,95,95
"34342",2017,0,0,43,43
"34342",2019,0,0,77,77
"34342",2020,0,0,24,24
"34343",2014,0,0,33,33
"34343",2015,0,0,18,18
"34343",2016,0,0,95,95
"34343",2017,0,0,43,43
"34343",2019,0,0,20,20
"34343",2020,0,0,50,50
"34344",2014,0,0,33,33
"34344",2015,0,0,45,45
"34344",2016,0,0,95,95
"34344",2017,0,0,97,97
"34344",2019,0,0,77,77
"35001",2013,0,0,46,46
"35001",2015,0,0,87,87
"35001",2016,0,53,53,106
"35001",2019,0,58,79,137
"35001",2020,0,0,15,15
"35002",2013,0,0,46,46
"35002",2015,0,0,87,87
"35002",2016,0,53,53,106
"35002",2019,0,58,86,144
"35003",2013,0,0,46,46
"35003",2015,0,0,87,87
"35003",2016,0,53,53,106
"35003",2019,0,58,119,177
"35003",2020,0,0,15,15
"35004",2013,0,0,46,46
"35004",2015,0,0,87,87
"35004",2016,0,53,53,106
"35004",2019,0,58,119,177
"35004",2020,0,0,15,15
"35005",2013,0,0,46,46
"35005",2015,0,0,87,87
"35005",2016,0,53,53,106
"35005",2019,0,58,86,144
"35006",2013,0,0,46,46
"35006",2015,0,0,87,87
"35006",2016,0,53,53,106
"35006",2019,0,58,79,137
"35007",2013,0,0,46,46
"35007",2015,0,0,87,87
"35007",2016,0,53,53,106
"35007",2019,0,58,185,243
"35007",2020,0,0,15,15
"35008",2013,0,0,46,46
"35008",2015,0,0,87,87
"35008",2016,0,53,53,106
"35008",2019,0,58,86,144
"35009",2013,0,0,46,46
"35009",2015,0,0,87,87
"35009",2016,0,53,53,106
"35009",2019,0,58,185,243
"35009",2020,0,0,15,15
"35010",2013,0,0,46,46
"35010",2015,0,0,87,87
"35010",2016,0,53,53,106
"35010",2019,0,58,185,243
"35010",2020,0,0,15,15
"35012",2013,0,0,44,44
"35012",2015,0,0,87,87
"35012",2016,0,53,53,106
"35012",2019,0,58,86,144
"35013",2013,0,0,46,46
"35013",2015,0,0,87,87
"35013",2016,0,53,53,106
"35013",2019,0,58,86,144
"35014",2013,0,0,46,46
"35014",2015,0,0,87,87
"35014",2016,0,53,53,106
"35014",2019,0,58,79,137
"35015",2013,0,0,46,46
"35015",2015,0,0,87,87
"35015",2016,0,53,53,106
"35015",2019,0,58,79,137
"35015",2020,0,0,15,15
"35016",2013,0,0,46,46
"35016",2015,0,0,87,87
"35016",2016,0,53,53,106
"35016",2019,0,58,185,243
"35016",2020,0,0,15,15
"35017",2013,0,0,46,46
"35017",2015,0,0,87,87
"35017",2016,0,53,53,106
"35017",2019,0,58,185,243
"35017",2020,0,0,15,15
"35018",2013,0,0,46,46
"35018",2015,0,0,87,87
"35018",2016,0,53,53,106
"35018",2019,0,58,119,177
"35018",2020,0,0,15,15
"35019",2013,0,0,46,46
"35019",2015,0,0,87,87
"35019",2016,0,53,53,106
"35019",2019,0,58,119,177
"35019",2020,0,0,15,15
"35021",2013,0,0,46,46
"35021",2015,0,0,87,87
"35021",2016,0,53,53,106
"35021",2019,0,58,119,177
"35021",2020,0,0,15,15
"35022",2013,0,0,46,46
"35022",2015,0,0,87,87
"35022",2016,0,53,53,106
"35022",2019,0,58,185,243
"35022",2020,0,0,15,15
"35023",2013,0,0,46,46
"35023",2015,0,0,87,87
"35023",2016,0,53,53,106
"35023",2019,0,58,185,243
"35023",2020,0,0,15,15
"35024",2013,0,0,46,46
"35024",2015,0,0,87,87
"35024",2016,0,53,53,106
"35024",2019,0,58,79,137
"35024",2020,0,0,15,15
"35025",2013,0,0,46,46
"35025",2015,0,0,87,87
"35025",2016,0,53,53,106
"35025",2019,0,58,119,177
"35025",2020,0,0,15,15
"35026",2013,0,0,46,46
"35026",2015,0,0,87,87
"35026",2016,0,53,53,106
"35026",2019,0,58,185,243
"35026",2020,0,0,15,15
"35027",2013,0,0,46,46
"35027",2015,0,0,87,87
"35027",2016,0,53,53,106
"35027",2019,0,58,185,243
"35027",2020,0,0,15,15
"35028",2013,0,0,46,46
"35028",2015,0,0,87,87
"35028",2016,0,53,53,106
"35028",2019,0,58,86,144
"35029",2013,0,0,46,46
"35029",2015,0,0,87,87
"35029",2016,0,53,53,106
"35029",2019,0,58,185,243
"35029",2020,0,0,15,15
"35030",2013,0,0,44,44
"35030",2015,0,0,87,87
"35030",2016,0,53,53,106
"35030",2019,0,58,86,144
"35031",2013,0,0,46,46
"35031",2015,0,0,87,87
"35031",2016,0,53,53,106
"35031",2019,0,58,79,137
"35031",2020,0,0,15,15
"35032",2013,0,0,46,46
"35032",2015,0,0,87,87
"35032",2016,0,53,53,106
"35032",2019,0,58,86,144
"35033",2013,0,0,46,46
"35033",2015,0,0,87,87
"35033",2016,0,53,53,106
"35033",2019,0,58,86,144
"35034",2013,0,0,46,46
"35034",2015,0,0,87,87
"35034",2016,0,53,53,106
"35034",2019,0,58,185,243
"35034",2020,0,0,15,15
"35035",2013,0,0,46,46
"35035",2015,0,0,87,87
"35035",2016,0,53,53,106
"35035",2019,0,58,185,243
"35035",2020,0,0,15,15
"35037",2013,0,0,46,46
"35037",2015,0,0,87,87
"35037",2016,0,53,53,106
"35037",2019,0,58,185,243
"35037",2020,0,0,15,15
"35038",2013,0,0,46,46
"35038",2015,0,0,87,87
"35038",2016,0,53,53,106
"35038",2019,0,58,79,137
"35039",2013,0,0,46,46
"35039",2015,0,0,87,87
"35039",2016,0,53,53,106
"35039",2019,0,58,79,137
"35039",2020,0,0,15,15
"35040",2013,0,0,46,46
"35040",2015,0,0,87,87
"35040",2016,0,53,53,106
"35040",2019,0,58,185,243
"35040",2020,0,0,15,15
"35041",2013,0,0,46,46
"35041",2015,0,0,87,87
"35041",2016,0,53,53,106
"35041",2019,0,58,86,144
"35042",2013,0,0,46,46
"35042",2015,0,0,87,87
"35042",2016,0,53,53,106
"35042",2019,0,58,79,137
"35044",2013,0,0,46,46
"35044",2015,0,0,87,87
"35044",2016,0,53,53,106
"35044",2019,0,58,119,177
"35044",2020,0,0,15,15
"35045",2013,0,0,46,46
"35045",2015,0,0,87,87
"35045",2016,0,53,53,106
"35045",2019,0,58,86,144
"35046",2013,0,0,46,46
"35046",2015,0,0,87,87
"35046",2016,0,53,53,106
"35046",2019,0,58,185,243
"35046",2020,0,0,15,15
"35047",2013,0,0,46,46
"35047",2015,0,0,87,87
"35047",2016,0,53,53,106
"35047",2019,0,58,86,144
"35049",2013,0,0,46,46
"35049",2015,0,0,87,87
"35049",2016,0,53,53,106
"35049",2019,0,58,185,243
"35049",2020,0,0,15,15
"35050",2013,0,0,46,46
"35050",2015,0,0,87,87
"35050",2016,0,53,53,106
"35050",2019,0,58,185,243
"35050",2020,0,0,15,15
"35051",2013,0,0,46,46
"35051",2015,0,0,87,87
"35051",2016,0,53,53,106
"35051",2019,0,58,79,137
"35052",2013,0,0,46,46
"35052",2015,0,0,87,87
"35052",2016,0,53,53,106
"35052",2019,0,58,79,137
"35052",2020,0,0,15,15
"35054",2013,0,0,46,46
"35054",2015,0,0,87,87
"35054",2016,0,53,53,106
"35054",2019,0,58,86,144
"35055",2013,0,0,46,46
"35055",2015,0,0,87,87
"35055",2016,0,53,53,106
"35055",2019,0,58,86,144
"35056",2013,0,0,46,46
"35056",2015,0,0,87,87
"35056",2016,0,53,53,106
"35056",2019,0,58,185,243
"35056",2020,0,0,15,15
"35057",2013,0,0,46,46
"35057",2015,0,0,87,87
"35057",2016,0,53,53,106
"35057",2019,0,58,185,243
"35057",2020,0,0,15,15
"35058",2013,0,0,46,46
"35058",2015,0,0,87,87
"35058",2016,0,53,53,106
"35058",2019,0,58,185,243
"35058",2020,0,0,15,15
"35059",2013,0,0,46,46
"35059",2015,0,0,87,87
"35059",2016,0,53,53,106
"35059",2019,0,58,185,243
"35059",2020,0,0,15,15
"35060",2013,0,0,46,46
"35060",2015,0,0,87,87
"35060",2016,0,53,53,106
"35060",2019,0,58,185,243
"35060",2020,0,0,15,15
"35061",2013,0,0,46,46
"35061",2015,0,0,87,87
"35061",2016,0,53,53,106
"35061",2019,0,58,79,137
"35061",2020,0,0,15,15
"35062",2013,0,0,46,46
"35062",2015,0,0,87,87
"35062",2016,0,53,53,106
"35062",2019,0,58,119,177
"35062",2020,0,0,15,15
"35063",2013,0,0,46,46
"35063",2015,0,0,87,87
"35063",2016,0,53,53,106
"35063",2019,0,58,119,177
"35063",2020,0,0,15,15
"35064",2013,0,0,46,46
"35064",2015,0,0,87,87
"35064",2016,0,53,53,106
"35064",2019,0,58,86,144
"35065",2013,0,0,46,46
"35065",2015,0,0,87,87
"35065",2016,0,53,53,106
"35065",2019,0,58,185,243
"35065",2020,0,0,15,15
"35066",2013,0,0,46,46
"35066",2015,0,0,87,87
"35066",2016,0,53,53,106
"35066",2019,0,58,86,144
"35067",2013,0,0,46,46
"35067",2015,0,0,87,87
"35067",2016,0,53,53,106
"35067",2019,0,58,79,137
"35067",2020,0,0,15,15
"35068",2013,0,0,46,46
"35068",2015,0,0,87,87
"35068",2016,0,53,53,106
"35068",2019,0,58,79,137
"35069",2013,0,0,46,46
"35069",2015,0,0,87,87
"35069",2016,0,53,53,106
"35069",2019,0,58,79,137
"35070",2013,0,0,46,46
"35070",2015,0,0,87,87
"35070",2016,0,53,53,106
"35070",2019,0,58,185,243
"35070",2020,0,0,15,15
"35071",2013,0,0,46,46
"35071",2015,0,0,87,87
"35071",2016,0,53,53,106
"35071",2019,0,58,119,177
"35071",2020,0,0,15,15
"35072",2013,0,0,46,46
"35072",2015,0,0,87,87
"35072",2016,0,53,53,106
"35072",2019,0,58,79,137
"35072",2020,0,0,15,15
"35075",2013,0,0,46,46
"35075",2015,0,0,87,87
"35075",2016,0,53,53,106
"35075",2019,0,58,119,177
"35075",2020,0,0,15,15
"35076",2013,0,0,46,46
"35076",2015,0,0,87,87
"35076",2016,0,53,53,106
"35076",2019,0,58,185,243
"35076",2020,0,0,15,15
"35077",2013,0,0,46,46
"35077",2015,0,0,87,87
"35077",2016,0,53,53,106
"35077",2019,0,58,86,144
"35078",2013,0,0,46,46
"35078",2015,0,0,87,87
"35078",2016,0,53,53,106
"35078",2019,0,58,185,243
"35078",2020,0,0,15,15
"35079",2013,0,0,46,46
"35079",2015,0,0,87,87
"35079",2016,0,53,53,106
"35079",2019,0,58,185,243
"35079",2020,0,0,15,15
"35080",2013,0,0,46,46
"35080",2015,0,0,87,87
"35080",2016,0,53,53,106
"35080",2019,0,58,185,243
"35080",2020,0,0,15,15
"35081",2013,0,0,46,46
"35081",2015,0,0,87,87
"35081",2016,0,53,53,106
"35081",2019,0,58,185,243
"35081",2020,0,0,15,15
"35082",2013,0,0,46,46
"35082",2015,0,0,87,87
"35082",2016,0,53,53,106
"35082",2019,0,58,86,144
"35084",2013,0,0,46,46
"35084",2015,0,0,87,87
"35084",2016,0,53,53,106
"35084",2019,0,58,185,243
"35084",2020,0,0,15,15
"35085",2013,0,0,46,46
"35085",2015,0,0,87,87
"35085",2016,0,53,53,106
"35085",2019,0,58,119,177
"35085",2020,0,0,15,15
"35086",2013,0,0,46,46
"35086",2015,0,0,87,87
"35086",2016,0,53,53,106
"35086",2019,0,58,79,137
"35086",2020,0,0,15,15
"35087",2013,0,0,46,46
"35087",2015,0,0,87,87
"35087",2016,0,53,53,106
"35087",2019,0,58,79,137
"35088",2013,0,0,46,46
"35088",2015,0,0,87,87
"35088",2016,0,53,53,106
"35088",2019,0,58,86,144
"35089",2013,0,0,46,46
"35089",2015,0,0,87,87
"35089",2016,0,53,53,106
"35089",2019,0,58,86,144
"35090",2013,0,0,46,46
"35090",2015,0,0,87,87
"35090",2016,0,53,53,106
"35090",2019,0,58,86,144
"35091",2013,0,0,46,46
"35091",2015,0,0,87,87
"35091",2016,0,53,53,106
"35091",2019,0,58,185,243
"35091",2020,0,0,15,15
"35092",2013,0,0,46,46
"35092",2015,0,0,87,87
"35092",2016,0,53,53,106
"35092",2019,0,58,119,177
"35092",2020,0,0,15,15
"35093",2013,0,0,46,46
"35093",2015,0,0,87,87
"35093",2016,0,53,53,106
"35093",2019,0,58,185,243
"35093",2020,0,0,15,15
"35094",2013,0,0,46,46
"35094",2015,0,0,87,87
"35094",2016,0,53,53,106
"35094",2019,0,58,119,177
"35094",2020,0,0,15,15
"35095",2013,0,0,46,46
"35095",2015,0,0,87,87
"35095",2016,0,53,53,106
"35095",2019,0,58,185,243
"35095",2020,0,0,15,15
"35096",2013,0,0,46,46
"35096",2015,0,0,87,87
"35096",2016,0,53,53,106
"35096",2019,0,58,79,137
"35097",2013,0,0,46,46
"35097",2015,0,0,87,87
"35097",2016,0,53,53,106
"35097",2019,0,58,79,137
"35098",2013,0,0,44,44
"35098",2015,0,0,87,87
"35098",2016,0,53,53,106
"35098",2019,0,58,86,144
"35099",2013,0,0,46,46
"35099",2015,0,0,87,87
"35099",2016,0,53,53,106
"35099",2019,0,58,79,137
"35101",2013,0,0,46,46
"35101",2015,0,0,87,87
"35101",2016,0,53,53,106
"35101",2019,0,58,79,137
"35101",2020,0,0,15,15
"35102",2013,0,0,46,46
"35102",2015,0,0,87,87
"35102",2016,0,53,53,106
"35102",2019,0,58,86,144
"35103",2013,0,0,46,46
"35103",2015,0,0,87,87
"35103",2016,0,53,53,106
"35103",2019,0,58,86,144
"35104",2013,0,0,46,46
"35104",2015,0,0,87,87
"35104",2016,0,53,53,106
"35104",2019,0,58,119,177
"35104",2020,0,0,15,15
"35105",2013,0,0,46,46
"35105",2015,0,0,87,87
"35105",2016,0,53,53,106
"35105",2019,0,58,79,137
"35105",2020,0,0,15,15
"35106",2013,0,0,44,44
"35106",2015,0,0,87,87
"35106",2016,0,53,53,106
"35106",2019,0,58,86,144
"35107",2013,0,0,46,46
"35107",2015,0,0,87,87
"35107",2016,0,53,53,106
"35107",2019,0,58,79,137
"35107",2020,0,0,15,15
"35108",2013,0,0,46,46
"35108",2015,0,0,87,87
"35108",2016,0,53,53,106
"35108",2019,0,58,86,144
"35109",2013,0,0,46,46
"35109",2015,0,0,87,87
"35109",2016,0,53,53,106
"35109",2019,0,58,79,137
"35110",2013,0,0,46,46
"35110",2015,0,0,87,87
"35110",2016,0,53,53,106
"35110",2019,0,58,119,177
"35110",2020,0,0,15,15
"35111",2013,0,0,46,46
"35111",2015,0,0,87,87
"35111",2016,0,53,53,106
"35111",2019,0,58,119,177
"35111",2020,0,0,15,15
"35114",2013,0,0,46,46
"35114",2015,0,0,87,87
"35114",2016,0,53,53,106
"35114",2019,0,58,86,144
"35115",2013,0,0,46,46
"35115",2015,0,0,87,87
"35115",2016,0,53,53,106
"35115",2019,0,58,119,177
"35115",2020,0,0,15,15
"35116",2013,0,0,46,46
"35116",2015,0,0,87,87
"35116",2016,0,53,53,106
"35116",2019,0,58,185,243
"35116",2020,0,0,15,15
"35117",2013,0,0,46,46
"35117",2015,0,0,87,87
"35117",2016,0,53,53,106
"35117",2019,0,58,185,243
"35117",2020,0,0,15,15
"35118",2013,0,0,46,46
"35118",2015,0,0,87,87
"35118",2016,0,53,53,106
"35118",2019,0,58,119,177
"35118",2020,0,0,15,15
"35119",2013,0,0,46,46
"35119",2015,0,0,87,87
"35119",2016,0,53,53,106
"35119",2019,0,58,79,137
"35120",2013,0,0,46,46
"35120",2015,0,0,87,87
"35120",2016,0,53,53,106
"35120",2019,0,58,185,243
"35120",2020,0,0,15,15
"35121",2013,0,0,46,46
"35121",2015,0,0,87,87
"35121",2016,0,53,53,106
"35121",2019,0,58,79,137
"35121",2020,0,0,15,15
"35122",2013,0,0,46,46
"35122",2015,0,0,87,87
"35122",2016,0,53,53,106
"35122",2019,0,58,185,243
"35122",2020,0,0,15,15
"35123",2013,0,0,46,46
"35123",2015,0,0,87,87
"35123",2016,0,53,53,106
"35123",2019,0,58,86,144
"35124",2013,0,0,44,44
"35124",2015,0,0,87,87
"35124",2016,0,53,53,106
"35124",2019,0,58,86,144
"35125",2013,0,0,46,46
"35125",2015,0,0,87,87
"35125",2016,0,53,53,106
"35125",2019,0,58,86,144
"35126",2013,0,0,46,46
"35126",2015,0,0,87,87
"35126",2016,0,53,53,106
"35126",2019,0,58,86,144
"35127",2013,0,0,46,46
"35127",2015,0,0,87,87
"35127",2016,0,53,53,106
"35127",2019,0,58,86,144
"35128",2013,0,0,46,46
"35128",2015,0,0,87,87
"35128",2016,0,53,53,106
"35128",2019,0,58,185,243
"35128",2020,0,0,15,15
"35130",2013,0,0,46,46
"35130",2015,0,0,87,87
"35130",2016,0,53,53,106
"35130",2019,0,58,185,243
"35130",2020,0,0,15,15
"35131",2013,0,0,46,46
"35131",2015,0,0,87,87
"35131",2016,0,53,53,106
"35131",2019,0,58,185,243
"35131",2020,0,0,15,15
"35132",2013,0,0,46,46
"35132",2015,0,0,87,87
"35132",2016,0,53,53,106
"35132",2019,0,58,185,243
"35132",2020,0,0,15,15
"35133",2013,0,0,46,46
"35133",2015,0,0,87,87
"35133",2016,0,53,53,106
"35133",2019,0,58,185,243
"35133",2020,0,0,15,15
"35134",2013,0,0,46,46
"35134",2015,0,0,87,87
"35134",2016,0,53,53,106
"35134",2019,0,58,185,243
"35134",2020,0,0,15,15
"35135",2013,0,0,46,46
"35135",2015,0,0,87,87
"35135",2016,0,53,53,106
"35135",2019,0,58,185,243
"35135",2020,0,0,15,15
"35136",2013,0,0,46,46
"35136",2015,0,0,87,87
"35136",2016,0,53,53,106
"35136",2019,0,58,86,144
"35137",2013,0,0,46,46
"35137",2015,0,0,87,87
"35137",2016,0,53,53,106
"35137",2019,0,58,119,177
"35137",2020,0,0,15,15
"35138",2013,0,0,46,46
"35138",2015,0,0,87,87
"35138",2016,0,53,53,106
"35138",2019,0,58,119,177
"35138",2020,0,0,15,15
"35139",2013,0,0,46,46
"35139",2015,0,0,87,87
"35139",2016,0,53,53,106
"35139",2019,0,58,86,144
"35140",2013,0,0,44,44
"35140",2015,0,0,87,87
"35140",2016,0,53,53,106
"35140",2019,0,58,86,144
"35141",2013,0,0,46,46
"35141",2015,0,0,87,87
"35141",2016,0,53,53,106
"35141",2019,0,58,79,137
"35141",2020,0,0,15,15
"35142",2013,0,0,46,46
"35142",2015,0,0,87,87
"35142",2016,0,53,53,106
"35142",2019,0,58,119,177
"35142",2020,0,0,15,15
"35143",2013,0,0,46,46
"35143",2015,0,0,87,87
"35143",2016,0,53,53,106
"35143",2019,0,58,185,243
"35143",2020,0,0,15,15
"35144",2013,0,0,46,46
"35144",2015,0,0,87,87
"35144",2016,0,53,53,106
"35144",2019,0,58,185,243
"35144",2020,0,0,15,15
"35145",2013,0,0,46,46
"35145",2015,0,0,87,87
"35145",2016,0,53,53,106
"35145",2019,0,58,86,144
"35146",2013,0,0,46,46
"35146",2015,0,0,87,87
"35146",2016,0,53,53,106
"35146",2019,0,58,185,243
"35146",2020,0,0,15,15
"35148",2013,0,0,46,46
"35148",2015,0,0,87,87
"35148",2016,0,53,53,106
"35148",2019,0,58,119,177
"35148",2020,0,0,15,15
"35149",2013,0,0,46,46
"35149",2015,0,0,87,87
"35149",2016,0,53,53,106
"35149",2019,0,58,86,144
"35150",2013,0,0,46,46
"35150",2015,0,0,87,87
"35150",2016,0,53,53,106
"35150",2019,0,58,119,177
"35150",2020,0,0,15,15
"35151",2013,0,0,46,46
"35151",2015,0,0,87,87
"35151",2016,0,53,53,106
"35151",2019,0,58,86,144
"35152",2013,0,0,46,46
"35152",2015,0,0,87,87
"35152",2016,0,53,53,106
"35152",2019,0,58,79,137
"35152",2020,0,0,15,15
"35153",2013,0,0,46,46
"35153",2015,0,0,87,87
"35153",2016,0,53,53,106
"35153",2019,0,58,185,243
"35153",2020,0,0,15,15
"35154",2013,0,0,46,46
"35154",2015,0,0,87,87
"35154",2016,0,53,53,106
"35154",2019,0,58,79,137
"35154",2020,0,0,15,15
"35155",2013,0,0,46,46
"35155",2015,0,0,87,87
"35155",2016,0,53,53,106
"35155",2019,0,58,86,144
"35156",2013,0,0,46,46
"35156",2015,0,0,87,87
"35156",2016,0,53,53,106
"35156",2019,0,58,185,243
"35156",2020,0,0,15,15
"35157",2013,0,0,46,46
"35157",2015,0,0,87,87
"35157",2016,0,53,53,106
"35157",2019,0,58,119,177
"35157",2020,0,0,15,15
"35159",2013,0,0,46,46
"35159",2015,0,0,87,87
"35159",2016,0,53,53,106
"35159",2019,0,58,185,243
"35159",2020,0,0,15,15
"35160",2013,0,0,46,46
"35160",2015,0,0,87,87
"35160",2016,0,53,53,106
"35160",2019,0,58,185,243
"35160",2020,0,0,15,15
"35161",2013,0,0,46,46
"35161",2015,0,0,87,87
"35161",2016,0,53,53,106
"35161",2019,0,58,79,137
"35162",2013,0,0,46,46
"35162",2015,0,0,87,87
"35162",2016,0,53,53,106
"35162",2019,0,58,119,177
"35162",2020,0,0,15,15
"35163",2013,0,0,46,46
"35163",2015,0,0,87,87
"35163",2016,0,53,53,106
"35163",2019,0,58,79,137
"35163",2020,0,0,15,15
"35164",2013,0,0,46,46
"35164",2015,0,0,87,87
"35164",2016,0,53,53,106
"35164",2019,0,58,119,177
"35164",2020,0,0,15,15
"35165",2013,0,0,46,46
"35165",2015,0,0,87,87
"35165",2016,0,53,53,106
"35165",2019,0,58,86,144
"35166",2013,0,0,46,46
"35166",2015,0,0,87,87
"35166",2016,0,53,53,106
"35166",2019,0,58,79,137
"35166",2020,0,0,15,15
"35167",2013,0,0,46,46
"35167",2015,0,0,87,87
"35167",2016,0,53,53,106
"35167",2019,0,58,86,144
"35168",2013,0,0,46,46
"35168",2015,0,0,87,87
"35168",2016,0,53,53,106
"35168",2019,0,58,86,144
"35169",2013,0,0,46,46
"35169",2015,0,0,87,87
"35169",2016,0,53,53,106
"35169",2019,0,58,185,243
"35169",2020,0,0,15,15
"35170",2013,0,0,46,46
"35170",2015,0,0,87,87
"35170",2016,0,53,53,106
"35170",2019,0,58,79,137
"35170",2020,0,0,15,15
"35171",2013,0,0,46,46
"35171",2015,0,0,87,87
"35171",2016,0,53,53,106
"35171",2019,0,58,185,243
"35171",2020,0,0,15,15
"35172",2013,0,0,46,46
"35172",2015,0,0,87,87
"35172",2016,0,53,53,106
"35172",2019,0,58,185,243
"35172",2020,0,0,15,15
"35173",2013,0,0,46,46
"35173",2015,0,0,87,87
"35173",2016,0,53,53,106
"35173",2019,0,58,185,243
"35173",2020,0,0,15,15
"35174",2013,0,0,46,46
"35174",2015,0,0,87,87
"35174",2016,0,53,53,106
"35174",2019,0,58,119,177
"35174",2020,0,0,15,15
"35175",2013,0,0,46,46
"35175",2015,0,0,87,87
"35175",2016,0,53,53,106
"35175",2019,0,58,185,243
"35175",2020,0,0,15,15
"35176",2013,0,0,46,46
"35176",2015,0,0,87,87
"35176",2016,0,53,53,106
"35176",2019,0,58,86,144
"35177",2013,0,0,46,46
"35177",2015,0,0,87,87
"35177",2016,0,53,53,106
"35177",2019,0,58,185,243
"35177",2020,0,0,15,15
"35178",2013,0,0,46,46
"35178",2015,0,0,87,87
"35178",2016,0,53,53,106
"35178",2019,0,58,119,177
"35178",2020,0,0,15,15
"35179",2013,0,0,46,46
"35179",2015,0,0,87,87
"35179",2016,0,53,53,106
"35179",2019,0,58,185,243
"35179",2020,0,0,15,15
"35180",2013,0,0,46,46
"35180",2015,0,0,87,87
"35180",2016,0,53,53,106
"35180",2019,0,58,185,243
"35180",2020,0,0,15,15
"35181",2013,0,0,46,46
"35181",2015,0,0,87,87
"35181",2016,0,53,53,106
"35181",2019,0,58,185,243
"35181",2020,0,0,15,15
"35183",2013,0,0,46,46
"35183",2015,0,0,87,87
"35183",2016,0,53,53,106
"35183",2019,0,58,79,137
"35184",2013,0,0,46,46
"35184",2015,0,0,87,87
"35184",2016,0,53,53,106
"35184",2019,0,58,185,243
"35184",2020,0,0,15,15
"35185",2013,0,0,46,46
"35185",2015,0,0,87,87
"35185",2016,0,53,53,106
"35185",2019,0,58,79,137
"35185",2020,0,0,15,15
"35186",2013,0,0,46,46
"35186",2015,0,0,87,87
"35186",2016,0,53,53,106
"35186",2019,0,58,185,243
"35186",2020,0,0,15,15
"35187",2013,0,0,46,46
"35187",2015,0,0,87,87
"35187",2016,0,53,53,106
"35187",2019,0,58,185,243
"35187",2020,0,0,15,15
"35188",2013,0,0,46,46
"35188",2015,0,0,87,87
"35188",2016,0,53,53,106
"35188",2019,0,58,185,243
"35188",2020,0,0,15,15
"35189",2013,0,0,46,46
"35189",2015,0,0,87,87
"35189",2016,0,53,53,106
"35189",2019,0,58,185,243
"35189",2020,0,0,15,15
"35190",2013,0,0,46,46
"35190",2015,0,0,87,87
"35190",2016,0,53,53,106
"35190",2019,0,58,119,177
"35190",2020,0,0,15,15
"35191",2013,0,0,46,46
"35191",2015,0,0,87,87
"35191",2016,0,53,53,106
"35191",2019,0,58,119,177
"35191",2020,0,0,15,15
"35192",2013,0,0,46,46
"35192",2015,0,0,87,87
"35192",2016,0,53,53,106
"35192",2019,0,58,79,137
"35192",2020,0,0,15,15
"35193",2013,0,0,46,46
"35193",2015,0,0,87,87
"35193",2016,0,53,53,106
"35193",2019,0,58,185,243
"35193",2020,0,0,15,15
"35194",2013,0,0,46,46
"35194",2015,0,0,87,87
"35194",2016,0,53,53,106
"35194",2019,0,58,79,137
"35194",2020,0,0,15,15
"35195",2013,0,0,46,46
"35195",2015,0,0,87,87
"35195",2016,0,53,53,106
"35195",2019,0,58,185,243
"35195",2020,0,0,15,15
"35196",2013,0,0,46,46
"35196",2015,0,0,87,87
"35196",2016,0,53,53,106
"35196",2019,0,58,185,243
"35196",2020,0,0,15,15
"35197",2013,0,0,46,46
"35197",2015,0,0,87,87
"35197",2016,0,53,53,106
"35197",2019,0,58,185,243
"35197",2020,0,0,15,15
"35198",2013,0,0,46,46
"35198",2015,0,0,87,87
"35198",2016,0,53,53,106
"35198",2019,0,58,86,144
"35199",2013,0,0,46,46
"35199",2015,0,0,87,87
"35199",2016,0,53,53,106
"35199",2019,0,58,86,144
"35200",2013,0,0,46,46
"35200",2015,0,0,87,87
"35200",2016,0,53,53,106
"35200",2019,0,58,86,144
"35201",2013,0,0,46,46
"35201",2015,0,0,87,87
"35201",2016,0,53,53,106
"35201",2019,0,58,185,243
"35201",2020,0,0,15,15
"35202",2013,0,0,44,44
"35202",2015,0,0,87,87
"35202",2016,0,53,53,106
"35202",2019,0,58,86,144
"35203",2013,0,0,46,46
"35203",2015,0,0,87,87
"35203",2016,0,53,53,106
"35203",2019,0,58,185,243
"35203",2020,0,0,15,15
"35204",2013,0,0,46,46
"35204",2015,0,0,87,87
"35204",2016,0,53,53,106
"35204",2019,0,58,86,144
"35205",2013,0,0,46,46
"35205",2015,0,0,87,87
"35205",2016,0,53,53,106
"35205",2019,0,58,119,177
"35205",2020,0,0,15,15
"35206",2013,0,0,46,46
"35206",2015,0,0,87,87
"35206",2016,0,53,53,106
"35206",2019,0,58,86,144
"35207",2013,0,0,46,46
"35207",2015,0,0,87,87
"35207",2016,0,53,53,106
"35207",2019,0,58,79,137
"35208",2013,0,0,46,46
"35208",2015,0,0,87,87
"35208",2016,0,53,53,106
"35208",2019,0,58,86,144
"35210",2013,0,0,46,46
"35210",2015,0,0,87,87
"35210",2016,0,53,53,106
"35210",2019,0,58,185,243
"35210",2020,0,0,15,15
"35211",2013,0,0,46,46
"35211",2015,0,0,87,87
"35211",2016,0,53,53,106
"35211",2019,0,58,185,243
"35211",2020,0,0,15,15
"35212",2013,0,0,46,46
"35212",2015,0,0,87,87
"35212",2016,0,53,53,106
"35212",2019,0,58,86,144
"35214",2013,0,0,46,46
"35214",2015,0,0,87,87
"35214",2016,0,53,53,106
"35214",2019,0,58,79,137
"35214",2020,0,0,15,15
"35215",2013,0,0,46,46
"35215",2015,0,0,87,87
"35215",2016,0,53,53,106
"35215",2019,0,58,119,177
"35215",2020,0,0,15,15
"35216",2013,0,0,46,46
"35216",2015,0,0,87,87
"35216",2016,0,53,53,106
"35216",2019,0,58,185,243
"35216",2020,0,0,15,15
"35217",2013,0,0,46,46
"35217",2015,0,0,87,87
"35217",2016,0,53,53,106
"35217",2019,0,58,79,137
"35218",2013,0,0,46,46
"35218",2015,0,0,87,87
"35218",2016,0,53,53,106
"35218",2019,0,58,86,144
"35219",2013,0,0,46,46
"35219",2015,0,0,87,87
"35219",2016,0,53,53,106
"35219",2019,0,58,86,144
"35220",2013,0,0,46,46
"35220",2015,0,0,87,87
"35220",2016,0,53,53,106
"35220",2019,0,58,86,144
"35221",2013,0,0,46,46
"35221",2015,0,0,87,87
"35221",2016,0,53,53,106
"35221",2019,0,58,86,144
"35222",2013,0,0,46,46
"35222",2015,0,0,87,87
"35222",2016,0,53,53,106
"35222",2019,0,58,119,177
"35222",2020,0,0,15,15
"35223",2013,0,0,46,46
"35223",2015,0,0,87,87
"35223",2016,0,53,53,106
"35223",2019,0,58,185,243
"35223",2020,0,0,15,15
"35224",2013,0,0,46,46
"35224",2015,0,0,87,87
"35224",2016,0,53,53,106
"35224",2019,0,58,185,243
"35224",2020,0,0,15,15
"35225",2013,0,0,46,46
"35225",2015,0,0,87,87
"35225",2016,0,53,53,106
"35225",2019,0,58,185,243
"35225",2020,0,0,15,15
"35226",2013,0,0,46,46
"35226",2015,0,0,87,87
"35226",2016,0,53,53,106
"35226",2019,0,58,185,243
"35226",2020,0,0,15,15
"35227",2013,0,0,46,46
"35227",2015,0,0,87,87
"35227",2016,0,53,53,106
"35227",2019,0,58,185,243
"35227",2020,0,0,15,15
"35228",2013,0,0,46,46
"35228",2015,0,0,87,87
"35228",2016,0,53,53,106
"35228",2019,0,58,185,243
"35228",2020,0,0,15,15
"35229",2013,0,0,46,46
"35229",2015,0,0,87,87
"35229",2016,0,53,53,106
"35229",2019,0,58,79,137
"35229",2020,0,0,15,15
"35230",2013,0,0,46,46
"35230",2015,0,0,87,87
"35230",2016,0,53,53,106
"35230",2019,0,58,119,177
"35230",2020,0,0,15,15
"35231",2013,0,0,46,46
"35231",2015,0,0,87,87
"35231",2016,0,53,53,106
"35231",2019,0,58,86,144
"35232",2013,0,0,46,46
"35232",2015,0,0,87,87
"35232",2016,0,53,53,106
"35232",2019,0,58,79,137
"35232",2020,0,0,15,15
"35233",2013,0,0,46,46
"35233",2015,0,0,87,87
"35233",2016,0,53,53,106
"35233",2019,0,58,185,243
"35233",2020,0,0,15,15
"35234",2013,0,0,46,46
"35234",2015,0,0,87,87
"35234",2016,0,53,53,106
"35234",2019,0,58,185,243
"35234",2020,0,0,15,15
"35235",2013,0,0,46,46
"35235",2015,0,0,87,87
"35235",2016,0,53,53,106
"35235",2019,0,58,86,144
"35236",2013,0,0,46,46
"35236",2015,0,0,87,87
"35236",2016,0,53,53,106
"35236",2019,0,58,86,144
"35237",2013,0,0,46,46
"35237",2015,0,0,87,87
"35237",2016,0,53,53,106
"35237",2019,0,58,86,144
"35238",2013,0,0,46,46
"35238",2015,0,0,87,87
"35238",2016,0,53,53,106
"35238",2019,0,58,86,144
"35239",2013,0,0,46,46
"35239",2015,0,0,87,87
"35239",2016,0,53,53,106
"35239",2019,0,58,86,144
"35240",2013,0,0,46,46
"35240",2015,0,0,87,87
"35240",2016,0,53,53,106
"35240",2019,0,58,185,243
"35240",2020,0,0,15,15
"35241",2013,0,0,46,46
"35241",2015,0,0,87,87
"35241",2016,0,53,53,106
"35241",2019,0,58,185,243
"35241",2020,0,0,15,15
"35242",2013,0,0,46,46
"35242",2015,0,0,87,87
"35242",2016,0,53,53,106
"35242",2019,0,58,119,177
"35242",2020,0,0,15,15
"35243",2013,0,0,46,46
"35243",2015,0,0,87,87
"35243",2016,0,53,53,106
"35243",2019,0,58,119,177
"35243",2020,0,0,15,15
"35244",2013,0,0,46,46
"35244",2015,0,0,87,87
"35244",2016,0,53,53,106
"35244",2019,0,58,119,177
"35244",2020,0,0,15,15
"35245",2013,0,0,46,46
"35245",2015,0,0,87,87
"35245",2016,0,53,53,106
"35245",2019,0,58,185,243
"35245",2020,0,0,15,15
"35246",2013,0,0,46,46
"35246",2015,0,0,87,87
"35246",2016,0,53,53,106
"35246",2019,0,58,185,243
"35246",2020,0,0,15,15
"35247",2013,0,0,46,46
"35247",2015,0,0,87,87
"35247",2016,0,53,53,106
"35247",2019,0,58,185,243
"35247",2020,0,0,15,15
"35248",2013,0,0,46,46
"35248",2015,0,0,87,87
"35248",2016,0,53,53,106
"35248",2019,0,58,185,243
"35248",2020,0,0,15,15
"35249",2013,0,0,44,44
"35249",2015,0,0,87,87
"35249",2016,0,53,53,106
"35249",2019,0,58,86,144
"35250",2013,0,0,46,46
"35250",2015,0,0,87,87
"35250",2016,0,53,53,106
"35250",2019,0,58,86,144
"35251",2013,0,0,46,46
"35251",2015,0,0,87,87
"35251",2016,0,53,53,106
"35251",2019,0,58,185,243
"35251",2020,0,0,15,15
"35252",2013,0,0,46,46
"35252",2015,0,0,87,87
"35252",2016,0,53,53,106
"35252",2019,0,58,79,137
"35252",2020,0,0,15,15
"35253",2013,0,0,46,46
"35253",2015,0,0,87,87
"35253",2016,0,53,53,106
"35253",2019,0,58,79,137
"35253",2020,0,0,15,15
"35255",2013,0,0,46,46
"35255",2015,0,0,87,87
"35255",2016,0,53,53,106
"35255",2019,0,58,185,243
"35255",2020,0,0,15,15
"35256",2013,0,0,46,46
"35256",2015,0,0,87,87
"35256",2016,0,53,53,106
"35256",2019,0,58,185,243
"35256",2020,0,0,15,15
"35257",2013,0,0,46,46
"35257",2015,0,0,87,87
"35257",2016,0,53,53,106
"35257",2019,0,58,119,177
"35257",2020,0,0,15,15
"35258",2013,0,0,46,46
"35258",2015,0,0,87,87
"35258",2016,0,53,53,106
"35258",2019,0,58,185,243
"35258",2020,0,0,15,15
"35259",2013,0,0,46,46
"35259",2015,0,0,87,87
"35259",2016,0,53,53,106
"35259",2019,0,58,185,243
"35259",2020,0,0,15,15
"35260",2013,0,0,46,46
"35260",2015,0,0,87,87
"35260",2016,0,53,53,106
"35260",2019,0,58,79,137
"35260",2020,0,0,15,15
"35261",2013,0,0,46,46
"35261",2015,0,0,87,87
"35261",2016,0,53,53,106
"35261",2019,0,58,119,177
"35261",2020,0,0,15,15
"35262",2013,0,0,46,46
"35262",2015,0,0,87,87
"35262",2016,0,53,53,106
"35262",2019,0,58,86,144
"35263",2013,0,0,46,46
"35263",2015,0,0,87,87
"35263",2016,0,53,53,106
"35263",2019,0,58,185,243
"35263",2020,0,0,15,15
"35264",2013,0,0,46,46
"35264",2015,0,0,87,87
"35264",2016,0,53,53,106
"35264",2019,0,58,79,137
"35265",2013,0,0,46,46
"35265",2015,0,0,87,87
"35265",2016,0,53,53,106
"35265",2019,0,58,185,243
"35265",2020,0,0,15,15
"35266",2013,0,0,46,46
"35266",2015,0,0,87,87
"35266",2016,0,53,53,106
"35266",2019,0,58,86,144
"35268",2013,0,0,46,46
"35268",2015,0,0,87,87
"35268",2016,0,53,53,106
"35268",2019,0,58,86,144
"35270",2013,0,0,46,46
"35270",2015,0,0,87,87
"35270",2016,0,53,53,106
"35270",2019,0,58,185,243
"35270",2020,0,0,15,15
"35271",2013,0,0,46,46
"35271",2015,0,0,87,87
"35271",2016,0,53,53,106
"35271",2019,0,58,119,177
"35271",2020,0,0,15,15
"35272",2013,0,0,46,46
"35272",2015,0,0,87,87
"35272",2016,0,53,53,106
"35272",2019,0,58,79,137
"35273",2013,0,0,46,46
"35273",2015,0,0,87,87
"35273",2016,0,53,53,106
"35273",2019,0,58,119,177
"35273",2020,0,0,15,15
"35274",2013,0,0,46,46
"35274",2015,0,0,87,87
"35274",2016,0,53,53,106
"35274",2019,0,58,185,243
"35274",2020,0,0,15,15
"35275",2013,0,0,46,46
"35275",2015,0,0,87,87
"35275",2016,0,53,53,106
"35275",2019,0,58,185,243
"35275",2020,0,0,15,15
"35276",2013,0,0,46,46
"35276",2015,0,0,87,87
"35276",2016,0,53,53,106
"35276",2019,0,58,185,243
"35276",2020,0,0,15,15
"35277",2013,0,0,46,46
"35277",2015,0,0,87,87
"35277",2016,0,53,53,106
"35277",2019,0,58,185,243
"35277",2020,0,0,15,15
"35278",2013,0,0,46,46
"35278",2015,0,0,87,87
"35278",2016,0,53,53,106
"35278",2019,0,58,185,243
"35278",2020,0,0,15,15
"35279",2013,0,0,46,46
"35279",2015,0,0,87,87
"35279",2016,0,53,53,106
"35279",2019,0,58,185,243
"35279",2020,0,0,15,15
"35280",2013,0,0,46,46
"35280",2015,0,0,87,87
"35280",2016,0,53,53,106
"35280",2019,0,58,119,177
"35280",2020,0,0,15,15
"35281",2013,0,0,46,46
"35281",2015,0,0,87,87
"35281",2016,0,53,53,106
"35281",2019,0,58,86,144
"35282",2013,0,0,46,46
"35282",2015,0,0,87,87
"35282",2016,0,53,53,106
"35282",2019,0,58,79,137
"35282",2020,0,0,15,15
"35283",2013,0,0,46,46
"35283",2015,0,0,87,87
"35283",2016,0,53,53,106
"35283",2019,0,58,79,137
"35283",2020,0,0,15,15
"35284",2013,0,0,46,46
"35284",2015,0,0,87,87
"35284",2016,0,53,53,106
"35284",2019,0,58,185,243
"35284",2020,0,0,15,15
"35285",2013,0,0,46,46
"35285",2015,0,0,87,87
"35285",2016,0,53,53,106
"35285",2019,0,58,86,144
"35286",2013,0,0,46,46
"35286",2015,0,0,87,87
"35286",2016,0,53,53,106
"35286",2019,0,58,119,177
"35286",2020,0,0,15,15
"35287",2013,0,0,46,46
"35287",2015,0,0,87,87
"35287",2016,0,53,53,106
"35287",2019,0,58,185,243
"35287",2020,0,0,15,15
"35288",2013,0,0,46,46
"35288",2015,0,0,87,87
"35288",2016,0,53,53,106
"35288",2019,0,58,185,243
"35288",2020,0,0,15,15
"35289",2013,0,0,46,46
"35289",2015,0,0,87,87
"35289",2016,0,53,53,106
"35289",2019,0,58,86,144
"35290",2013,0,0,46,46
"35290",2015,0,0,87,87
"35290",2016,0,53,53,106
"35290",2019,0,58,185,243
"35290",2020,0,0,15,15
"35291",2013,0,0,46,46
"35291",2015,0,0,87,87
"35291",2016,0,53,53,106
"35291",2019,0,58,185,243
"35291",2020,0,0,15,15
"35292",2013,0,0,46,46
"35292",2015,0,0,87,87
"35292",2016,0,53,53,106
"35292",2019,0,58,119,177
"35292",2020,0,0,15,15
"35294",2013,0,0,46,46
"35294",2015,0,0,87,87
"35294",2016,0,53,53,106
"35294",2019,0,58,86,144
"35295",2013,0,0,46,46
"35295",2015,0,0,87,87
"35295",2016,0,53,53,106
"35295",2019,0,58,185,243
"35295",2020,0,0,15,15
"35296",2013,0,0,46,46
"35296",2015,0,0,87,87
"35296",2016,0,53,53,106
"35296",2019,0,58,185,243
"35296",2020,0,0,15,15
"35297",2013,0,0,46,46
"35297",2015,0,0,87,87
"35297",2016,0,53,53,106
"35297",2019,0,58,185,243
"35297",2020,0,0,15,15
"35299",2013,0,0,46,46
"35299",2015,0,0,87,87
"35299",2016,0,53,53,106
"35299",2019,0,58,185,243
"35299",2020,0,0,15,15
"35300",2013,0,0,46,46
"35300",2015,0,0,87,87
"35300",2016,0,53,53,106
"35300",2019,0,58,79,137
"35300",2020,0,0,15,15
"35302",2013,0,0,46,46
"35302",2015,0,0,87,87
"35302",2016,0,53,53,106
"35302",2019,0,58,185,243
"35302",2020,0,0,15,15
"35304",2013,0,0,46,46
"35304",2015,0,0,87,87
"35304",2016,0,53,53,106
"35304",2019,0,58,119,177
"35304",2020,0,0,15,15
"35305",2013,0,0,46,46
"35305",2015,0,0,87,87
"35305",2016,0,53,53,106
"35305",2019,0,58,185,243
"35305",2020,0,0,15,15
"35306",2013,0,0,46,46
"35306",2015,0,0,87,87
"35306",2016,0,53,53,106
"35306",2019,0,58,185,243
"35306",2020,0,0,15,15
"35307",2013,0,0,46,46
"35307",2015,0,0,87,87
"35307",2016,0,53,53,106
"35307",2019,0,58,185,243
"35307",2020,0,0,15,15
"35308",2013,0,0,46,46
"35308",2015,0,0,87,87
"35308",2016,0,53,53,106
"35308",2019,0,58,185,243
"35308",2020,0,0,15,15
"35309",2013,0,0,46,46
"35309",2015,0,0,87,87
"35309",2016,0,53,53,106
"35309",2019,0,58,119,177
"35309",2020,0,0,15,15
"35310",2013,0,0,46,46
"35310",2015,0,0,87,87
"35310",2016,0,53,53,106
"35310",2019,0,58,119,177
"35310",2020,0,0,15,15
"35311",2013,0,0,46,46
"35311",2015,0,0,87,87
"35311",2016,0,53,53,106
"35311",2019,0,58,86,144
"35312",2013,0,0,46,46
"35312",2015,0,0,87,87
"35312",2016,0,53,53,106
"35312",2019,0,58,86,144
"35314",2013,0,0,46,46
"35314",2015,0,0,87,87
"35314",2016,0,53,53,106
"35314",2019,0,58,185,243
"35314",2020,0,0,15,15
"35315",2013,0,0,46,46
"35315",2015,0,0,87,87
"35315",2016,0,53,53,106
"35315",2019,0,58,79,137
"35315",2020,0,0,15,15
"35316",2013,0,0,44,44
"35316",2015,0,0,87,87
"35316",2016,0,53,53,106
"35316",2019,0,58,86,144
"35317",2013,0,0,46,46
"35317",2015,0,0,87,87
"35317",2016,0,53,53,106
"35317",2019,0,58,185,243
"35317",2020,0,0,15,15
"35318",2013,0,0,46,46
"35318",2015,0,0,87,87
"35318",2016,0,53,53,106
"35318",2019,0,58,185,243
"35318",2020,0,0,15,15
"35319",2013,0,0,46,46
"35319",2015,0,0,87,87
"35319",2016,0,53,53,106
"35319",2019,0,58,185,243
"35319",2020,0,0,15,15
"35320",2013,0,0,46,46
"35320",2015,0,0,87,87
"35320",2016,0,53,53,106
"35320",2019,0,58,185,243
"35320",2020,0,0,15,15
"35321",2013,0,0,46,46
"35321",2015,0,0,87,87
"35321",2016,0,53,53,106
"35321",2019,0,58,86,144
"35322",2013,0,0,46,46
"35322",2015,0,0,87,87
"35322",2016,0,53,53,106
"35322",2019,0,58,86,144
"35324",2013,0,0,46,46
"35324",2015,0,0,87,87
"35324",2016,0,53,53,106
"35324",2019,0,58,119,177
"35324",2020,0,0,15,15
"35325",2013,0,0,46,46
"35325",2015,0,0,87,87
"35325",2016,0,53,53,106
"35325",2019,0,58,86,144
"35326",2013,0,0,46,46
"35326",2015,0,0,87,87
"35326",2016,0,53,53,106
"35326",2019,0,58,119,177
"35326",2020,0,0,15,15
"35327",2013,0,0,46,46
"35327",2015,0,0,87,87
"35327",2016,0,53,53,106
"35327",2019,0,58,79,137
"35328",2013,0,0,46,46
"35328",2015,0,0,87,87
"35328",2016,0,53,53,106
"35328",2019,0,58,86,144
"35329",2013,0,0,46,46
"35329",2015,0,0,87,87
"35329",2016,0,53,53,106
"35329",2019,0,58,119,177
"35329",2020,0,0,15,15
"35330",2013,0,0,46,46
"35330",2015,0,0,87,87
"35330",2016,0,53,53,106
"35330",2019,0,58,79,137
"35330",2020,0,0,15,15
"35331",2013,0,0,46,46
"35331",2015,0,0,87,87
"35331",2016,0,53,53,106
"35331",2019,0,58,185,243
"35331",2020,0,0,15,15
"35332",2013,0,0,44,44
"35332",2015,0,0,87,87
"35332",2016,0,53,53,106
"35332",2019,0,58,86,144
"35333",2013,0,0,46,46
"35333",2015,0,0,87,87
"35333",2016,0,53,53,106
"35333",2019,0,58,86,144
"35334",2013,0,0,46,46
"35334",2015,0,0,87,87
"35334",2016,0,53,53,106
"35334",2019,0,58,79,137
"35334",2020,0,0,15,15
"35335",2013,0,0,44,44
"35335",2015,0,0,87,87
"35335",2016,0,53,53,106
"35335",2019,0,58,86,144
"35336",2013,0,0,46,46
"35336",2015,0,0,87,87
"35336",2016,0,53,53,106
"35336",2019,0,58,119,177
"35336",2020,0,0,15,15
"35337",2013,0,0,46,46
"35337",2015,0,0,87,87
"35337",2016,0,53,53,106
"35337",2019,0,58,185,243
"35337",2020,0,0,15,15
"35338",2013,0,0,46,46
"35338",2015,0,0,87,87
"35338",2016,0,53,53,106
"35338",2019,0,58,79,137
"35339",2013,0,0,46,46
"35339",2015,0,0,87,87
"35339",2016,0,53,53,106
"35339",2019,0,58,119,177
"35339",2020,0,0,15,15
"35340",2013,0,0,46,46
"35340",2015,0,0,87,87
"35340",2016,0,53,53,106
"35340",2019,0,58,185,243
"35340",2020,0,0,15,15
"35342",2013,0,0,46,46
"35342",2015,0,0,87,87
"35342",2016,0,53,53,106
"35342",2019,0,58,119,177
"35342",2020,0,0,15,15
"35343",2013,0,0,44,44
"35343",2015,0,0,87,87
"35343",2016,0,53,53,106
"35343",2019,0,58,86,144
"35345",2013,0,0,46,46
"35345",2015,0,0,87,87
"35345",2016,0,53,53,106
"35345",2019,0,58,185,243
"35345",2020,0,0,15,15
"35346",2013,0,0,46,46
"35346",2015,0,0,87,87
"35346",2016,0,53,53,106
"35346",2019,0,58,185,243
"35346",2020,0,0,15,15
"35347",2013,0,0,46,46
"35347",2015,0,0,87,87
"35347",2016,0,53,53,106
"35347",2019,0,58,79,137
"35347",2020,0,0,15,15
"35350",2013,0,0,46,46
"35350",2015,0,0,87,87
"35350",2016,0,53,53,106
"35350",2019,0,58,79,137
"35351",2013,0,0,46,46
"35351",2015,0,0,87,87
"35351",2016,0,53,53,106
"35351",2019,0,58,185,243
"35351",2020,0,0,15,15
"35352",2013,0,0,46,46
"35352",2015,0,0,87,87
"35352",2016,0,53,53,106
"35352",2019,0,58,86,144
"35353",2013,0,0,46,46
"35353",2015,0,0,87,87
"35353",2016,0,53,53,106
"35353",2019,0,58,185,243
"35353",2020,0,0,15,15
"35354",2013,0,0,46,46
"35354",2015,0,0,87,87
"35354",2016,0,53,53,106
"35354",2019,0,58,119,177
"35354",2020,0,0,15,15
"35355",2013,0,0,46,46
"35355",2015,0,0,87,87
"35355",2016,0,53,53,106
"35355",2019,0,58,119,177
"35355",2020,0,0,15,15
"35356",2013,0,0,46,46
"35356",2015,0,0,87,87
"35356",2016,0,53,53,106
"35356",2019,0,58,185,243
"35356",2020,0,0,15,15
"35357",2013,0,0,46,46
"35357",2015,0,0,87,87
"35357",2016,0,53,53,106
"35357",2019,0,58,119,177
"35357",2020,0,0,15,15
"35358",2013,0,0,46,46
"35358",2015,0,0,87,87
"35358",2016,0,53,53,106
"35358",2019,0,58,185,243
"35358",2020,0,0,15,15
"35359",2013,0,0,46,46
"35359",2015,0,0,87,87
"35359",2016,0,53,53,106
"35359",2019,0,58,86,144
"35360",2013,0,0,46,46
"35360",2015,0,0,87,87
"35360",2016,0,53,53,106
"35360",2019,0,58,79,137
"35360",2020,0,0,15,15
"35361",2013,0,0,46,46
"35361",2015,0,0,87,87
"35361",2016,0,53,53,106
"35361",2019,0,58,185,243
"35361",2020,0,0,15,15
"35362",2013,0,0,46,46
"35362",2015,0,0,87,87
"35362",2016,0,53,53,106
"35362",2019,0,58,185,243
"35362",2020,0,0,15,15
"35363",2013,0,0,46,46
"35363",2015,0,0,87,87
"35363",2016,0,53,53,106
"35363",2019,0,58,86,144
"36001",2019,0,0,25,25
"36001",2020,0,0,46,46
"36002",2019,0,0,25,25
"36002",2020,0,0,46,46
"36003",2019,0,0,25,25
"36003",2020,0,0,46,46
"36004",2019,0,0,25,25
"36004",2020,0,0,46,46
"36005",2019,0,0,25,25
"36005",2020,0,0,46,46
"36006",2019,0,0,25,25
"36006",2020,0,0,46,46
"36007",2019,0,0,25,25
"36007",2020,0,0,46,46
"36008",2019,0,0,25,25
"36008",2020,0,0,46,46
"36009",2019,0,0,25,25
"36009",2020,0,0,46,46
"36010",2019,0,0,25,25
"36010",2020,0,0,46,46
"36011",2019,0,0,25,25
"36011",2020,0,0,46,46
"36012",2019,0,0,25,25
"36012",2020,0,0,46,46
"36013",2019,0,0,25,25
"36013",2020,0,0,46,46
"36014",2019,0,0,25,25
"36014",2020,0,0,46,46
"36015",2019,0,0,25,25
"36015",2020,0,0,46,46
"36016",2019,0,0,25,25
"36016",2020,0,0,46,46
"36017",2019,0,0,25,25
"36017",2020,0,0,46,46
"36018",2019,0,0,25,25
"36018",2020,0,0,46,46
"36019",2019,0,0,25,25
"36019",2020,0,0,46,46
"36020",2019,0,0,25,25
"36020",2020,0,0,46,46
"36021",2019,0,0,25,25
"36021",2020,0,0,46,46
"36022",2019,0,0,25,25
"36022",2020,0,0,46,46
"36023",2019,0,0,25,25
"36023",2020,0,0,46,46
"36024",2019,0,0,25,25
"36024",2020,0,0,46,46
"36025",2019,0,0,25,25
"36025",2020,0,0,46,46
"36026",2019,0,0,25,25
"36026",2020,0,0,46,46
"36027",2019,0,0,25,25
"36027",2020,0,0,46,46
"36028",2019,0,0,25,25
"36028",2020,0,0,46,46
"36029",2019,0,0,25,25
"36029",2020,0,0,46,46
"36030",2019,0,0,25,25
"36030",2020,0,0,46,46
"36031",2019,0,0,25,25
"36031",2020,0,0,46,46
"36032",2019,0,0,25,25
"36032",2020,0,0,46,46
"36033",2019,0,0,25,25
"36033",2020,0,0,46,46
"36034",2019,0,0,25,25
"36034",2020,0,0,46,46
"36035",2019,0,0,25,25
"36035",2020,0,0,46,46
"36036",2019,0,0,25,25
"36036",2020,0,0,46,46
"36037",2019,0,0,25,25
"36037",2020,0,0,46,46
"36038",2019,0,0,25,25
"36038",2020,0,0,46,46
"36040",2019,0,0,25,25
"36040",2020,0,0,46,46
"36041",2019,0,0,25,25
"36041",2020,0,0,46,46
"36042",2019,0,0,25,25
"36042",2020,0,0,46,46
"36043",2019,0,0,25,25
"36043",2020,0,0,46,46
"36044",2019,0,0,25,25
"36044",2020,0,0,46,46
"36045",2019,0,0,25,25
"36045",2020,0,0,46,46
"36046",2019,0,0,25,25
"36046",2020,0,0,46,46
"36047",2019,0,0,25,25
"36047",2020,0,0,46,46
"36048",2019,0,0,25,25
"36048",2020,0,0,46,46
"36049",2019,0,0,25,25
"36049",2020,0,0,46,46
"36050",2019,0,0,25,25
"36050",2020,0,0,46,46
"36051",2019,0,0,25,25
"36051",2020,0,0,46,46
"36052",2019,0,0,25,25
"36052",2020,0,0,46,46
"36053",2019,0,0,25,25
"36053",2020,0,0,46,46
"36054",2019,0,0,25,25
"36054",2020,0,0,46,46
"36055",2019,0,0,25,25
"36055",2020,0,0,46,46
"36056",2019,0,0,25,25
"36056",2020,0,0,46,46
"36057",2019,0,0,25,25
"36057",2020,0,0,46,46
"36058",2019,0,0,25,25
"36058",2020,0,0,46,46
"36059",2019,0,0,25,25
"36059",2020,0,0,46,46
"36060",2019,0,0,25,25
"36060",2020,0,0,46,46
"36061",2019,0,0,25,25
"36061",2020,0,0,46,46
"36062",2019,0,0,25,25
"36062",2020,0,0,46,46
"36063",2019,0,0,25,25
"36063",2020,0,0,46,46
"36064",2019,0,0,25,25
"36064",2020,0,0,46,46
"36065",2019,0,0,25,25
"36065",2020,0,0,46,46
"36066",2019,0,0,25,25
"36066",2020,0,0,46,46
"36067",2019,0,0,25,25
"36067",2020,0,0,46,46
"36068",2019,0,0,25,25
"36068",2020,0,0,46,46
"36069",2019,0,0,25,25
"36069",2020,0,0,46,46
"36070",2019,0,0,25,25
"36070",2020,0,0,46,46
"36071",2019,0,0,25,25
"36071",2020,0,0,46,46
"36073",2019,0,0,25,25
"36073",2020,0,0,46,46
"36074",2019,0,0,25,25
"36074",2020,0,0,46,46
"36075",2019,0,0,25,25
"36075",2020,0,0,46,46
"36076",2019,0,0,25,25
"36076",2020,0,0,46,46
"36077",2019,0,0,25,25
"36077",2020,0,0,46,46
"36078",2019,0,0,25,25
"36078",2020,0,0,46,46
"36079",2019,0,0,25,25
"36079",2020,0,0,46,46
"36080",2019,0,0,25,25
"36080",2020,0,0,46,46
"36081",2019,0,0,25,25
"36081",2020,0,0,46,46
"36082",2019,0,0,25,25
"36082",2020,0,0,46,46
"36083",2019,0,0,25,25
"36083",2020,0,0,46,46
"36084",2019,0,0,25,25
"36084",2020,0,0,46,46
"36085",2019,0,0,25,25
"36085",2020,0,0,46,46
"36086",2019,0,0,25,25
"36086",2020,0,0,46,46
"36087",2019,0,0,25,25
"36087",2020,0,0,46,46
"36088",2019,0,0,25,25
"36088",2020,0,0,46,46
"36089",2019,0,0,25,25
"36089",2020,0,0,46,46
"36090",2019,0,0,25,25
"36090",2020,0,0,46,46
"36091",2019,0,0,25,25
"36091",2020,0,0,46,46
"36092",2019,0,0,25,25
"36092",2020,0,0,46,46
"36093",2019,0,0,25,25
"36093",2020,0,0,46,46
"36094",2019,0,0,25,25
"36094",2020,0,0,46,46
"36095",2019,0,0,25,25
"36095",2020,0,0,46,46
"36096",2019,0,0,25,25
"36096",2020,0,0,46,46
"36097",2019,0,0,25,25
"36097",2020,0,0,46,46
"36098",2019,0,0,25,25
"36098",2020,0,0,46,46
"36099",2019,0,0,25,25
"36099",2020,0,0,46,46
"36100",2019,0,0,25,25
"36100",2020,0,0,46,46
"36101",2019,0,0,25,25
"36101",2020,0,0,46,46
"36102",2019,0,0,25,25
"36102",2020,0,0,46,46
"36103",2019,0,0,25,25
"36103",2020,0,0,46,46
"36104",2019,0,0,25,25
"36104",2020,0,0,46,46
"36105",2019,0,0,25,25
"36105",2020,0,0,46,46
"36106",2019,0,0,25,25
"36106",2020,0,0,46,46
"36107",2019,0,0,25,25
"36107",2020,0,0,46,46
"36108",2019,0,0,25,25
"36108",2020,0,0,46,46
"36109",2019,0,0,25,25
"36109",2020,0,0,46,46
"36110",2019,0,0,25,25
"36110",2020,0,0,46,46
"36111",2019,0,0,25,25
"36111",2020,0,0,46,46
"36112",2019,0,0,25,25
"36112",2020,0,0,46,46
"36113",2019,0,0,25,25
"36113",2020,0,0,46,46
"36114",2019,0,0,25,25
"36114",2020,0,0,46,46
"36115",2019,0,0,25,25
"36115",2020,0,0,46,46
"36116",2019,0,0,25,25
"36116",2020,0,0,46,46
"36117",2019,0,0,25,25
"36117",2020,0,0,46,46
"36118",2019,0,0,25,25
"36118",2020,0,0,46,46
"36119",2019,0,0,25,25
"36119",2020,0,0,46,46
"36120",2019,0,0,25,25
"36120",2020,0,0,46,46
"36121",2019,0,0,25,25
"36121",2020,0,0,46,46
"36122",2019,0,0,25,25
"36122",2020,0,0,46,46
"36123",2019,0,0,25,25
"36123",2020,0,0,46,46
"36124",2019,0,0,25,25
"36124",2020,0,0,46,46
"36125",2019,0,0,25,25
"36125",2020,0,0,46,46
"36126",2019,0,0,25,25
"36126",2020,0,0,46,46
"36127",2019,0,0,25,25
"36127",2020,0,0,46,46
"36128",2019,0,0,25,25
"36128",2020,0,0,46,46
"36129",2019,0,0,25,25
"36129",2020,0,0,46,46
"36130",2019,0,0,25,25
"36130",2020,0,0,46,46
"36131",2019,0,0,25,25
"36131",2020,0,0,46,46
"36132",2019,0,0,25,25
"36132",2020,0,0,46,46
"36133",2019,0,0,25,25
"36133",2020,0,0,46,46
"36134",2019,0,0,25,25
"36134",2020,0,0,46,46
"36135",2019,0,0,25,25
"36135",2020,0,0,46,46
"36136",2019,0,0,25,25
"36136",2020,0,0,46,46
"36137",2019,0,0,25,25
"36137",2020,0,0,46,46
"36138",2019,0,0,25,25
"36138",2020,0,0,46,46
"36139",2019,0,0,25,25
"36139",2020,0,0,46,46
"36140",2019,0,0,25,25
"36140",2020,0,0,46,46
"36141",2019,0,0,25,25
"36141",2020,0,0,46,46
"36142",2019,0,0,25,25
"36142",2020,0,0,46,46
"36143",2019,0,0,25,25
"36143",2020,0,0,46,46
"36144",2019,0,0,25,25
"36144",2020,0,0,46,46
"36145",2019,0,0,25,25
"36145",2020,0,0,46,46
"36146",2019,0,0,25,25
"36146",2020,0,0,46,46
"36147",2019,0,0,25,25
"36147",2020,0,0,46,46
"36148",2019,0,0,25,25
"36148",2020,0,0,46,46
"36149",2019,0,0,25,25
"36149",2020,0,0,46,46
"36150",2019,0,0,25,25
"36150",2020,0,0,46,46
"36152",2019,0,0,25,25
"36152",2020,0,0,46,46
"36153",2019,0,0,25,25
"36153",2020,0,0,46,46
"36154",2019,0,0,25,25
"36154",2020,0,0,46,46
"36155",2019,0,0,25,25
"36155",2020,0,0,46,46
"36156",2019,0,0,25,25
"36156",2020,0,0,46,46
"36157",2019,0,0,25,25
"36157",2020,0,0,46,46
"36158",2019,0,0,25,25
"36158",2020,0,0,46,46
"36159",2019,0,0,25,25
"36159",2020,0,0,46,46
"36160",2019,0,0,25,25
"36160",2020,0,0,46,46
"36161",2019,0,0,25,25
"36161",2020,0,0,46,46
"36162",2019,0,0,25,25
"36162",2020,0,0,46,46
"36163",2019,0,0,25,25
"36163",2020,0,0,46,46
"36164",2019,0,0,25,25
"36164",2020,0,0,46,46
"36165",2019,0,0,25,25
"36165",2020,0,0,46,46
"36166",2019,0,0,25,25
"36166",2020,0,0,46,46
"36167",2019,0,0,25,25
"36167",2020,0,0,46,46
"36168",2019,0,0,25,25
"36168",2020,0,0,46,46
"36169",2019,0,0,25,25
"36169",2020,0,0,46,46
"36170",2019,0,0,25,25
"36170",2020,0,0,46,46
"36171",2019,0,0,25,25
"36171",2020,0,0,46,46
"36172",2019,0,0,25,25
"36172",2020,0,0,46,46
"36173",2019,0,0,25,25
"36173",2020,0,0,46,46
"36174",2019,0,0,25,25
"36174",2020,0,0,46,46
"36175",2019,0,0,25,25
"36175",2020,0,0,46,46
"36176",2019,0,0,25,25
"36176",2020,0,0,46,46
"36177",2019,0,0,25,25
"36177",2020,0,0,46,46
"36178",2019,0,0,25,25
"36178",2020,0,0,46,46
"36179",2019,0,0,25,25
"36179",2020,0,0,46,46
"36180",2019,0,0,25,25
"36180",2020,0,0,46,46
"36181",2019,0,0,25,25
"36181",2020,0,0,46,46
"36182",2019,0,0,25,25
"36182",2020,0,0,46,46
"36184",2019,0,0,25,25
"36184",2020,0,0,46,46
"36185",2019,0,0,25,25
"36185",2020,0,0,46,46
"36186",2019,0,0,25,25
"36186",2020,0,0,46,46
"36187",2019,0,0,25,25
"36187",2020,0,0,46,46
"36188",2019,0,0,25,25
"36188",2020,0,0,46,46
"36189",2019,0,0,25,25
"36189",2020,0,0,46,46
"36190",2019,0,0,25,25
"36190",2020,0,0,46,46
"36191",2019,0,0,25,25
"36191",2020,0,0,46,46
"36192",2019,0,0,25,25
"36192",2020,0,0,46,46
"36193",2019,0,0,25,25
"36193",2020,0,0,46,46
"36194",2019,0,0,25,25
"36194",2020,0,0,46,46
"36195",2019,0,0,25,25
"36195",2020,0,0,46,46
"36196",2019,0,0,25,25
"36196",2020,0,0,46,46
"36197",2019,0,0,25,25
"36197",2020,0,0,46,46
"36198",2019,0,0,25,25
"36198",2020,0,0,46,46
"36199",2019,0,0,25,25
"36199",2020,0,0,46,46
"36200",2019,0,0,25,25
"36200",2020,0,0,46,46
"36202",2019,0,0,25,25
"36202",2020,0,0,46,46
"36203",2019,0,0,25,25
"36203",2020,0,0,46,46
"36204",2019,0,0,25,25
"36204",2020,0,0,46,46
"36205",2019,0,0,25,25
"36205",2020,0,0,46,46
"36207",2019,0,0,25,25
"36207",2020,0,0,46,46
"36208",2019,0,0,25,25
"36208",2020,0,0,46,46
"36209",2019,0,0,25,25
"36209",2020,0,0,46,46
"36210",2019,0,0,25,25
"36210",2020,0,0,46,46
"36211",2019,0,0,25,25
"36211",2020,0,0,46,46
"36212",2019,0,0,25,25
"36212",2020,0,0,46,46
"36213",2019,0,0,25,25
"36213",2020,0,0,46,46
"36214",2019,0,0,25,25
"36214",2020,0,0,46,46
"36215",2019,0,0,25,25
"36215",2020,0,0,46,46
"36216",2019,0,0,25,25
"36216",2020,0,0,46,46
"36217",2019,0,0,25,25
"36217",2020,0,0,46,46
"36218",2019,0,0,25,25
"36218",2020,0,0,46,46
"36219",2019,0,0,25,25
"36219",2020,0,0,46,46
"36220",2019,0,0,25,25
"36220",2020,0,0,46,46
"36221",2019,0,0,25,25
"36221",2020,0,0,46,46
"36222",2019,0,0,25,25
"36222",2020,0,0,46,46
"36223",2019,0,0,25,25
"36223",2020,0,0,46,46
"36224",2019,0,0,25,25
"36224",2020,0,0,46,46
"36225",2019,0,0,25,25
"36225",2020,0,0,46,46
"36226",2019,0,0,25,25
"36226",2020,0,0,46,46
"36227",2019,0,0,25,25
"36227",2020,0,0,46,46
"36228",2019,0,0,25,25
"36228",2020,0,0,46,46
"36229",2019,0,0,25,25
"36229",2020,0,0,46,46
"36230",2019,0,0,25,25
"36230",2020,0,0,46,46
"36231",2019,0,0,25,25
"36231",2020,0,0,46,46
"36232",2019,0,0,25,25
"36232",2020,0,0,46,46
"36233",2019,0,0,25,25
"36233",2020,0,0,46,46
"36234",2019,0,0,25,25
"36234",2020,0,0,46,46
"36235",2019,0,0,25,25
"36235",2020,0,0,46,46
"36236",2019,0,0,25,25
"36236",2020,0,0,46,46
"36237",2019,0,0,25,25
"36237",2020,0,0,46,46
"36238",2019,0,0,25,25
"36238",2020,0,0,46,46
"36239",2019,0,0,25,25
"36239",2020,0,0,46,46
"36240",2019,0,0,25,25
"36240",2020,0,0,46,46
"36241",2019,0,0,25,25
"36241",2020,0,0,46,46
"36242",2019,0,0,25,25
"36242",2020,0,0,46,46
"36243",2019,0,0,25,25
"36243",2020,0,0,46,46
"36244",2019,0,0,25,25
"36244",2020,0,0,46,46
"36246",2019,0,0,25,25
"36246",2020,0,0,46,46
"36247",2019,0,0,25,25
"36247",2020,0,0,46,46
"36248",2019,0,0,25,25
"36248",2020,0,0,46,46
"37003",2018,0,0,67,67
"37009",2018,0,0,67,67
"37010",2018,0,0,67,67
"37021",2019,0,0,15,15
"37026",2019,0,0,15,15
"37029",2019,0,0,15,15
"37036",2019,0,0,15,15
"37037",2019,0,0,15,15
"37041",2019,0,0,15,15
"37043",2018,0,0,67,67
"37044",2019,0,0,15,15
"37052",2018,0,0,67,67
"37057",2019,0,0,15,15
"37061",2019,0,0,15,15
"37062",2019,0,0,15,15
"37064",2019,0,0,15,15
"37068",2019,0,0,15,15
"37084",2019,0,0,15,15
"37086",2019,0,0,15,15
"37095",2018,0,0,67,67
"37097",2019,0,0,15,15
"37101",2019,0,0,15,15
"37104",2019,0,0,15,15
"37106",2019,0,0,15,15
"37113",2019,0,0,15,15
"37116",2019,0,0,15,15
"37131",2018,0,0,67,67
"37134",2019,0,0,15,15
"37136",2019,0,0,15,15
"37137",2019,0,0,15,15
"37143",2019,0,0,15,15
"37149",2019,0,0,15,15
"37155",2019,0,0,15,15
"37158",2018,0,0,67,67
"37160",2018,0,0,67,67
"37162",2019,0,0,15,15
"37163",2018,0,0,67,67
"37166",2018,0,0,67,67
"37167",2019,0,0,15,15
"37170",2019,0,0,15,15
"37171",2018,0,0,67,67
"37173",2019,0,0,15,15
"37181",2019,0,0,15,15
"37184",2019,0,0,15,15
"37185",2018,0,0,67,67
"37203",2018,0,0,67,67
"37204",2019,0,0,15,15
"37207",2019,0,0,15,15
"37211",2019,0,0,15,15
"37212",2019,0,0,15,15
"37213",2019,0,0,15,15
"37218",2019,0,0,15,15
"37223",2019,0,0,15,15
"37224",2019,0,0,15,15
"37229",2018,0,0,67,67
"37230",2018,0,0,67,67
"37231",2019,0,0,15,15
"37245",2019,0,0,15,15
"37249",2019,0,0,15,15
"37251",2019,0,0,15,15
"37254",2019,0,0,15,15
"37270",2018,0,0,67,67
"37274",2019,0,0,15,15
"37277",2019,0,0,15,15
"37279",2019,0,0,15,15
"37280",2019,0,0,15,15
"37281",2018,0,0,67,67
"38001",2015,0,1,91,92
"38001",2016,0,22,22,44
"38001",2017,0,95,95,190
"38001",2018,0,18,54,72
"38001",2019,0,93,140,233
"38001",2020,0,96,203,299
"38002",2015,0,0,91,91
"38002",2016,0,0,22,22
"38002",2017,0,0,95,95
"38002",2018,0,18,54,72
"38002",2019,0,134,160,294
"38002",2020,0,186,186,372
"38003",2015,0,0,91,91
"38003",2016,0,22,22,44
"38003",2017,0,95,95,190
"38003",2018,0,18,54,72
"38003",2019,0,93,140,233
"38003",2020,0,96,233,329
"38004",2015,0,0,91,91
"38004",2016,0,0,22,22
"38004",2017,0,0,95,95
"38004",2018,0,18,54,72
"38004",2019,0,93,140,233
"38004",2020,0,96,233,329
"38005",2015,0,0,91,91
"38005",2016,0,0,22,22
"38005",2017,0,0,95,95
"38005",2018,0,18,54,72
"38005",2019,0,109,135,244
"38005",2020,0,186,186,372
"38006",2015,0,0,91,91
"38006",2016,0,0,22,22
"38006",2017,0,0,95,95
"38006",2018,0,18,54,72
"38006",2019,0,134,160,294
"38006",2020,0,186,186,372
"38008",2015,0,0,91,91
"38008",2016,0,0,22,22
"38008",2017,0,0,95,95
"38008",2018,0,18,54,72
"38008",2019,0,47,135,182
"38008",2020,0,186,186,372
"38009",2015,0,0,91,91
"38009",2016,0,22,22,44
"38009",2017,0,95,95,190
"38009",2018,0,18,54,72
"38009",2019,0,93,140,233
"38009",2020,0,96,233,329
"38010",2015,0,0,91,91
"38010",2016,0,0,22,22
"38010",2017,0,0,95,95
"38010",2018,0,18,54,72
"38010",2019,0,166,166,332
"38010",2020,0,186,233,419
"38011",2015,0,1,91,92
"38011",2016,0,0,22,22
"38011",2017,0,95,95,190
"38011",2018,0,100,36,136
"38011",2019,0,0,140,140
"38011",2020,0,0,186,186
"38012",2015,0,1,91,92
"38012",2016,0,22,22,44
"38012",2017,0,95,95,190
"38012",2018,0,18,54,72
"38012",2019,0,166,140,306
"38012",2020,0,156,203,359
"38013",2015,0,0,91,91
"38013",2016,0,22,22,44
"38013",2017,0,95,95,190
"38013",2018,0,18,54,72
"38013",2019,0,93,140,233
"38013",2020,0,96,203,299
"38015",2015,0,1,35,36
"38015",2016,0,22,22,44
"38015",2017,0,95,95,190
"38015",2018,0,46,54,100
"38015",2019,0,73,140,213
"38015",2020,0,60,167,227
"38017",2015,0,0,91,91
"38017",2016,0,22,22,44
"38017",2017,0,95,95,190
"38017",2018,0,18,54,72
"38017",2019,0,93,140,233
"38017",2020,0,96,233,329
"38018",2015,0,0,91,91
"38018",2016,0,0,22,22
"38018",2017,0,0,95,95
"38018",2018,0,18,54,72
"38018",2019,0,93,140,233
"38018",2020,0,96,233,329
"38019",2015,0,1,35,36
"38019",2016,0,22,22,44
"38019",2017,0,95,95,190
"38019",2018,0,18,54,72
"38019",2019,0,73,140,213
"38019",2020,0,60,167,227
"38020",2015,0,0,91,91
"38020",2016,0,0,22,22
"38020",2017,0,0,95,95
"38020",2018,0,18,54,72
"38020",2019,0,47,135,182
"38020",2020,0,186,186,372
"38022",2015,0,1,91,92
"38022",2016,0,22,22,44
"38022",2017,0,95,95,190
"38022",2018,0,18,54,72
"38022",2019,0,166,140,306
"38022",2020,0,156,203,359
"38023",2015,0,0,91,91
"38023",2016,0,0,22,22
"38023",2017,0,0,95,95
"38023",2018,0,18,54,72
"38023",2019,0,47,135,182
"38023",2020,0,186,186,372
"38026",2015,0,0,91,91
"38026",2016,0,0,22,22
"38026",2017,0,0,95,95
"38026",2018,0,18,54,72
"38026",2019,0,166,166,332
"38026",2020,0,186,233,419
"38027",2015,0,0,91,91
"38027",2016,0,0,22,22
"38027",2017,0,0,95,95
"38027",2018,0,18,54,72
"38027",2019,0,134,160,294
"38027",2020,0,186,186,372
"38029",2015,0,0,91,91
"38029",2016,0,0,22,22
"38029",2017,0,0,95,95
"38029",2018,0,18,54,72
"38029",2019,0,93,140,233
"38029",2020,0,126,233,359
"38030",2015,0,0,91,91
"38030",2016,0,22,22,44
"38030",2017,0,95,95,190
"38030",2018,0,18,54,72
"38030",2019,0,93,140,233
"38030",2020,0,96,233,329
"38031",2015,0,0,91,91
"38031",2016,0,0,22,22
"38031",2017,0,0,95,95
"38031",2018,0,18,54,72
"38031",2019,0,47,135,182
"38031",2020,0,186,186,372
"38032",2015,0,0,91,91
"38032",2016,0,22,22,44
"38032",2017,0,95,95,190
"38032",2018,0,18,54,72
"38032",2019,0,93,140,233
"38032",2020,0,96,233,329
"38033",2015,0,0,91,91
"38033",2016,0,0,22,22
"38033",2017,0,0,95,95
"38033",2018,0,18,54,72
"38033",2019,0,93,140,233
"38033",2020,0,96,233,329
"38034",2015,0,0,91,91
"38034",2016,0,22,22,44
"38034",2017,0,95,95,190
"38034",2018,0,18,54,72
"38034",2019,0,93,140,233
"38034",2020,0,96,233,329
"38035",2015,0,1,35,36
"38035",2016,0,22,22,44
"38035",2017,0,95,95,190
"38035",2018,0,46,54,100
"38035",2019,0,73,140,213
"38035",2020,0,60,167,227
"38036",2015,0,0,91,91
"38036",2016,0,0,22,22
"38036",2017,0,0,95,95
"38036",2018,0,18,54,72
"38036",2019,0,93,140,233
"38036",2020,0,96,233,329
"38037",2015,0,0,91,91
"38037",2016,0,22,22,44
"38037",2017,0,95,95,190
"38037",2018,0,18,54,72
"38037",2019,0,93,140,233
"38037",2020,0,96,233,329
"38038",2015,0,0,91,91
"38038",2016,0,22,22,44
"38038",2017,0,95,95,190
"38038",2018,0,18,54,72
"38038",2019,0,93,140,233
"38038",2020,0,96,233,329
"38039",2015,0,0,91,91
"38039",2016,0,0,22,22
"38039",2017,0,0,95,95
"38039",2018,0,18,54,72
"38039",2019,0,134,160,294
"38039",2020,0,186,186,372
"38040",2015,0,0,91,91
"38040",2016,0,0,22,22
"38040",2017,0,0,95,95
"38040",2018,0,18,54,72
"38040",2019,0,47,135,182
"38040",2020,0,186,186,372
"38041",2015,0,0,91,91
"38041",2016,0,0,22,22
"38041",2017,0,0,95,95
"38041",2018,0,18,54,72
"38041",2019,0,93,140,233
"38041",2020,0,96,120,216
"38042",2015,0,0,91,91
"38042",2016,0,22,22,44
"38042",2017,0,95,95,190
"38042",2018,0,18,54,72
"38042",2019,0,93,140,233
"38042",2020,0,96,233,329
"38043",2015,0,1,91,92
"38043",2016,0,22,22,44
"38043",2017,0,95,95,190
"38043",2018,0,18,54,72
"38043",2019,0,166,140,306
"38043",2020,0,156,203,359
"38044",2015,0,0,91,91
"38044",2016,0,0,22,22
"38044",2017,0,0,95,95
"38044",2018,0,18,54,72
"38044",2019,0,93,140,233
"38044",2020,0,126,233,359
"38045",2015,0,0,91,91
"38045",2016,0,0,22,22
"38045",2017,0,0,95,95
"38045",2018,0,18,54,72
"38045",2019,0,93,140,233
"38045",2020,0,96,233,329
"38046",2015,0,0,91,91
"38046",2016,0,22,22,44
"38046",2017,0,95,95,190
"38046",2018,0,18,54,72
"38046",2019,0,93,140,233
"38046",2020,0,96,233,329
"38047",2015,0,0,91,91
"38047",2016,0,0,22,22
"38047",2017,0,0,95,95
"38047",2018,0,18,54,72
"38047",2019,0,93,140,233
"38047",2020,0,126,233,359
"38048",2015,0,1,35,36
"38048",2016,0,22,22,44
"38048",2017,0,95,95,190
"38048",2018,0,100,36,136
"38048",2019,0,0,140,140
"38048",2020,0,0,120,120
"38049",2015,0,1,35,36
"38049",2016,0,22,22,44
"38049",2017,0,95,95,190
"38049",2018,0,18,54,72
"38049",2019,0,73,140,213
"38049",2020,0,60,167,227
"38050",2015,0,0,91,91
"38050",2016,0,0,22,22
"38050",2017,0,0,95,95
"38050",2018,0,18,54,72
"38050",2019,0,166,166,332
"38050",2020,0,186,233,419
"38051",2015,0,0,91,91
"38051",2016,0,22,22,44
"38051",2017,0,95,95,190
"38051",2018,0,18,54,72
"38051",2019,0,93,140,233
"38051",2020,0,96,233,329
"38052",2015,0,0,91,91
"38052",2016,0,0,22,22
"38052",2017,0,0,95,95
"38052",2018,0,18,54,72
"38052",2019,0,47,135,182
"38052",2020,0,186,186,372
"38053",2015,0,0,91,91
"38053",2016,0,0,22,22
"38053",2017,0,0,95,95
"38053",2018,0,18,54,72
"38053",2019,0,93,140,233
"38053",2020,0,126,233,359
"38054",2015,0,0,91,91
"38054",2016,0,0,22,22
"38054",2017,0,0,95,95
"38054",2018,0,18,54,72
"38054",2019,0,166,166,332
"38054",2020,0,186,233,419
"38055",2015,0,0,91,91
"38055",2016,0,0,22,22
"38055",2017,0,0,95,95
"38055",2018,0,18,54,72
"38055",2019,0,166,166,332
"38055",2020,0,186,233,419
"38056",2015,0,0,91,91
"38056",2016,0,22,22,44
"38056",2017,0,95,95,190
"38056",2018,0,18,54,72
"38056",2019,0,93,140,233
"38056",2020,0,96,233,329
"38057",2015,0,0,91,91
"38057",2016,0,0,22,22
"38057",2017,0,0,95,95
"38057",2018,0,18,54,72
"38057",2019,0,109,135,244
"38057",2020,0,186,186,372
"38058",2015,0,0,91,91
"38058",2016,0,22,22,44
"38058",2017,0,95,95,190
"38058",2018,0,18,54,72
"38058",2019,0,93,140,233
"38058",2020,0,96,233,329
"38059",2015,0,0,91,91
"38059",2016,0,0,22,22
"38059",2017,0,0,95,95
"38059",2018,0,18,54,72
"38059",2019,0,109,135,244
"38059",2020,0,186,186,372
"38060",2015,0,0,91,91
"38060",2016,0,22,22,44
"38060",2017,0,95,95,190
"38060",2018,0,18,54,72
"38060",2019,0,93,140,233
"38060",2020,0,96,233,329
"38061",2015,0,1,91,92
"38061",2016,0,22,22,44
"38061",2017,0,95,95,190
"38061",2018,0,18,54,72
"38061",2019,0,93,140,233
"38061",2020,0,96,203,299
"38062",2015,0,0,91,91
"38062",2016,0,0,22,22
"38062",2017,0,0,95,95
"38062",2018,0,18,54,72
"38062",2019,0,134,160,294
"38062",2020,0,186,186,372
"38063",2015,0,0,91,91
"38063",2016,0,22,22,44
"38063",2017,0,95,95,190
"38063",2018,0,18,54,72
"38063",2019,0,93,140,233
"38063",2020,0,96,233,329
"38064",2015,0,0,91,91
"38064",2016,0,0,22,22
"38064",2017,0,0,95,95
"38064",2018,0,18,54,72
"38064",2019,0,93,140,233
"38064",2020,0,126,233,359
"38065",2015,0,0,91,91
"38065",2016,0,22,22,44
"38065",2017,0,95,95,190
"38065",2018,0,18,54,72
"38065",2019,0,93,140,233
"38065",2020,0,96,233,329
"38066",2015,0,1,35,36
"38066",2016,0,22,22,44
"38066",2017,0,95,95,190
"38066",2018,0,18,54,72
"38066",2019,0,73,140,213
"38066",2020,0,60,167,227
"38067",2015,0,0,91,91
"38067",2016,0,0,22,22
"38067",2017,0,0,95,95
"38067",2018,0,18,54,72
"38067",2019,0,93,140,233
"38067",2020,0,126,233,359
"38068",2015,0,0,91,91
"38068",2016,0,0,22,22
"38068",2017,0,0,95,95
"38068",2018,0,18,54,72
"38068",2019,0,47,135,182
"38068",2020,0,186,186,372
"38069",2015,0,1,35,36
"38069",2016,0,22,22,44
"38069",2017,0,95,95,190
"38069",2018,0,18,54,72
"38069",2019,0,73,140,213
"38069",2020,0,60,167,227
"38070",2015,0,0,91,91
"38070",2016,0,0,22,22
"38070",2017,0,0,95,95
"38070",2018,0,18,54,72
"38070",2019,0,134,160,294
"38070",2020,0,186,186,372
"38071",2015,0,0,91,91
"38071",2016,0,0,22,22
"38071",2017,0,0,95,95
"38071",2018,0,18,54,72
"38071",2019,0,47,135,182
"38071",2020,0,186,186,372
"38072",2015,0,0,91,91
"38072",2016,0,22,22,44
"38072",2017,0,95,95,190
"38072",2018,0,18,54,72
"38072",2019,0,93,140,233
"38072",2020,0,96,233,329
"38073",2015,0,0,91,91
"38073",2016,0,0,22,22
"38073",2017,0,0,95,95
"38073",2018,0,18,54,72
"38073",2019,0,47,135,182
"38073",2020,0,186,186,372
"38074",2015,0,0,91,91
"38074",2016,0,0,22,22
"38074",2017,0,0,95,95
"38074",2018,0,18,54,72
"38074",2019,0,93,140,233
"38074",2020,0,96,233,329
"38075",2015,0,0,91,91
"38075",2016,0,0,22,22
"38075",2017,0,0,95,95
"38075",2018,0,18,54,72
"38075",2019,0,134,160,294
"38075",2020,0,186,186,372
"38076",2015,0,0,91,91
"38076",2016,0,0,22,22
"38076",2017,0,0,95,95
"38076",2018,0,18,54,72
"38076",2019,0,93,140,233
"38076",2020,0,126,233,359
"38077",2015,0,0,91,91
"38077",2016,0,22,22,44
"38077",2017,0,95,95,190
"38077",2018,0,18,54,72
"38077",2019,0,93,140,233
"38077",2020,0,96,233,329
"38078",2015,0,0,91,91
"38078",2016,0,0,22,22
"38078",2017,0,0,95,95
"38078",2018,0,18,54,72
"38078",2019,0,134,160,294
"38078",2020,0,186,186,372
"38080",2015,0,0,91,91
"38080",2016,0,0,22,22
"38080",2017,0,0,95,95
"38080",2018,0,18,54,72
"38080",2019,0,93,140,233
"38080",2020,0,126,233,359
"38081",2015,0,1,35,36
"38081",2016,0,22,22,44
"38081",2017,0,95,95,190
"38081",2018,0,46,54,100
"38081",2019,0,73,140,213
"38081",2020,0,60,167,227
"38082",2015,0,1,91,92
"38082",2016,0,22,22,44
"38082",2017,0,95,95,190
"38082",2018,0,18,54,72
"38082",2019,0,93,140,233
"38082",2020,0,96,203,299
"38083",2015,0,0,91,91
"38083",2016,0,0,22,22
"38083",2017,0,0,95,95
"38083",2018,0,18,54,72
"38083",2019,0,166,166,332
"38083",2020,0,186,233,419
"38084",2015,0,0,91,91
"38084",2016,0,0,22,22
"38084",2017,0,0,95,95
"38084",2018,0,18,54,72
"38084",2019,0,228,228,456
"38084",2020,0,186,233,419
"38085",2015,0,1,91,92
"38085",2016,0,0,22,22
"38085",2017,0,95,95,190
"38085",2018,0,100,36,136
"38085",2019,0,0,140,140
"38085",2020,0,0,186,186
"38086",2015,0,0,91,91
"38086",2016,0,22,22,44
"38086",2017,0,95,95,190
"38086",2018,0,18,54,72
"38086",2019,0,93,140,233
"38086",2020,0,96,120,216
"38087",2015,0,1,35,36
"38087",2016,0,22,22,44
"38087",2017,0,95,95,190
"38087",2018,0,46,54,100
"38087",2019,0,73,140,213
"38087",2020,0,60,167,227
"38089",2015,0,0,91,91
"38089",2016,0,0,22,22
"38089",2017,0,0,95,95
"38089",2018,0,18,54,72
"38089",2019,0,93,140,233
"38089",2020,0,126,233,359
"38090",2015,0,0,91,91
"38090",2016,0,0,22,22
"38090",2017,0,0,95,95
"38090",2018,0,18,54,72
"38090",2019,0,135,73,208
"38090",2020,0,186,186,372
"38091",2015,0,0,91,91
"38091",2016,0,0,22,22
"38091",2017,0,0,95,95
"38091",2018,0,18,54,72
"38091",2019,0,93,140,233
"38091",2020,0,126,233,359
"38092",2015,0,0,91,91
"38092",2016,0,0,22,22
"38092",2017,0,0,95,95
"38092",2018,0,18,54,72
"38092",2019,0,135,73,208
"38092",2020,0,186,186,372
"38093",2015,0,0,91,91
"38093",2016,0,22,22,44
"38093",2017,0,95,95,190
"38093",2018,0,18,54,72
"38093",2019,0,93,140,233
"38093",2020,0,96,233,329
"38094",2015,0,1,35,36
"38094",2016,0,22,22,44
"38094",2017,0,95,95,190
"38094",2018,0,18,54,72
"38094",2019,0,73,140,213
"38094",2020,0,60,167,227
"38095",2015,0,0,91,91
"38095",2016,0,0,22,22
"38095",2017,0,0,95,95
"38095",2018,0,18,54,72
"38095",2019,0,93,140,233
"38095",2020,0,96,233,329
"38097",2015,0,1,91,92
"38097",2016,0,0,22,22
"38097",2017,0,95,95,190
"38097",2018,0,18,36,54
"38097",2019,0,93,140,233
"38097",2020,0,126,233,359
"38098",2015,0,0,91,91
"38098",2016,0,0,22,22
"38098",2017,0,0,95,95
"38098",2018,0,18,54,72
"38098",2019,0,93,140,233
"38098",2020,0,126,233,359
"38099",2015,0,0,91,91
"38099",2016,0,0,22,22
"38099",2017,0,0,95,95
"38099",2018,0,18,54,72
"38099",2019,0,93,140,233
"38099",2020,0,96,120,216
"38100",2015,0,0,91,91
"38100",2016,0,0,22,22
"38100",2017,0,0,95,95
"38100",2018,0,18,54,72
"38100",2019,0,134,160,294
"38100",2020,0,186,186,372
"38101",2015,0,1,35,36
"38101",2016,0,22,22,44
"38101",2017,0,95,95,190
"38101",2018,0,18,54,72
"38101",2019,0,73,140,213
"38101",2020,0,60,167,227
"38102",2015,0,0,91,91
"38102",2016,0,0,22,22
"38102",2017,0,0,95,95
"38102",2018,0,18,54,72
"38102",2019,0,93,140,233
"38102",2020,0,126,233,359
"38103",2015,0,0,91,91
"38103",2016,0,0,22,22
"38103",2017,0,0,95,95
"38103",2018,0,18,54,72
"38103",2019,0,47,135,182
"38103",2020,0,186,186,372
"38104",2015,0,1,91,92
"38104",2016,0,22,22,44
"38104",2017,0,95,95,190
"38104",2018,0,18,54,72
"38104",2019,0,93,140,233
"38104",2020,0,96,203,299
"38105",2015,0,1,91,92
"38105",2016,0,22,22,44
"38105",2017,0,95,95,190
"38105",2018,0,18,54,72
"38105",2019,0,166,140,306
"38105",2020,0,156,203,359
"38106",2015,0,0,91,91
"38106",2016,0,0,22,22
"38106",2017,0,0,95,95
"38106",2018,0,18,54,72
"38106",2019,0,47,135,182
"38106",2020,0,186,186,372
"38107",2015,0,1,35,36
"38107",2016,0,22,22,44
"38107",2017,0,95,95,190
"38107",2018,0,46,54,100
"38107",2019,0,73,140,213
"38107",2020,0,60,167,227
"38108",2015,0,0,91,91
"38108",2016,0,0,22,22
"38108",2017,0,0,95,95
"38108",2018,0,18,54,72
"38108",2019,0,135,73,208
"38108",2020,0,186,186,372
"38109",2015,0,0,91,91
"38109",2016,0,0,22,22
"38109",2017,0,0,95,95
"38109",2018,0,18,54,72
"38109",2019,0,93,140,233
"38109",2020,0,126,233,359
"38110",2015,0,1,35,36
"38110",2016,0,22,22,44
"38110",2017,0,95,95,190
"38110",2018,0,46,54,100
"38110",2019,0,73,140,213
"38110",2020,0,60,167,227
"38111",2015,0,0,91,91
"38111",2016,0,0,22,22
"38111",2017,0,0,95,95
"38111",2018,0,18,54,72
"38111",2019,0,135,73,208
"38111",2020,0,186,186,372
"38112",2015,0,0,91,91
"38112",2016,0,0,22,22
"38112",2017,0,0,95,95
"38112",2018,0,18,54,72
"38112",2019,0,47,135,182
"38112",2020,0,186,186,372
"38113",2015,0,0,91,91
"38113",2016,0,0,22,22
"38113",2017,0,0,95,95
"38113",2018,0,18,54,72
"38113",2019,0,47,135,182
"38113",2020,0,186,186,372
"38114",2015,0,1,35,36
"38114",2016,0,22,22,44
"38114",2017,0,95,95,190
"38114",2018,0,18,54,72
"38114",2019,0,73,140,213
"38114",2020,0,60,167,227
"38115",2015,0,0,91,91
"38115",2016,0,0,22,22
"38115",2017,0,0,95,95
"38115",2018,0,18,54,72
"38115",2019,0,47,135,182
"38115",2020,0,186,186,372
"38116",2015,0,0,91,91
"38116",2016,0,0,22,22
"38116",2017,0,0,95,95
"38116",2018,0,18,54,72
"38116",2019,0,47,135,182
"38116",2020,0,186,186,372
"38117",2015,0,0,91,91
"38117",2016,0,0,22,22
"38117",2017,0,0,95,95
"38117",2018,0,18,54,72
"38117",2019,0,93,140,233
"38117",2020,0,96,233,329
"38118",2015,0,0,91,91
"38118",2016,0,22,22,44
"38118",2017,0,95,95,190
"38118",2018,0,18,54,72
"38118",2019,0,93,140,233
"38118",2020,0,96,233,329
"38120",2015,0,0,91,91
"38120",2016,0,0,22,22
"38120",2017,0,0,95,95
"38120",2018,0,18,54,72
"38120",2019,0,109,135,244
"38120",2020,0,186,186,372
"38124",2015,0,0,91,91
"38124",2016,0,0,22,22
"38124",2017,0,0,95,95
"38124",2018,0,18,54,72
"38124",2019,0,166,166,332
"38124",2020,0,186,233,419
"38126",2015,0,0,91,91
"38126",2016,0,0,22,22
"38126",2017,0,0,95,95
"38126",2018,0,18,54,72
"38126",2019,0,93,140,233
"38126",2020,0,96,233,329
"38127",2015,0,0,91,91
"38127",2016,0,0,22,22
"38127",2017,0,0,95,95
"38127",2018,0,18,54,72
"38127",2019,0,47,135,182
"38127",2020,0,186,186,372
"38128",2015,0,0,91,91
"38128",2016,0,0,22,22
"38128",2017,0,0,95,95
"38128",2018,0,18,54,72
"38128",2019,0,47,135,182
"38128",2020,0,186,186,372
"38129",2015,0,0,91,91
"38129",2016,0,0,22,22
"38129",2017,0,0,95,95
"38129",2018,0,18,54,72
"38129",2019,0,135,73,208
"38129",2020,0,186,186,372
"38130",2015,0,0,91,91
"38130",2016,0,22,22,44
"38130",2017,0,95,95,190
"38130",2018,0,18,54,72
"38130",2019,0,93,140,233
"38130",2020,0,96,233,329
"38131",2015,0,1,35,36
"38131",2016,0,22,22,44
"38131",2017,0,95,95,190
"38131",2018,0,18,54,72
"38131",2019,0,73,140,213
"38131",2020,0,60,167,227
"38132",2015,0,0,91,91
"38132",2016,0,0,22,22
"38132",2017,0,0,95,95
"38132",2018,0,18,54,72
"38132",2019,0,47,135,182
"38132",2020,0,186,186,372
"38133",2015,0,1,91,92
"38133",2016,0,22,22,44
"38133",2017,0,95,95,190
"38133",2018,0,18,54,72
"38133",2019,0,166,140,306
"38133",2020,0,156,203,359
"38134",2015,0,1,35,36
"38134",2016,0,22,22,44
"38134",2017,0,95,95,190
"38134",2018,0,18,54,72
"38134",2019,0,73,140,213
"38134",2020,0,60,167,227
"38135",2015,0,0,91,91
"38135",2016,0,0,22,22
"38135",2017,0,0,95,95
"38135",2018,0,18,54,72
"38135",2019,0,93,140,233
"38135",2020,0,126,233,359
"38136",2015,0,1,35,36
"38136",2016,0,22,22,44
"38136",2017,0,95,95,190
"38136",2018,0,46,54,100
"38136",2019,0,73,140,213
"38136",2020,0,60,167,227
"38137",2015,0,0,91,91
"38137",2016,0,22,22,44
"38137",2017,0,95,95,190
"38137",2018,0,18,54,72
"38137",2019,0,93,140,233
"38137",2020,0,96,233,329
"38138",2015,0,0,91,91
"38138",2016,0,0,22,22
"38138",2017,0,0,95,95
"38138",2018,0,18,54,72
"38138",2019,0,166,166,332
"38138",2020,0,186,233,419
"38139",2015,0,0,91,91
"38139",2016,0,0,22,22
"38139",2017,0,0,95,95
"38139",2018,0,18,54,72
"38139",2019,0,166,166,332
"38139",2020,0,186,233,419
"38140",2015,0,0,91,91
"38140",2016,0,0,22,22
"38140",2017,0,0,95,95
"38140",2018,0,18,54,72
"38140",2019,0,134,160,294
"38140",2020,0,186,186,372
"38141",2015,0,1,35,36
"38141",2016,0,22,22,44
"38141",2017,0,95,95,190
"38141",2018,0,46,54,100
"38141",2019,0,73,140,213
"38141",2020,0,60,167,227
"38144",2015,0,1,35,36
"38144",2016,0,22,22,44
"38144",2017,0,95,95,190
"38144",2018,0,100,36,136
"38144",2019,0,0,140,140
"38144",2020,0,0,120,120
"38146",2015,0,0,91,91
"38146",2016,0,0,22,22
"38146",2017,0,0,95,95
"38146",2018,0,18,54,72
"38146",2019,0,93,140,233
"38146",2020,0,126,233,359
"38147",2015,0,0,91,91
"38147",2016,0,0,22,22
"38147",2017,0,0,95,95
"38147",2018,0,18,54,72
"38147",2019,0,93,140,233
"38147",2020,0,126,233,359
"38148",2015,0,0,91,91
"38148",2016,0,0,22,22
"38148",2017,0,0,95,95
"38148",2018,0,18,54,72
"38148",2019,0,93,140,233
"38148",2020,0,126,233,359
"38149",2015,0,0,91,91
"38149",2016,0,0,22,22
"38149",2017,0,0,95,95
"38149",2018,0,18,54,72
"38149",2019,0,93,140,233
"38149",2020,0,126,233,359
"38150",2015,0,0,91,91
"38150",2016,0,0,22,22
"38150",2017,0,0,95,95
"38150",2018,0,18,54,72
"38150",2019,0,134,160,294
"38150",2020,0,186,186,372
"38151",2015,0,0,91,91
"38151",2016,0,0,22,22
"38151",2017,0,0,95,95
"38151",2018,0,18,54,72
"38151",2019,0,109,135,244
"38151",2020,0,186,186,372
"38152",2015,0,1,35,36
"38152",2016,0,22,22,44
"38152",2017,0,95,95,190
"38152",2018,0,18,54,72
"38152",2019,0,73,140,213
"38152",2020,0,60,167,227
"38153",2015,0,0,91,91
"38153",2016,0,0,22,22
"38153",2017,0,0,95,95
"38153",2018,0,18,54,72
"38153",2019,0,93,140,233
"38153",2020,0,96,233,329
"38154",2015,0,0,91,91
"38154",2016,0,0,22,22
"38154",2017,0,0,95,95
"38154",2018,0,18,54,72
"38154",2019,0,47,135,182
"38154",2020,0,186,186,372
"38155",2015,0,1,91,92
"38155",2016,0,22,22,44
"38155",2017,0,95,95,190
"38155",2018,0,18,54,72
"38155",2019,0,166,140,306
"38155",2020,0,156,156,312
"38156",2015,0,1,35,36
"38156",2016,0,22,22,44
"38156",2017,0,95,95,190
"38156",2018,0,46,54,100
"38156",2019,0,73,140,213
"38156",2020,0,60,167,227
"38157",2015,0,1,35,36
"38157",2016,0,22,22,44
"38157",2017,0,95,95,190
"38157",2018,0,46,54,100
"38157",2019,0,73,140,213
"38157",2020,0,60,167,227
"38158",2015,0,0,91,91
"38158",2016,0,0,22,22
"38158",2017,0,0,95,95
"38158",2018,0,18,54,72
"38158",2019,0,109,135,244
"38158",2020,0,186,186,372
"38159",2015,0,0,91,91
"38159",2016,0,22,22,44
"38159",2017,0,95,95,190
"38159",2018,0,18,54,72
"38159",2019,0,93,140,233
"38159",2020,0,96,233,329
"38160",2015,0,1,35,36
"38160",2016,0,22,22,44
"38160",2017,0,95,95,190
"38160",2018,0,18,54,72
"38160",2019,0,73,140,213
"38160",2020,0,60,167,227
"38161",2015,0,0,91,91
"38161",2016,0,22,22,44
"38161",2017,0,95,95,190
"38161",2018,0,18,54,72
"38161",2019,0,93,140,233
"38161",2020,0,96,233,329
"38162",2015,0,0,91,91
"38162",2016,0,0,22,22
"38162",2017,0,0,95,95
"38162",2018,0,18,54,72
"38162",2019,0,93,140,233
"38162",2020,0,126,233,359
"38163",2015,0,0,91,91
"38163",2016,0,0,22,22
"38163",2017,0,0,95,95
"38163",2018,0,18,54,72
"38163",2019,0,109,135,244
"38163",2020,0,186,186,372
"38166",2015,0,0,91,91
"38166",2016,0,0,22,22
"38166",2017,0,0,95,95
"38166",2018,0,18,54,72
"38166",2019,0,134,160,294
"38166",2020,0,186,186,372
"38167",2015,0,0,91,91
"38167",2016,0,22,22,44
"38167",2017,0,95,95,190
"38167",2018,0,18,54,72
"38167",2019,0,93,140,233
"38167",2020,0,96,233,329
"38169",2015,0,0,91,91
"38169",2016,0,0,22,22
"38169",2017,0,0,95,95
"38169",2018,0,18,54,72
"38169",2019,0,93,140,233
"38169",2020,0,96,233,329
"38170",2015,0,0,91,91
"38170",2016,0,0,22,22
"38170",2017,0,0,95,95
"38170",2018,0,18,54,72
"38170",2019,0,93,140,233
"38170",2020,0,96,233,329
"38171",2015,0,0,91,91
"38171",2016,0,22,22,44
"38171",2017,0,95,95,190
"38171",2018,0,18,54,72
"38171",2019,0,93,140,233
"38171",2020,0,96,233,329
"38172",2015,0,1,35,36
"38172",2016,0,22,22,44
"38172",2017,0,95,95,190
"38172",2018,0,46,54,100
"38172",2019,0,73,140,213
"38172",2020,0,60,167,227
"38173",2015,0,0,91,91
"38173",2016,0,0,22,22
"38173",2017,0,0,95,95
"38173",2018,0,18,54,72
"38173",2019,0,47,135,182
"38173",2020,0,186,186,372
"38174",2015,0,0,91,91
"38174",2016,0,22,22,44
"38174",2017,0,95,95,190
"38174",2018,0,18,54,72
"38174",2019,0,93,140,233
"38174",2020,0,96,233,329
"38175",2015,0,0,91,91
"38175",2016,0,0,22,22
"38175",2017,0,0,95,95
"38175",2018,0,18,54,72
"38175",2019,0,134,160,294
"38175",2020,0,186,186,372
"38176",2015,0,0,91,91
"38176",2016,0,0,22,22
"38176",2017,0,0,95,95
"38176",2018,0,18,54,72
"38176",2019,0,93,140,233
"38176",2020,0,126,233,359
"38177",2015,0,0,91,91
"38177",2016,0,0,22,22
"38177",2017,0,0,95,95
"38177",2018,0,18,54,72
"38177",2019,0,47,135,182
"38177",2020,0,186,186,372
"38179",2015,0,0,91,91
"38179",2016,0,0,22,22
"38179",2017,0,0,95,95
"38179",2018,0,18,54,72
"38179",2019,0,134,160,294
"38179",2020,0,186,186,372
"38180",2015,0,0,91,91
"38180",2016,0,22,22,44
"38180",2017,0,95,95,190
"38180",2018,0,18,54,72
"38180",2019,0,93,140,233
"38180",2020,0,96,233,329
"38181",2015,0,0,91,91
"38181",2016,0,0,22,22
"38181",2017,0,0,95,95
"38181",2018,0,18,54,72
"38181",2019,0,134,160,294
"38181",2020,0,186,186,372
"38182",2015,0,0,91,91
"38182",2016,0,22,22,44
"38182",2017,0,95,95,190
"38182",2018,0,18,54,72
"38182",2019,0,93,140,233
"38182",2020,0,96,233,329
"38183",2015,0,1,91,92
"38183",2016,0,22,22,44
"38183",2017,0,95,95,190
"38183",2018,0,18,54,72
"38183",2019,0,166,140,306
"38183",2020,0,156,203,359
"38184",2015,0,1,91,92
"38184",2016,0,0,22,22
"38184",2017,0,89,95,184
"38184",2018,0,100,36,136
"38184",2019,0,0,140,140
"38184",2020,0,0,186,186
"38185",2015,0,0,91,91
"38185",2016,0,0,22,22
"38185",2017,0,0,95,95
"38185",2018,0,18,54,72
"38185",2019,0,93,140,233
"38185",2020,0,96,233,329
"38186",2015,0,0,91,91
"38186",2016,0,0,22,22
"38186",2017,0,0,95,95
"38186",2018,0,18,54,72
"38186",2019,0,47,135,182
"38186",2020,0,186,186,372
"38187",2015,0,0,91,91
"38187",2016,0,0,22,22
"38187",2017,0,0,95,95
"38187",2018,0,18,54,72
"38187",2019,0,135,73,208
"38187",2020,0,186,186,372
"38188",2015,0,0,91,91
"38188",2016,0,0,22,22
"38188",2017,0,0,95,95
"38188",2018,0,18,54,72
"38188",2019,0,109,135,244
"38188",2020,0,186,186,372
"38189",2015,0,1,35,36
"38189",2016,0,22,22,44
"38189",2017,0,95,95,190
"38189",2018,0,100,36,136
"38189",2019,0,0,140,140
"38189",2020,0,0,186,186
"38190",2015,0,0,91,91
"38190",2016,0,0,22,22
"38190",2017,0,0,95,95
"38190",2018,0,18,54,72
"38190",2019,0,166,166,332
"38190",2020,0,186,233,419
"38191",2015,0,0,91,91
"38191",2016,0,0,22,22
"38191",2017,0,0,95,95
"38191",2018,0,18,54,72
"38191",2019,0,47,135,182
"38191",2020,0,186,186,372
"38192",2015,0,0,91,91
"38192",2016,0,0,22,22
"38192",2017,0,0,95,95
"38192",2018,0,18,54,72
"38192",2019,0,134,160,294
"38192",2020,0,186,186,372
"38193",2015,0,0,91,91
"38193",2016,0,0,22,22
"38193",2017,0,0,95,95
"38193",2018,0,18,54,72
"38193",2019,0,93,140,233
"38193",2020,0,126,233,359
"38194",2015,0,0,91,91
"38194",2016,0,22,22,44
"38194",2017,0,95,95,190
"38194",2018,0,18,54,72
"38194",2019,0,93,140,233
"38194",2020,0,96,233,329
"38195",2015,0,0,91,91
"38195",2016,0,0,22,22
"38195",2017,0,0,95,95
"38195",2018,0,18,54,72
"38195",2019,0,93,140,233
"38195",2020,0,96,233,329
"38197",2015,0,1,91,92
"38197",2016,0,0,22,22
"38197",2017,0,95,95,190
"38197",2018,0,100,36,136
"38197",2019,0,0,140,140
"38197",2020,0,0,186,186
"38198",2015,0,0,91,91
"38198",2016,0,22,22,44
"38198",2017,0,95,95,190
"38198",2018,0,18,54,72
"38198",2019,0,93,140,233
"38198",2020,0,96,233,329
"38199",2015,0,1,35,36
"38199",2016,0,22,22,44
"38199",2017,0,95,95,190
"38199",2018,0,46,54,100
"38199",2019,0,73,140,213
"38199",2020,0,60,167,227
"38200",2015,0,0,91,91
"38200",2016,0,0,22,22
"38200",2017,0,0,95,95
"38200",2018,0,18,54,72
"38200",2019,0,109,135,244
"38200",2020,0,186,186,372
"38203",2015,0,0,91,91
"38203",2016,0,0,22,22
"38203",2017,0,0,95,95
"38203",2018,0,18,54,72
"38203",2019,0,47,135,182
"38203",2020,0,186,186,372
"38204",2015,0,0,91,91
"38204",2016,0,0,22,22
"38204",2017,0,0,95,95
"38204",2018,0,18,54,72
"38204",2019,0,47,135,182
"38204",2020,0,186,186,372
"38205",2015,0,0,91,91
"38205",2016,0,0,22,22
"38205",2017,0,0,95,95
"38205",2018,0,18,54,72
"38205",2019,0,135,73,208
"38205",2020,0,186,186,372
"38206",2015,0,0,91,91
"38206",2016,0,0,22,22
"38206",2017,0,0,95,95
"38206",2018,0,18,54,72
"38206",2019,0,109,135,244
"38206",2020,0,186,186,372
"38207",2015,0,0,91,91
"38207",2016,0,0,22,22
"38207",2017,0,0,95,95
"38207",2018,0,18,54,72
"38207",2019,0,47,135,182
"38207",2020,0,186,186,372
"38208",2015,0,0,91,91
"38208",2016,0,0,22,22
"38208",2017,0,0,95,95
"38208",2018,0,18,54,72
"38208",2019,0,47,135,182
"38208",2020,0,186,186,372
"38209",2015,0,0,91,91
"38209",2016,0,22,22,44
"38209",2017,0,95,95,190
"38209",2018,0,18,54,72
"38209",2019,0,93,140,233
"38209",2020,0,96,233,329
"38210",2015,0,0,91,91
"38210",2016,0,0,22,22
"38210",2017,0,0,95,95
"38210",2018,0,18,54,72
"38210",2019,0,166,166,332
"38210",2020,0,186,233,419
"38211",2015,0,1,35,36
"38211",2016,0,22,22,44
"38211",2017,0,95,95,190
"38211",2018,0,18,54,72
"38211",2019,0,73,140,213
"38211",2020,0,60,167,227
"38212",2015,0,0,91,91
"38212",2016,0,0,22,22
"38212",2017,0,0,95,95
"38212",2018,0,18,54,72
"38212",2019,0,109,135,244
"38212",2020,0,186,186,372
"38213",2015,0,0,91,91
"38213",2016,0,22,22,44
"38213",2017,0,95,95,190
"38213",2018,0,18,54,72
"38213",2019,0,93,140,233
"38213",2020,0,96,233,329
"38214",2015,0,0,91,91
"38214",2016,0,0,22,22
"38214",2017,0,0,95,95
"38214",2018,0,18,54,72
"38214",2019,0,134,160,294
"38214",2020,0,186,186,372
"38215",2015,0,1,35,36
"38215",2016,0,22,22,44
"38215",2017,0,95,95,190
"38215",2018,0,100,36,136
"38215",2019,0,0,140,140
"38215",2020,0,0,120,120
"38216",2015,0,0,91,91
"38216",2016,0,0,22,22
"38216",2017,0,0,95,95
"38216",2018,0,18,54,72
"38216",2019,0,93,140,233
"38216",2020,0,96,233,329
"38217",2015,0,0,91,91
"38217",2016,0,0,22,22
"38217",2017,0,0,95,95
"38217",2018,0,18,54,72
"38217",2019,0,47,135,182
"38217",2020,0,186,186,372
"38218",2015,0,0,91,91
"38218",2016,0,22,22,44
"38218",2017,0,95,95,190
"38218",2018,0,18,54,72
"38218",2019,0,93,140,233
"38218",2020,0,96,233,329
"38219",2015,0,0,91,91
"38219",2016,0,22,22,44
"38219",2017,0,95,95,190
"38219",2018,0,18,54,72
"38219",2019,0,93,140,233
"38219",2020,0,96,233,329
"38221",2015,0,0,91,91
"38221",2016,0,22,22,44
"38221",2017,0,95,95,190
"38221",2018,0,18,54,72
"38221",2019,0,93,140,233
"38221",2020,0,96,233,329
"38222",2015,0,1,91,92
"38222",2016,0,22,22,44
"38222",2017,0,95,95,190
"38222",2018,0,18,54,72
"38222",2019,0,166,140,306
"38222",2020,0,156,203,359
"38223",2015,0,0,91,91
"38223",2016,0,0,22,22
"38223",2017,0,0,95,95
"38223",2018,0,18,54,72
"38223",2019,0,93,140,233
"38223",2020,0,126,233,359
"38224",2015,0,0,91,91
"38224",2016,0,0,22,22
"38224",2017,0,0,95,95
"38224",2018,0,18,54,72
"38224",2019,0,47,135,182
"38224",2020,0,186,186,372
"38225",2015,0,0,91,91
"38225",2016,0,0,22,22
"38225",2017,0,0,95,95
"38225",2018,0,18,54,72
"38225",2019,0,93,140,233
"38225",2020,0,96,233,329
"38226",2015,0,0,91,91
"38226",2016,0,0,22,22
"38226",2017,0,0,95,95
"38226",2018,0,18,54,72
"38226",2019,0,47,135,182
"38226",2020,0,186,186,372
"38228",2015,0,1,91,92
"38228",2016,0,22,22,44
"38228",2017,0,95,95,190
"38228",2018,0,18,54,72
"38228",2019,0,166,140,306
"38228",2020,0,156,203,359
"38229",2015,0,0,91,91
"38229",2016,0,0,22,22
"38229",2017,0,0,95,95
"38229",2018,0,18,54,72
"38229",2019,0,93,140,233
"38229",2020,0,96,233,329
"38230",2015,0,0,91,91
"38230",2016,0,0,22,22
"38230",2017,0,0,95,95
"38230",2018,0,18,54,72
"38230",2019,0,93,140,233
"38230",2020,0,126,233,359
"38231",2015,0,1,35,36
"38231",2016,0,22,22,44
"38231",2017,0,95,95,190
"38231",2018,0,46,54,100
"38231",2019,0,73,140,213
"38231",2020,0,60,167,227
"38232",2015,0,1,35,36
"38232",2016,0,22,22,44
"38232",2017,0,95,95,190
"38232",2018,0,18,54,72
"38232",2019,0,73,140,213
"38232",2020,0,60,167,227
"38235",2015,0,0,91,91
"38235",2016,0,0,22,22
"38235",2017,0,0,95,95
"38235",2018,0,18,54,72
"38235",2019,0,47,135,182
"38235",2020,0,186,186,372
"38236",2015,0,1,91,92
"38236",2016,0,22,22,44
"38236",2017,0,95,95,190
"38236",2018,0,18,54,72
"38236",2019,0,166,140,306
"38236",2020,0,156,203,359
"38237",2015,0,0,91,91
"38237",2016,0,0,22,22
"38237",2017,0,0,95,95
"38237",2018,0,18,54,72
"38237",2019,0,47,135,182
"38237",2020,0,186,186,372
"38238",2015,0,1,35,36
"38238",2016,0,22,22,44
"38238",2017,0,95,95,190
"38238",2018,0,46,54,100
"38238",2019,0,73,140,213
"38238",2020,0,60,167,227
"38239",2015,0,0,91,91
"38239",2016,0,0,22,22
"38239",2017,0,0,95,95
"38239",2018,0,18,54,72
"38239",2019,0,93,140,233
"38239",2020,0,96,233,329
"38240",2015,0,0,91,91
"38240",2016,0,22,22,44
"38240",2017,0,95,95,190
"38240",2018,0,18,54,72
"38240",2019,0,93,140,233
"38240",2020,0,96,233,329
"38241",2015,0,0,91,91
"38241",2016,0,0,22,22
"38241",2017,0,0,95,95
"38241",2018,0,18,54,72
"38241",2019,0,47,135,182
"38241",2020,0,186,186,372
"38242",2015,0,0,91,91
"38242",2016,0,0,22,22
"38242",2017,0,0,95,95
"38242",2018,0,18,54,72
"38242",2019,0,47,135,182
"38242",2020,0,186,186,372
"38243",2015,0,0,91,91
"38243",2016,0,0,22,22
"38243",2017,0,0,95,95
"38243",2018,0,18,54,72
"38243",2019,0,47,135,182
"38243",2020,0,186,186,372
"38244",2015,0,0,91,91
"38244",2016,0,22,22,44
"38244",2017,0,95,95,190
"38244",2018,0,18,54,72
"38244",2019,0,93,140,233
"38244",2020,0,96,233,329
"38245",2015,0,0,91,91
"38245",2016,0,0,22,22
"38245",2017,0,0,95,95
"38245",2018,0,18,54,72
"38245",2019,0,93,140,233
"38245",2020,0,96,233,329
"38246",2015,0,0,91,91
"38246",2016,0,0,22,22
"38246",2017,0,0,95,95
"38246",2018,0,18,54,72
"38246",2019,0,93,140,233
"38246",2020,0,126,233,359
"38247",2015,0,0,91,91
"38247",2016,0,0,22,22
"38247",2017,0,0,95,95
"38247",2018,0,18,54,72
"38247",2019,0,166,166,332
"38247",2020,0,186,233,419
"38248",2015,0,0,91,91
"38248",2016,0,0,22,22
"38248",2017,0,0,95,95
"38248",2018,0,18,54,72
"38248",2019,0,93,140,233
"38248",2020,0,96,233,329
"38249",2015,0,0,91,91
"38249",2016,0,0,22,22
"38249",2017,0,0,95,95
"38249",2018,0,18,54,72
"38249",2019,0,134,160,294
"38249",2020,0,186,186,372
"38250",2015,0,0,91,91
"38250",2016,0,0,22,22
"38250",2017,0,0,95,95
"38250",2018,0,18,54,72
"38250",2019,0,93,140,233
"38250",2020,0,126,233,359
"38252",2015,0,0,91,91
"38252",2016,0,0,22,22
"38252",2017,0,0,95,95
"38252",2018,0,18,54,72
"38252",2019,0,109,135,244
"38252",2020,0,186,186,372
"38253",2015,0,0,91,91
"38253",2016,0,0,22,22
"38253",2017,0,0,95,95
"38253",2018,0,18,54,72
"38253",2019,0,47,135,182
"38253",2020,0,186,186,372
"38254",2015,0,0,91,91
"38254",2016,0,0,22,22
"38254",2017,0,0,95,95
"38254",2018,0,18,54,72
"38254",2019,0,47,135,182
"38254",2020,0,186,186,372
"38255",2015,0,0,91,91
"38255",2016,0,22,22,44
"38255",2017,0,95,95,190
"38255",2018,0,18,54,72
"38255",2019,0,93,140,233
"38255",2020,0,96,120,216
"38256",2015,0,1,91,92
"38256",2016,0,22,22,44
"38256",2017,0,95,95,190
"38256",2018,0,18,54,72
"38256",2019,0,93,140,233
"38256",2020,0,96,203,299
"38257",2015,0,0,91,91
"38257",2016,0,22,22,44
"38257",2017,0,95,95,190
"38257",2018,0,18,54,72
"38257",2019,0,93,140,233
"38257",2020,0,96,233,329
"38258",2015,0,1,91,92
"38258",2016,0,22,22,44
"38258",2017,0,95,95,190
"38258",2018,0,18,54,72
"38258",2019,0,93,140,233
"38258",2020,0,96,203,299
"38259",2015,0,1,35,36
"38259",2016,0,22,22,44
"38259",2017,0,95,95,190
"38259",2018,0,18,54,72
"38259",2019,0,73,140,213
"38259",2020,0,60,167,227
"38260",2015,0,0,91,91
"38260",2016,0,0,22,22
"38260",2017,0,0,95,95
"38260",2018,0,18,54,72
"38260",2019,0,93,140,233
"38260",2020,0,126,233,359
"38261",2015,0,0,91,91
"38261",2016,0,0,22,22
"38261",2017,0,0,95,95
"38261",2018,0,18,54,72
"38261",2019,0,166,166,332
"38261",2020,0,186,233,419
"38263",2015,0,0,91,91
"38263",2016,0,22,22,44
"38263",2017,0,95,95,190
"38263",2018,0,18,54,72
"38263",2019,0,93,140,233
"38263",2020,0,96,233,329
"38264",2015,0,0,91,91
"38264",2016,0,0,22,22
"38264",2017,0,0,95,95
"38264",2018,0,18,54,72
"38264",2019,0,47,135,182
"38264",2020,0,186,186,372
"38265",2015,0,0,91,91
"38265",2016,0,0,22,22
"38265",2017,0,0,95,95
"38265",2018,0,18,54,72
"38265",2019,0,47,135,182
"38265",2020,0,186,186,372
"38266",2015,0,0,91,91
"38266",2016,0,0,22,22
"38266",2017,0,0,95,95
"38266",2018,0,18,54,72
"38266",2019,0,47,135,182
"38266",2020,0,186,186,372
"38267",2015,0,0,91,91
"38267",2016,0,22,22,44
"38267",2017,0,95,95,190
"38267",2018,0,18,54,72
"38267",2019,0,93,140,233
"38267",2020,0,96,233,329
"38268",2015,0,0,91,91
"38268",2016,0,0,22,22
"38268",2017,0,0,95,95
"38268",2018,0,18,54,72
"38268",2019,0,134,160,294
"38268",2020,0,186,186,372
"38269",2015,0,0,91,91
"38269",2016,0,0,22,22
"38269",2017,0,0,95,95
"38269",2018,0,18,54,72
"38269",2019,0,47,135,182
"38269",2020,0,186,186,372
"38270",2015,0,1,91,92
"38270",2016,0,22,22,44
"38270",2017,0,95,95,190
"38270",2018,0,18,54,72
"38270",2019,0,166,140,306
"38270",2020,0,156,203,359
"38271",2015,0,0,91,91
"38271",2016,0,0,22,22
"38271",2017,0,0,95,95
"38271",2018,0,18,54,72
"38271",2019,0,134,160,294
"38271",2020,0,186,186,372
"38272",2015,0,0,91,91
"38272",2016,0,0,22,22
"38272",2017,0,0,95,95
"38272",2018,0,18,54,72
"38272",2019,0,93,140,233
"38272",2020,0,96,120,216
"38273",2015,0,0,91,91
"38273",2016,0,0,22,22
"38273",2017,0,0,95,95
"38273",2018,0,18,54,72
"38273",2019,0,47,135,182
"38273",2020,0,186,186,372
"38275",2015,0,0,91,91
"38275",2016,0,22,22,44
"38275",2017,0,95,95,190
"38275",2018,0,18,54,72
"38275",2019,0,93,140,233
"38275",2020,0,96,233,329
"38276",2015,0,0,91,91
"38276",2016,0,0,22,22
"38276",2017,0,0,95,95
"38276",2018,0,18,54,72
"38276",2019,0,93,140,233
"38276",2020,0,126,233,359
"38277",2015,0,0,91,91
"38277",2016,0,0,22,22
"38277",2017,0,0,95,95
"38277",2018,0,18,54,72
"38277",2019,0,47,135,182
"38277",2020,0,186,186,372
"38278",2015,0,0,91,91
"38278",2016,0,0,22,22
"38278",2017,0,0,95,95
"38278",2018,0,18,54,72
"38278",2019,0,93,140,233
"38278",2020,0,96,233,329
"38279",2015,0,0,91,91
"38279",2016,0,0,22,22
"38279",2017,0,0,95,95
"38279",2018,0,18,54,72
"38279",2019,0,47,135,182
"38279",2020,0,186,186,372
"38280",2015,0,0,91,91
"38280",2016,0,0,22,22
"38280",2017,0,0,95,95
"38280",2018,0,18,54,72
"38280",2019,0,47,135,182
"38280",2020,0,186,186,372
"38281",2015,0,0,91,91
"38281",2016,0,0,22,22
"38281",2017,0,0,95,95
"38281",2018,0,18,54,72
"38281",2019,0,93,140,233
"38281",2020,0,96,233,329
"38282",2015,0,0,91,91
"38282",2016,0,0,22,22
"38282",2017,0,0,95,95
"38282",2018,0,18,54,72
"38282",2019,0,166,166,332
"38282",2020,0,186,233,419
"38283",2015,0,0,91,91
"38283",2016,0,0,22,22
"38283",2017,0,0,95,95
"38283",2018,0,18,54,72
"38283",2019,0,47,135,182
"38283",2020,0,186,186,372
"38284",2015,0,0,91,91
"38284",2016,0,22,22,44
"38284",2017,0,95,95,190
"38284",2018,0,18,54,72
"38284",2019,0,93,140,233
"38284",2020,0,96,233,329
"38285",2015,0,0,91,91
"38285",2016,0,0,22,22
"38285",2017,0,0,95,95
"38285",2018,0,18,54,72
"38285",2019,0,47,135,182
"38285",2020,0,186,186,372
"38286",2015,0,0,91,91
"38286",2016,0,0,22,22
"38286",2017,0,0,95,95
"38286",2018,0,18,54,72
"38286",2019,0,47,135,182
"38286",2020,0,186,186,372
"38287",2015,0,0,91,91
"38287",2016,0,22,22,44
"38287",2017,0,95,95,190
"38287",2018,0,18,54,72
"38287",2019,0,93,140,233
"38287",2020,0,96,233,329
"38288",2015,0,1,35,36
"38288",2016,0,22,22,44
"38288",2017,0,95,95,190
"38288",2018,0,100,36,136
"38288",2019,0,0,140,140
"38288",2020,0,0,120,120
"38289",2015,0,0,91,91
"38289",2016,0,0,22,22
"38289",2017,0,0,95,95
"38289",2018,0,18,54,72
"38289",2019,0,47,135,182
"38289",2020,0,186,186,372
"38290",2015,0,0,91,91
"38290",2016,0,22,22,44
"38290",2017,0,95,95,190
"38290",2018,0,18,54,72
"38290",2019,0,93,140,233
"38290",2020,0,96,233,329
"38291",2015,0,0,91,91
"38291",2016,0,22,22,44
"38291",2017,0,95,95,190
"38291",2018,0,18,54,72
"38291",2019,0,93,140,233
"38291",2020,0,96,233,329
"38292",2015,0,0,91,91
"38292",2016,0,22,22,44
"38292",2017,0,95,95,190
"38292",2018,0,18,54,72
"38292",2019,0,93,140,233
"38292",2020,0,96,233,329
"38294",2015,0,0,91,91
"38294",2016,0,0,22,22
"38294",2017,0,0,95,95
"38294",2018,0,18,54,72
"38294",2019,0,93,140,233
"38294",2020,0,126,233,359
"38295",2015,0,0,91,91
"38295",2016,0,0,22,22
"38295",2017,0,0,95,95
"38295",2018,0,18,54,72
"38295",2019,0,166,166,332
"38295",2020,0,186,233,419
"38296",2015,0,0,91,91
"38296",2016,0,0,22,22
"38296",2017,0,0,95,95
"38296",2018,0,18,54,72
"38296",2019,0,93,140,233
"38296",2020,0,126,233,359
"38297",2015,0,0,91,91
"38297",2016,0,0,22,22
"38297",2017,0,0,95,95
"38297",2018,0,18,54,72
"38297",2019,0,93,140,233
"38297",2020,0,126,233,359
"38298",2015,0,0,91,91
"38298",2016,0,22,22,44
"38298",2017,0,95,95,190
"38298",2018,0,18,54,72
"38298",2019,0,93,140,233
"38298",2020,0,96,233,329
"38299",2015,0,0,91,91
"38299",2016,0,0,22,22
"38299",2017,0,0,95,95
"38299",2018,0,18,54,72
"38299",2019,0,47,135,182
"38299",2020,0,186,186,372
"38300",2015,0,0,91,91
"38300",2016,0,22,22,44
"38300",2017,0,95,95,190
"38300",2018,0,18,54,72
"38300",2019,0,93,140,233
"38300",2020,0,96,233,329
"38301",2015,0,0,91,91
"38301",2016,0,0,22,22
"38301",2017,0,0,95,95
"38301",2018,0,18,54,72
"38301",2019,0,47,135,182
"38301",2020,0,186,186,372
"38303",2015,0,0,91,91
"38303",2016,0,0,22,22
"38303",2017,0,0,95,95
"38303",2018,0,18,54,72
"38303",2019,0,134,160,294
"38303",2020,0,186,186,372
"38304",2015,0,0,91,91
"38304",2016,0,0,22,22
"38304",2017,0,0,95,95
"38304",2018,0,18,54,72
"38304",2019,0,47,135,182
"38304",2020,0,186,186,372
"38307",2015,0,0,91,91
"38307",2016,0,22,22,44
"38307",2017,0,95,95,190
"38307",2018,0,18,54,72
"38307",2019,0,93,140,233
"38307",2020,0,96,233,329
"38308",2015,0,0,91,91
"38308",2016,0,22,22,44
"38308",2017,0,95,95,190
"38308",2018,0,18,54,72
"38308",2019,0,93,140,233
"38308",2020,0,96,233,329
"38309",2015,0,0,91,91
"38309",2016,0,0,22,22
"38309",2017,0,0,95,95
"38309",2018,0,18,54,72
"38309",2019,0,134,160,294
"38309",2020,0,186,186,372
"38310",2015,0,0,91,91
"38310",2016,0,0,22,22
"38310",2017,0,0,95,95
"38310",2018,0,18,54,72
"38310",2019,0,93,140,233
"38310",2020,0,96,233,329
"38311",2015,0,0,91,91
"38311",2016,0,22,22,44
"38311",2017,0,95,95,190
"38311",2018,0,18,54,72
"38311",2019,0,93,140,233
"38311",2020,0,96,233,329
"38313",2015,0,0,91,91
"38313",2016,0,0,22,22
"38313",2017,0,0,95,95
"38313",2018,0,18,54,72
"38313",2019,0,47,135,182
"38313",2020,0,186,186,372
"38314",2015,0,0,91,91
"38314",2016,0,0,22,22
"38314",2017,0,0,95,95
"38314",2018,0,18,54,72
"38314",2019,0,134,160,294
"38314",2020,0,186,186,372
"38315",2015,0,1,91,92
"38315",2016,0,22,22,44
"38315",2017,0,95,95,190
"38315",2018,0,18,54,72
"38315",2019,0,166,140,306
"38315",2020,0,156,203,359
"38316",2015,0,1,91,92
"38316",2016,0,0,22,22
"38316",2017,0,95,95,190
"38316",2018,0,100,36,136
"38316",2019,0,0,140,140
"38316",2020,0,0,186,186
"38317",2015,0,0,91,91
"38317",2016,0,0,22,22
"38317",2017,0,0,95,95
"38317",2018,0,18,54,72
"38317",2019,0,47,135,182
"38317",2020,0,186,186,372
"38318",2015,0,1,35,36
"38318",2016,0,22,22,44
"38318",2017,0,95,95,190
"38318",2018,0,46,54,100
"38318",2019,0,73,140,213
"38318",2020,0,60,167,227
"38319",2015,0,0,91,91
"38319",2016,0,0,22,22
"38319",2017,0,0,95,95
"38319",2018,0,18,54,72
"38319",2019,0,135,73,208
"38319",2020,0,186,186,372
"38320",2015,0,0,91,91
"38320",2016,0,0,22,22
"38320",2017,0,0,95,95
"38320",2018,0,18,54,72
"38320",2019,0,166,166,332
"38320",2020,0,186,233,419
"38321",2015,0,0,91,91
"38321",2016,0,0,22,22
"38321",2017,0,0,95,95
"38321",2018,0,18,54,72
"38321",2019,0,47,135,182
"38321",2020,0,186,186,372
"38322",2015,0,0,91,91
"38322",2016,0,0,22,22
"38322",2017,0,0,95,95
"38322",2018,0,18,54,72
"38322",2019,0,93,140,233
"38322",2020,0,96,233,329
"38323",2015,0,1,91,92
"38323",2016,0,22,22,44
"38323",2017,0,95,95,190
"38323",2018,0,18,54,72
"38323",2019,0,93,140,233
"38323",2020,0,96,203,299
"38324",2015,0,0,91,91
"38324",2016,0,22,22,44
"38324",2017,0,95,95,190
"38324",2018,0,18,54,72
"38324",2019,0,93,140,233
"38324",2020,0,96,233,329
"38325",2015,0,1,91,92
"38325",2016,0,22,22,44
"38325",2017,0,95,95,190
"38325",2018,0,18,54,72
"38325",2019,0,93,140,233
"38325",2020,0,96,203,299
"38326",2015,0,0,91,91
"38326",2016,0,0,22,22
"38326",2017,0,0,95,95
"38326",2018,0,18,54,72
"38326",2019,0,47,135,182
"38326",2020,0,186,186,372
"38328",2015,0,0,91,91
"38328",2016,0,0,22,22
"38328",2017,0,0,95,95
"38328",2018,0,18,54,72
"38328",2019,0,93,140,233
"38328",2020,0,96,233,329
"38329",2015,0,0,91,91
"38329",2016,0,0,22,22
"38329",2017,0,0,95,95
"38329",2018,0,18,54,72
"38329",2019,0,47,135,182
"38329",2020,0,186,186,372
"38330",2015,0,0,91,91
"38330",2016,0,22,22,44
"38330",2017,0,95,95,190
"38330",2018,0,18,54,72
"38330",2019,0,93,140,233
"38330",2020,0,96,233,329
"38331",2015,0,0,91,91
"38331",2016,0,0,22,22
"38331",2017,0,0,95,95
"38331",2018,0,18,54,72
"38331",2019,0,228,228,456
"38331",2020,0,186,233,419
"38332",2015,0,0,91,91
"38332",2016,0,22,22,44
"38332",2017,0,95,95,190
"38332",2018,0,18,54,72
"38332",2019,0,93,140,233
"38332",2020,0,96,233,329
"38333",2015,0,0,91,91
"38333",2016,0,0,22,22
"38333",2017,0,0,95,95
"38333",2018,0,18,54,72
"38333",2019,0,93,140,233
"38333",2020,0,96,233,329
"38334",2015,0,0,91,91
"38334",2016,0,0,22,22
"38334",2017,0,0,95,95
"38334",2018,0,18,54,72
"38334",2019,0,109,135,244
"38334",2020,0,186,186,372
"38335",2015,0,0,91,91
"38335",2016,0,22,22,44
"38335",2017,0,95,95,190
"38335",2018,0,18,54,72
"38335",2019,0,93,140,233
"38335",2020,0,96,233,329
"38336",2015,0,1,35,36
"38336",2016,0,22,22,44
"38336",2017,0,95,95,190
"38336",2018,0,46,54,100
"38336",2019,0,73,140,213
"38336",2020,0,60,167,227
"38337",2015,0,0,91,91
"38337",2016,0,22,22,44
"38337",2017,0,95,95,190
"38337",2018,0,18,54,72
"38337",2019,0,93,140,233
"38337",2020,0,96,233,329
"38338",2015,0,0,91,91
"38338",2016,0,0,22,22
"38338",2017,0,0,95,95
"38338",2018,0,18,54,72
"38338",2019,0,93,140,233
"38338",2020,0,96,233,329
"38339",2015,0,1,35,36
"38339",2016,0,22,22,44
"38339",2017,0,95,95,190
"38339",2018,0,46,54,100
"38339",2019,0,73,140,213
"38339",2020,0,60,167,227
"38340",2015,0,1,35,36
"38340",2016,0,22,22,44
"38340",2017,0,95,95,190
"38340",2018,0,46,54,100
"38340",2019,0,73,140,213
"38340",2020,0,60,167,227
"38341",2015,0,0,91,91
"38341",2016,0,0,22,22
"38341",2017,0,0,95,95
"38341",2018,0,18,54,72
"38341",2019,0,93,140,233
"38341",2020,0,126,233,359
"38342",2015,0,0,91,91
"38342",2016,0,0,22,22
"38342",2017,0,0,95,95
"38342",2018,0,18,54,72
"38342",2019,0,47,135,182
"38342",2020,0,186,186,372
"38343",2015,0,1,91,92
"38343",2016,0,22,22,44
"38343",2017,0,95,95,190
"38343",2018,0,18,54,72
"38343",2019,0,166,140,306
"38343",2020,0,156,203,359
"38344",2015,0,0,91,91
"38344",2016,0,22,22,44
"38344",2017,0,95,95,190
"38344",2018,0,18,54,72
"38344",2019,0,93,140,233
"38344",2020,0,96,233,329
"38345",2015,0,0,91,91
"38345",2016,0,0,22,22
"38345",2017,0,0,95,95
"38345",2018,0,18,54,72
"38345",2019,0,93,140,233
"38345",2020,0,96,233,329
"38346",2015,0,1,35,36
"38346",2016,0,22,22,44
"38346",2017,0,95,95,190
"38346",2018,0,46,54,100
"38346",2019,0,73,140,213
"38346",2020,0,60,167,227
"38347",2015,0,0,91,91
"38347",2016,0,22,22,44
"38347",2017,0,95,95,190
"38347",2018,0,18,54,72
"38347",2019,0,93,140,233
"38347",2020,0,96,120,216
"38348",2015,0,0,91,91
"38348",2016,0,0,22,22
"38348",2017,0,0,95,95
"38348",2018,0,18,54,72
"38348",2019,0,93,140,233
"38348",2020,0,126,233,359
"38349",2015,0,0,91,91
"38349",2016,0,22,22,44
"38349",2017,0,95,95,190
"38349",2018,0,18,54,72
"38349",2019,0,93,140,233
"38349",2020,0,96,233,329
"38350",2015,0,0,91,91
"38350",2016,0,0,22,22
"38350",2017,0,0,95,95
"38350",2018,0,18,54,72
"38350",2019,0,109,135,244
"38350",2020,0,186,186,372
"38351",2015,0,1,35,36
"38351",2016,0,22,22,44
"38351",2017,0,95,95,190
"38351",2018,0,46,54,100
"38351",2019,0,73,140,213
"38351",2020,0,60,167,227
"38352",2015,0,0,91,91
"38352",2016,0,0,22,22
"38352",2017,0,0,95,95
"38352",2018,0,18,54,72
"38352",2019,0,93,140,233
"38352",2020,0,126,233,359
"38353",2015,0,1,35,36
"38353",2016,0,22,22,44
"38353",2017,0,95,95,190
"38353",2018,0,18,54,72
"38353",2019,0,73,140,213
"38353",2020,0,60,167,227
"38354",2015,0,1,91,92
"38354",2016,0,22,22,44
"38354",2017,0,95,95,190
"38354",2018,0,18,54,72
"38354",2019,0,166,140,306
"38354",2020,0,156,156,312
"38355",2015,0,0,91,91
"38355",2016,0,0,22,22
"38355",2017,0,0,95,95
"38355",2018,0,18,54,72
"38355",2019,0,135,73,208
"38355",2020,0,186,186,372
"38356",2015,0,0,91,91
"38356",2016,0,0,22,22
"38356",2017,0,0,95,95
"38356",2018,0,18,54,72
"38356",2019,0,93,140,233
"38356",2020,0,96,233,329
"38357",2015,0,0,91,91
"38357",2016,0,0,22,22
"38357",2017,0,0,95,95
"38357",2018,0,18,54,72
"38357",2019,0,93,140,233
"38357",2020,0,126,233,359
"38358",2015,0,1,35,36
"38358",2016,0,22,22,44
"38358",2017,0,95,95,190
"38358",2018,0,46,54,100
"38358",2019,0,73,140,213
"38358",2020,0,60,167,227
"38359",2015,0,0,91,91
"38359",2016,0,0,22,22
"38359",2017,0,0,95,95
"38359",2018,0,18,54,72
"38359",2019,0,93,140,233
"38359",2020,0,96,120,216
"38360",2015,0,0,91,91
"38360",2016,0,0,22,22
"38360",2017,0,0,95,95
"38360",2018,0,18,54,72
"38360",2019,0,93,140,233
"38360",2020,0,96,120,216
"38361",2015,0,0,91,91
"38361",2016,0,0,22,22
"38361",2017,0,0,95,95
"38361",2018,0,18,54,72
"38361",2019,0,47,135,182
"38361",2020,0,186,186,372
"38362",2015,0,1,91,92
"38362",2016,0,22,22,44
"38362",2017,0,95,95,190
"38362",2018,0,18,54,72
"38362",2019,0,166,140,306
"38362",2020,0,156,203,359
"38363",2015,0,0,91,91
"38363",2016,0,22,22,44
"38363",2017,0,95,95,190
"38363",2018,0,18,54,72
"38363",2019,0,93,140,233
"38363",2020,0,96,233,329
"38364",2015,0,0,91,91
"38364",2016,0,0,22,22
"38364",2017,0,0,95,95
"38364",2018,0,18,54,72
"38364",2019,0,47,135,182
"38364",2020,0,186,186,372
"38365",2015,0,0,91,91
"38365",2016,0,0,22,22
"38365",2017,0,0,95,95
"38365",2018,0,18,54,72
"38365",2019,0,166,166,332
"38365",2020,0,186,233,419
"38366",2015,0,0,91,91
"38366",2016,0,0,22,22
"38366",2017,0,0,95,95
"38366",2018,0,18,54,72
"38366",2019,0,47,135,182
"38366",2020,0,186,186,372
"38368",2015,0,0,91,91
"38368",2016,0,0,22,22
"38368",2017,0,0,95,95
"38368",2018,0,18,54,72
"38368",2019,0,228,228,456
"38368",2020,0,186,233,419
"38369",2015,0,0,91,91
"38369",2016,0,0,22,22
"38369",2017,0,0,95,95
"38369",2018,0,18,54,72
"38369",2019,0,93,140,233
"38369",2020,0,126,233,359
"38370",2015,0,0,91,91
"38370",2016,0,0,22,22
"38370",2017,0,0,95,95
"38370",2018,0,18,54,72
"38370",2019,0,93,140,233
"38370",2020,0,96,233,329
"38372",2015,0,1,91,92
"38372",2016,0,22,22,44
"38372",2017,0,95,95,190
"38372",2018,0,18,54,72
"38372",2019,0,166,140,306
"38372",2020,0,156,156,312
"38373",2015,0,0,91,91
"38373",2016,0,0,22,22
"38373",2017,0,0,95,95
"38373",2018,0,18,54,72
"38373",2019,0,228,228,456
"38373",2020,0,186,233,419
"38374",2015,0,0,91,91
"38374",2016,0,0,22,22
"38374",2017,0,0,95,95
"38374",2018,0,18,54,72
"38374",2019,0,93,140,233
"38374",2020,0,126,233,359
"38375",2015,0,0,91,91
"38375",2016,0,0,22,22
"38375",2017,0,0,95,95
"38375",2018,0,18,54,72
"38375",2019,0,47,135,182
"38375",2020,0,186,186,372
"38376",2015,0,1,91,92
"38376",2016,0,22,22,44
"38376",2017,0,95,95,190
"38376",2018,0,18,54,72
"38376",2019,0,166,140,306
"38376",2020,0,156,156,312
"38377",2015,0,0,91,91
"38377",2016,0,0,22,22
"38377",2017,0,0,95,95
"38377",2018,0,18,54,72
"38377",2019,0,93,140,233
"38377",2020,0,126,233,359
"38378",2015,0,1,35,36
"38378",2016,0,22,22,44
"38378",2017,0,95,95,190
"38378",2018,0,18,54,72
"38378",2019,0,73,140,213
"38378",2020,0,60,167,227
"38379",2015,0,0,91,91
"38379",2016,0,22,22,44
"38379",2017,0,95,95,190
"38379",2018,0,18,54,72
"38379",2019,0,93,140,233
"38379",2020,0,96,120,216
"38380",2015,0,0,91,91
"38380",2016,0,22,22,44
"38380",2017,0,95,95,190
"38380",2018,0,18,54,72
"38380",2019,0,93,140,233
"38380",2020,0,96,233,329
"38381",2015,0,0,91,91
"38381",2016,0,0,22,22
"38381",2017,0,0,95,95
"38381",2018,0,18,54,72
"38381",2019,0,93,140,233
"38381",2020,0,126,233,359
"38382",2015,0,0,91,91
"38382",2016,0,0,22,22
"38382",2017,0,0,95,95
"38382",2018,0,18,54,72
"38382",2019,0,93,140,233
"38382",2020,0,96,233,329
"38383",2015,0,1,91,92
"38383",2016,0,22,22,44
"38383",2017,0,95,95,190
"38383",2018,0,18,54,72
"38383",2019,0,166,140,306
"38383",2020,0,156,203,359
"38384",2015,0,0,91,91
"38384",2016,0,22,22,44
"38384",2017,0,95,95,190
"38384",2018,0,18,54,72
"38384",2019,0,93,140,233
"38384",2020,0,96,233,329
"38386",2015,0,1,91,92
"38386",2016,0,22,22,44
"38386",2017,0,95,95,190
"38386",2018,0,18,54,72
"38386",2019,0,166,140,306
"38386",2020,0,156,156,312
"38387",2015,0,0,91,91
"38387",2016,0,22,22,44
"38387",2017,0,95,95,190
"38387",2018,0,18,54,72
"38387",2019,0,93,140,233
"38387",2020,0,96,233,329
"38388",2015,0,0,91,91
"38388",2016,0,0,22,22
"38388",2017,0,0,95,95
"38388",2018,0,18,54,72
"38388",2019,0,47,135,182
"38388",2020,0,186,186,372
"38389",2015,0,1,35,36
"38389",2016,0,22,22,44
"38389",2017,0,95,95,190
"38389",2018,0,100,36,136
"38389",2019,0,0,140,140
"38389",2020,0,0,120,120
"38390",2015,0,0,91,91
"38390",2016,0,0,22,22
"38390",2017,0,0,95,95
"38390",2018,0,18,54,72
"38390",2019,0,93,140,233
"38390",2020,0,96,233,329
"38391",2015,0,0,91,91
"38391",2016,0,0,22,22
"38391",2017,0,0,95,95
"38391",2018,0,18,54,72
"38391",2019,0,47,135,182
"38391",2020,0,186,186,372
"38392",2015,0,0,91,91
"38392",2016,0,0,22,22
"38392",2017,0,0,95,95
"38392",2018,0,18,54,72
"38392",2019,0,93,140,233
"38392",2020,0,126,233,359
"38393",2015,0,0,91,91
"38393",2016,0,22,22,44
"38393",2017,0,95,95,190
"38393",2018,0,18,54,72
"38393",2019,0,93,140,233
"38393",2020,0,96,233,329
"38394",2015,0,0,91,91
"38394",2016,0,0,22,22
"38394",2017,0,0,95,95
"38394",2018,0,18,54,72
"38394",2019,0,93,140,233
"38394",2020,0,96,233,329
"38395",2015,0,1,91,92
"38395",2016,0,22,22,44
"38395",2017,0,95,95,190
"38395",2018,0,18,54,72
"38395",2019,0,166,140,306
"38395",2020,0,156,156,312
"38396",2015,0,0,91,91
"38396",2016,0,0,22,22
"38396",2017,0,0,95,95
"38396",2018,0,18,54,72
"38396",2019,0,47,135,182
"38396",2020,0,186,186,372
"38397",2015,0,1,91,92
"38397",2016,0,22,22,44
"38397",2017,0,95,95,190
"38397",2018,0,18,54,72
"38397",2019,0,93,140,233
"38397",2020,0,96,203,299
"38398",2015,0,1,91,92
"38398",2016,0,22,22,44
"38398",2017,0,95,95,190
"38398",2018,0,18,54,72
"38398",2019,0,166,140,306
"38398",2020,0,156,203,359
"38399",2015,0,1,35,36
"38399",2016,0,22,22,44
"38399",2017,0,95,95,190
"38399",2018,0,46,54,100
"38399",2019,0,73,140,213
"38399",2020,0,60,167,227
"38400",2015,0,0,91,91
"38400",2016,0,0,22,22
"38400",2017,0,0,95,95
"38400",2018,0,18,54,72
"38400",2019,0,93,140,233
"38400",2020,0,96,233,329
"38401",2015,0,0,91,91
"38401",2016,0,0,22,22
"38401",2017,0,0,95,95
"38401",2018,0,18,54,72
"38401",2019,0,93,140,233
"38401",2020,0,126,233,359
"38402",2015,0,0,91,91
"38402",2016,0,0,22,22
"38402",2017,0,0,95,95
"38402",2018,0,18,54,72
"38402",2019,0,47,135,182
"38402",2020,0,186,186,372
"38403",2015,0,0,91,91
"38403",2016,0,0,22,22
"38403",2017,0,0,95,95
"38403",2018,0,18,54,72
"38403",2019,0,47,135,182
"38403",2020,0,186,186,372
"38404",2015,0,0,91,91
"38404",2016,0,0,22,22
"38404",2017,0,0,95,95
"38404",2018,0,18,54,72
"38404",2019,0,134,160,294
"38404",2020,0,186,186,372
"38405",2015,0,1,91,92
"38405",2016,0,22,22,44
"38405",2017,0,95,95,190
"38405",2018,0,18,54,72
"38405",2019,0,166,140,306
"38405",2020,0,156,203,359
"38406",2015,0,1,35,36
"38406",2016,0,22,22,44
"38406",2017,0,95,95,190
"38406",2018,0,18,54,72
"38406",2019,0,73,140,213
"38406",2020,0,60,167,227
"38407",2015,0,1,91,92
"38407",2016,0,22,22,44
"38407",2017,0,95,95,190
"38407",2018,0,18,54,72
"38407",2019,0,93,140,233
"38407",2020,0,96,203,299
"38408",2015,0,1,35,36
"38408",2016,0,22,22,44
"38408",2017,0,95,95,190
"38408",2018,0,100,36,136
"38408",2019,0,0,140,140
"38408",2020,0,0,120,120
"38409",2015,0,0,91,91
"38409",2016,0,0,22,22
"38409",2017,0,0,95,95
"38409",2018,0,18,54,72
"38409",2019,0,93,140,233
"38409",2020,0,96,233,329
"38410",2015,0,0,91,91
"38410",2016,0,0,22,22
"38410",2017,0,0,95,95
"38410",2018,0,18,54,72
"38410",2019,0,93,140,233
"38410",2020,0,96,233,329
"38412",2015,0,1,91,92
"38412",2016,0,22,22,44
"38412",2017,0,95,95,190
"38412",2018,0,18,54,72
"38412",2019,0,166,140,306
"38412",2020,0,156,156,312
"38413",2015,0,0,91,91
"38413",2016,0,0,22,22
"38413",2017,0,0,95,95
"38413",2018,0,18,54,72
"38413",2019,0,47,135,182
"38413",2020,0,186,186,372
"38414",2015,0,0,91,91
"38414",2016,0,0,22,22
"38414",2017,0,0,95,95
"38414",2018,0,18,54,72
"38414",2019,0,47,135,182
"38414",2020,0,186,186,372
"38415",2015,0,0,91,91
"38415",2016,0,0,22,22
"38415",2017,0,0,95,95
"38415",2018,0,18,54,72
"38415",2019,0,93,140,233
"38415",2020,0,126,233,359
"38416",2015,0,0,91,91
"38416",2016,0,0,22,22
"38416",2017,0,0,95,95
"38416",2018,0,18,54,72
"38416",2019,0,93,140,233
"38416",2020,0,96,233,329
"38417",2015,0,0,91,91
"38417",2016,0,0,22,22
"38417",2017,0,0,95,95
"38417",2018,0,18,54,72
"38417",2019,0,134,160,294
"38417",2020,0,186,186,372
"38418",2015,0,0,91,91
"38418",2016,0,22,22,44
"38418",2017,0,95,95,190
"38418",2018,0,18,54,72
"38418",2019,0,166,140,306
"38418",2020,0,156,156,312
"38419",2015,0,0,91,91
"38419",2016,0,0,22,22
"38419",2017,0,0,95,95
"38419",2018,0,18,54,72
"38419",2019,0,47,135,182
"38419",2020,0,186,186,372
"38420",2015,0,1,91,92
"38420",2016,0,22,22,44
"38420",2017,0,95,95,190
"38420",2018,0,18,54,72
"38420",2019,0,166,140,306
"38420",2020,0,156,156,312
"38421",2015,0,0,91,91
"38421",2016,0,0,22,22
"38421",2017,0,0,95,95
"38421",2018,0,18,54,72
"38421",2019,0,109,135,244
"38421",2020,0,186,186,372
"38422",2015,0,0,91,91
"38422",2016,0,0,22,22
"38422",2017,0,0,95,95
"38422",2018,0,18,54,72
"38422",2019,0,109,135,244
"38422",2020,0,186,186,372
"38423",2015,0,0,91,91
"38423",2016,0,0,22,22
"38423",2017,0,0,95,95
"38423",2018,0,18,54,72
"38423",2019,0,93,140,233
"38423",2020,0,96,233,329
"38424",2015,0,0,91,91
"38424",2016,0,0,22,22
"38424",2017,0,0,95,95
"38424",2018,0,18,54,72
"38424",2019,0,47,135,182
"38424",2020,0,186,186,372
"38425",2015,0,0,91,91
"38425",2016,0,22,22,44
"38425",2017,0,95,95,190
"38425",2018,0,18,54,72
"38425",2019,0,93,140,233
"38425",2020,0,96,233,329
"38426",2015,0,0,91,91
"38426",2016,0,0,22,22
"38426",2017,0,0,95,95
"38426",2018,0,18,54,72
"38426",2019,0,134,160,294
"38426",2020,0,186,186,372
"38427",2015,0,0,91,91
"38427",2016,0,22,22,44
"38427",2017,0,95,95,190
"38427",2018,0,18,54,72
"38427",2019,0,93,140,233
"38427",2020,0,96,233,329
"38428",2015,0,0,91,91
"38428",2016,0,0,22,22
"38428",2017,0,0,95,95
"38428",2018,0,18,54,72
"38428",2019,0,47,135,182
"38428",2020,0,186,186,372
"38429",2015,0,0,91,91
"38429",2016,0,0,22,22
"38429",2017,0,0,95,95
"38429",2018,0,18,54,72
"38429",2019,0,47,135,182
"38429",2020,0,186,186,372
"38430",2015,0,0,91,91
"38430",2016,0,0,22,22
"38430",2017,0,0,95,95
"38430",2018,0,18,54,72
"38430",2019,0,134,160,294
"38430",2020,0,186,186,372
"38431",2015,0,1,91,92
"38431",2016,0,22,22,44
"38431",2017,0,95,95,190
"38431",2018,0,18,54,72
"38431",2019,0,166,140,306
"38431",2020,0,156,156,312
"38432",2015,0,1,91,92
"38432",2016,0,22,22,44
"38432",2017,0,95,95,190
"38432",2018,0,18,54,72
"38432",2019,0,166,140,306
"38432",2020,0,156,203,359
"38433",2015,0,0,91,91
"38433",2016,0,0,22,22
"38433",2017,0,0,95,95
"38433",2018,0,18,54,72
"38433",2019,0,135,73,208
"38433",2020,0,186,186,372
"38434",2015,0,0,91,91
"38434",2016,0,0,22,22
"38434",2017,0,0,95,95
"38434",2018,0,18,54,72
"38434",2019,0,93,140,233
"38434",2020,0,126,233,359
"38436",2015,0,0,91,91
"38436",2016,0,0,22,22
"38436",2017,0,0,95,95
"38436",2018,0,18,54,72
"38436",2019,0,135,73,208
"38436",2020,0,186,186,372
"38437",2015,0,0,91,91
"38437",2016,0,22,22,44
"38437",2017,0,95,95,190
"38437",2018,0,18,54,72
"38437",2019,0,93,140,233
"38437",2020,0,96,233,329
"38438",2015,0,0,91,91
"38438",2016,0,0,22,22
"38438",2017,0,0,95,95
"38438",2018,0,18,54,72
"38438",2019,0,47,135,182
"38438",2020,0,186,186,372
"38439",2015,0,0,91,91
"38439",2016,0,0,22,22
"38439",2017,0,0,95,95
"38439",2018,0,18,54,72
"38439",2019,0,134,160,294
"38439",2020,0,186,186,372
"38440",2015,0,0,91,91
"38440",2016,0,22,22,44
"38440",2017,0,95,95,190
"38440",2018,0,18,54,72
"38440",2019,0,93,140,233
"38440",2020,0,96,120,216
"38442",2015,0,1,91,92
"38442",2016,0,22,22,44
"38442",2017,0,95,95,190
"38442",2018,0,18,54,72
"38442",2019,0,93,140,233
"38442",2020,0,96,203,299
"38443",2015,0,0,91,91
"38443",2016,0,0,22,22
"38443",2017,0,0,95,95
"38443",2018,0,18,54,72
"38443",2019,0,93,140,233
"38443",2020,0,96,233,329
"38444",2015,0,0,91,91
"38444",2016,0,0,22,22
"38444",2017,0,0,95,95
"38444",2018,0,18,54,72
"38444",2019,0,47,135,182
"38444",2020,0,186,186,372
"38445",2015,0,0,91,91
"38445",2016,0,0,22,22
"38445",2017,0,0,95,95
"38445",2018,0,18,54,72
"38445",2019,0,47,135,182
"38445",2020,0,186,186,372
"38446",2015,0,1,91,92
"38446",2016,0,22,22,44
"38446",2017,0,95,95,190
"38446",2018,0,18,54,72
"38446",2019,0,166,140,306
"38446",2020,0,156,156,312
"38448",2015,0,1,35,36
"38448",2016,0,22,22,44
"38448",2017,0,95,95,190
"38448",2018,0,18,54,72
"38448",2019,0,73,140,213
"38448",2020,0,60,167,227
"38449",2015,0,1,91,92
"38449",2016,0,0,22,22
"38449",2017,0,95,95,190
"38449",2018,0,100,36,136
"38449",2019,0,0,140,140
"38449",2020,0,0,186,186
"38450",2015,0,0,91,91
"38450",2016,0,0,22,22
"38450",2017,0,0,95,95
"38450",2018,0,18,54,72
"38450",2019,0,93,140,233
"38450",2020,0,96,233,329
"38451",2015,0,0,91,91
"38451",2016,0,0,22,22
"38451",2017,0,0,95,95
"38451",2018,0,18,54,72
"38451",2019,0,93,140,233
"38451",2020,0,126,233,359
"38452",2015,0,0,91,91
"38452",2016,0,22,22,44
"38452",2017,0,95,95,190
"38452",2018,0,18,54,72
"38452",2019,0,93,140,233
"38452",2020,0,96,233,329
"38453",2015,0,0,91,91
"38453",2016,0,0,22,22
"38453",2017,0,0,95,95
"38453",2018,0,18,54,72
"38453",2019,0,93,140,233
"38453",2020,0,96,233,329
"38454",2015,0,0,91,91
"38454",2016,0,0,22,22
"38454",2017,0,0,95,95
"38454",2018,0,18,54,72
"38454",2019,0,93,140,233
"38454",2020,0,96,233,329
"38455",2015,0,0,91,91
"38455",2016,0,0,22,22
"38455",2017,0,0,95,95
"38455",2018,0,18,54,72
"38455",2019,0,93,140,233
"38455",2020,0,126,233,359
"38456",2015,0,0,91,91
"38456",2016,0,0,22,22
"38456",2017,0,0,95,95
"38456",2018,0,18,54,72
"38456",2019,0,47,135,182
"38456",2020,0,186,186,372
"38457",2015,0,0,91,91
"38457",2016,0,22,22,44
"38457",2017,0,95,95,190
"38457",2018,0,18,54,72
"38457",2019,0,93,140,233
"38457",2020,0,96,233,329
"38458",2015,0,0,91,91
"38458",2016,0,0,22,22
"38458",2017,0,0,95,95
"38458",2018,0,18,54,72
"38458",2019,0,166,166,332
"38458",2020,0,186,233,419
"38459",2015,0,1,35,36
"38459",2016,0,22,22,44
"38459",2017,0,95,95,190
"38459",2018,0,18,54,72
"38459",2019,0,73,140,213
"38459",2020,0,60,167,227
"38460",2015,0,1,91,92
"38460",2016,0,22,22,44
"38460",2017,0,95,95,190
"38460",2018,0,18,54,72
"38460",2019,0,166,140,306
"38460",2020,0,156,203,359
"38462",2015,0,0,91,91
"38462",2016,0,0,22,22
"38462",2017,0,0,95,95
"38462",2018,0,18,54,72
"38462",2019,0,47,135,182
"38462",2020,0,186,186,372
"38463",2015,0,0,91,91
"38463",2016,0,0,22,22
"38463",2017,0,0,95,95
"38463",2018,0,18,54,72
"38463",2019,0,93,140,233
"38463",2020,0,96,233,329
"38464",2015,0,0,91,91
"38464",2016,0,0,22,22
"38464",2017,0,0,95,95
"38464",2018,0,18,54,72
"38464",2019,0,93,140,233
"38464",2020,0,126,233,359
"38465",2015,0,0,91,91
"38465",2016,0,0,22,22
"38465",2017,0,0,95,95
"38465",2018,0,18,54,72
"38465",2019,0,166,166,332
"38465",2020,0,186,233,419
"38466",2015,0,0,91,91
"38466",2016,0,0,22,22
"38466",2017,0,0,95,95
"38466",2018,0,18,54,72
"38466",2019,0,134,160,294
"38466",2020,0,186,186,372
"38467",2015,0,0,91,91
"38467",2016,0,0,22,22
"38467",2017,0,0,95,95
"38467",2018,0,18,54,72
"38467",2019,0,93,140,233
"38467",2020,0,126,233,359
"38468",2015,0,0,91,91
"38468",2016,0,22,22,44
"38468",2017,0,95,95,190
"38468",2018,0,18,54,72
"38468",2019,0,93,140,233
"38468",2020,0,96,233,329
"38469",2015,0,0,91,91
"38469",2016,0,0,22,22
"38469",2017,0,0,95,95
"38469",2018,0,18,54,72
"38469",2019,0,47,135,182
"38469",2020,0,186,186,372
"38470",2015,0,0,91,91
"38470",2016,0,0,22,22
"38470",2017,0,0,95,95
"38470",2018,0,18,54,72
"38470",2019,0,47,135,182
"38470",2020,0,186,186,372
"38471",2015,0,1,91,92
"38471",2016,0,22,22,44
"38471",2017,0,95,95,190
"38471",2018,0,18,54,72
"38471",2019,0,93,140,233
"38471",2020,0,96,203,299
"38472",2015,0,1,91,92
"38472",2016,0,22,22,44
"38472",2017,0,95,95,190
"38472",2018,0,18,54,72
"38472",2019,0,93,140,233
"38472",2020,0,96,203,299
"38473",2015,0,0,91,91
"38473",2016,0,22,22,44
"38473",2017,0,95,95,190
"38473",2018,0,18,54,72
"38473",2019,0,93,140,233
"38473",2020,0,96,233,329
"38474",2015,0,0,91,91
"38474",2016,0,0,22,22
"38474",2017,0,0,95,95
"38474",2018,0,18,54,72
"38474",2019,0,93,140,233
"38474",2020,0,96,233,329
"38475",2015,0,0,91,91
"38475",2016,0,0,22,22
"38475",2017,0,0,95,95
"38475",2018,0,18,54,72
"38475",2019,0,93,140,233
"38475",2020,0,126,233,359
"38476",2015,0,1,35,36
"38476",2016,0,22,22,44
"38476",2017,0,95,95,190
"38476",2018,0,46,54,100
"38476",2019,0,73,140,213
"38476",2020,0,60,167,227
"38478",2015,0,0,91,91
"38478",2016,0,0,22,22
"38478",2017,0,0,95,95
"38478",2018,0,18,54,72
"38478",2019,0,47,135,182
"38478",2020,0,186,186,372
"38479",2015,0,1,35,36
"38479",2016,0,22,22,44
"38479",2017,0,95,95,190
"38479",2018,0,18,54,72
"38479",2019,0,73,140,213
"38479",2020,0,60,167,227
"38480",2015,0,1,35,36
"38480",2016,0,22,22,44
"38480",2017,0,95,95,190
"38480",2018,0,46,54,100
"38480",2019,0,73,140,213
"38480",2020,0,60,167,227
"38481",2015,0,0,91,91
"38481",2016,0,0,22,22
"38481",2017,0,0,95,95
"38481",2018,0,18,54,72
"38481",2019,0,93,140,233
"38481",2020,0,126,233,359
"38483",2015,0,0,91,91
"38483",2016,0,0,22,22
"38483",2017,0,0,95,95
"38483",2018,0,18,54,72
"38483",2019,0,93,140,233
"38483",2020,0,126,233,359
"38484",2015,0,1,35,36
"38484",2016,0,22,22,44
"38484",2017,0,95,95,190
"38484",2018,0,46,54,100
"38484",2019,0,73,140,213
"38484",2020,0,60,167,227
"38485",2015,0,0,91,91
"38485",2016,0,0,22,22
"38485",2017,0,0,95,95
"38485",2018,0,18,54,72
"38485",2019,0,135,73,208
"38485",2020,0,186,186,372
"38486",2015,0,0,91,91
"38486",2016,0,0,22,22
"38486",2017,0,0,95,95
"38486",2018,0,18,54,72
"38486",2019,0,135,73,208
"38486",2020,0,186,186,372
"38487",2015,0,1,35,36
"38487",2016,0,22,22,44
"38487",2017,0,95,95,190
"38487",2018,0,46,54,100
"38487",2019,0,73,140,213
"38487",2020,0,60,167,227
"38488",2015,0,0,91,91
"38488",2016,0,0,22,22
"38488",2017,0,0,95,95
"38488",2018,0,18,54,72
"38488",2019,0,93,140,233
"38488",2020,0,126,233,359
"38489",2015,0,0,91,91
"38489",2016,0,0,22,22
"38489",2017,0,0,95,95
"38489",2018,0,18,54,72
"38489",2019,0,47,135,182
"38489",2020,0,186,186,372
"38490",2015,0,0,91,91
"38490",2016,0,22,22,44
"38490",2017,0,95,95,190
"38490",2018,0,18,54,72
"38490",2019,0,93,140,233
"38490",2020,0,96,233,329
"38492",2015,0,0,91,91
"38492",2016,0,0,22,22
"38492",2017,0,0,95,95
"38492",2018,0,18,54,72
"38492",2019,0,47,135,182
"38492",2020,0,186,186,372
"38494",2015,0,0,91,91
"38494",2016,0,0,22,22
"38494",2017,0,0,95,95
"38494",2018,0,18,54,72
"38494",2019,0,93,140,233
"38494",2020,0,126,233,359
"38495",2015,0,0,91,91
"38495",2016,0,0,22,22
"38495",2017,0,0,95,95
"38495",2018,0,18,54,72
"38495",2019,0,93,140,233
"38495",2020,0,96,233,329
"38496",2015,0,0,91,91
"38496",2016,0,22,22,44
"38496",2017,0,95,95,190
"38496",2018,0,18,54,72
"38496",2019,0,93,140,233
"38496",2020,0,96,233,329
"38497",2015,0,0,91,91
"38497",2016,0,0,22,22
"38497",2017,0,0,95,95
"38497",2018,0,18,54,72
"38497",2019,0,47,135,182
"38497",2020,0,186,186,372
"38498",2015,0,0,91,91
"38498",2016,0,0,22,22
"38498",2017,0,0,95,95
"38498",2018,0,18,54,72
"38498",2019,0,93,140,233
"38498",2020,0,126,233,359
"38499",2015,0,0,91,91
"38499",2016,0,0,22,22
"38499",2017,0,0,95,95
"38499",2018,0,18,54,72
"38499",2019,0,47,135,182
"38499",2020,0,186,186,372
"38500",2015,0,0,91,91
"38500",2016,0,0,22,22
"38500",2017,0,0,95,95
"38500",2018,0,18,54,72
"38500",2019,0,93,140,233
"38500",2020,0,96,233,329
"38501",2015,0,0,91,91
"38501",2016,0,0,22,22
"38501",2017,0,0,95,95
"38501",2018,0,18,54,72
"38501",2019,0,134,160,294
"38501",2020,0,186,186,372
"38503",2015,0,0,91,91
"38503",2016,0,0,22,22
"38503",2017,0,0,95,95
"38503",2018,0,18,54,72
"38503",2019,0,134,160,294
"38503",2020,0,186,186,372
"38504",2015,0,0,91,91
"38504",2016,0,0,22,22
"38504",2017,0,0,95,95
"38504",2018,0,18,54,72
"38504",2019,0,134,160,294
"38504",2020,0,186,186,372
"38505",2015,0,0,91,91
"38505",2016,0,22,22,44
"38505",2017,0,95,95,190
"38505",2018,0,18,54,72
"38505",2019,0,93,140,233
"38505",2020,0,96,120,216
"38507",2015,0,1,91,92
"38507",2016,0,0,22,22
"38507",2017,0,95,95,190
"38507",2018,0,100,36,136
"38507",2019,0,0,140,140
"38507",2020,0,0,186,186
"38508",2015,0,0,91,91
"38508",2016,0,0,22,22
"38508",2017,0,0,95,95
"38508",2018,0,18,54,72
"38508",2019,0,93,140,233
"38508",2020,0,126,233,359
"38509",2015,0,0,91,91
"38509",2016,0,0,22,22
"38509",2017,0,0,95,95
"38509",2018,0,18,54,72
"38509",2019,0,93,140,233
"38509",2020,0,126,233,359
"38511",2015,0,0,91,91
"38511",2016,0,0,22,22
"38511",2017,0,0,95,95
"38511",2018,0,18,54,72
"38511",2019,0,134,160,294
"38511",2020,0,186,186,372
"38512",2015,0,1,35,36
"38512",2016,0,22,22,44
"38512",2017,0,95,95,190
"38512",2018,0,46,54,100
"38512",2019,0,73,140,213
"38512",2020,0,60,167,227
"38513",2015,0,0,91,91
"38513",2016,0,0,22,22
"38513",2017,0,0,95,95
"38513",2018,0,18,54,72
"38513",2019,0,47,135,182
"38513",2020,0,186,186,372
"38514",2015,0,0,91,91
"38514",2016,0,0,22,22
"38514",2017,0,0,95,95
"38514",2018,0,18,54,72
"38514",2019,0,47,135,182
"38514",2020,0,186,186,372
"38515",2015,0,0,91,91
"38515",2016,0,0,22,22
"38515",2017,0,0,95,95
"38515",2018,0,18,54,72
"38515",2019,0,93,140,233
"38515",2020,0,126,233,359
"38516",2015,0,0,91,91
"38516",2016,0,0,22,22
"38516",2017,0,0,95,95
"38516",2018,0,18,54,72
"38516",2019,0,109,135,244
"38516",2020,0,186,186,372
"38517",2015,0,0,91,91
"38517",2016,0,22,22,44
"38517",2017,0,95,95,190
"38517",2018,0,18,54,72
"38517",2019,0,93,140,233
"38517",2020,0,96,233,329
"38518",2015,0,0,91,91
"38518",2016,0,0,22,22
"38518",2017,0,0,95,95
"38518",2018,0,18,54,72
"38518",2019,0,47,135,182
"38518",2020,0,186,186,372
"38519",2015,0,1,35,36
"38519",2016,0,22,22,44
"38519",2017,0,95,95,190
"38519",2018,0,100,36,136
"38519",2019,0,0,140,140
"38519",2020,0,0,120,120
"38520",2015,0,0,91,91
"38520",2016,0,0,22,22
"38520",2017,0,0,95,95
"38520",2018,0,18,54,72
"38520",2019,0,93,140,233
"38520",2020,0,126,233,359
"38521",2015,0,0,91,91
"38521",2016,0,0,22,22
"38521",2017,0,0,95,95
"38521",2018,0,18,54,72
"38521",2019,0,47,135,182
"38521",2020,0,186,186,372
"38522",2015,0,0,91,91
"38522",2016,0,0,22,22
"38522",2017,0,0,95,95
"38522",2018,0,18,54,72
"38522",2019,0,47,135,182
"38522",2020,0,186,186,372
"38523",2015,0,0,91,91
"38523",2016,0,0,22,22
"38523",2017,0,0,95,95
"38523",2018,0,18,54,72
"38523",2019,0,93,140,233
"38523",2020,0,96,120,216
"38524",2015,0,0,91,91
"38524",2016,0,0,22,22
"38524",2017,0,0,95,95
"38524",2018,0,18,54,72
"38524",2019,0,135,73,208
"38524",2020,0,186,186,372
"38525",2015,0,0,91,91
"38525",2016,0,0,22,22
"38525",2017,0,0,95,95
"38525",2018,0,18,54,72
"38525",2019,0,93,140,233
"38525",2020,0,126,233,359
"38526",2015,0,0,91,91
"38526",2016,0,0,22,22
"38526",2017,0,0,95,95
"38526",2018,0,18,54,72
"38526",2019,0,93,140,233
"38526",2020,0,96,233,329
"38527",2015,0,0,91,91
"38527",2016,0,0,22,22
"38527",2017,0,0,95,95
"38527",2018,0,18,54,72
"38527",2019,0,109,135,244
"38527",2020,0,186,186,372
"38528",2015,0,0,91,91
"38528",2016,0,0,22,22
"38528",2017,0,0,95,95
"38528",2018,0,18,54,72
"38528",2019,0,109,135,244
"38528",2020,0,186,186,372
"38529",2015,0,0,91,91
"38529",2016,0,0,22,22
"38529",2017,0,0,95,95
"38529",2018,0,18,54,72
"38529",2019,0,109,135,244
"38529",2020,0,186,186,372
"38530",2015,0,0,91,91
"38530",2016,0,0,22,22
"38530",2017,0,0,95,95
"38530",2018,0,18,54,72
"38530",2019,0,93,140,233
"38530",2020,0,126,233,359
"38531",2015,0,1,91,92
"38531",2016,0,22,22,44
"38531",2017,0,95,95,190
"38531",2018,0,18,54,72
"38531",2019,0,93,140,233
"38531",2020,0,96,203,299
"38532",2015,0,0,91,91
"38532",2016,0,0,22,22
"38532",2017,0,0,95,95
"38532",2018,0,18,54,72
"38532",2019,0,93,140,233
"38532",2020,0,126,233,359
"38533",2015,0,0,91,91
"38533",2016,0,0,22,22
"38533",2017,0,0,95,95
"38533",2018,0,18,54,72
"38533",2019,0,134,160,294
"38533",2020,0,186,186,372
"38535",2015,0,0,91,91
"38535",2016,0,0,22,22
"38535",2017,0,0,95,95
"38535",2018,0,18,54,72
"38535",2019,0,166,166,332
"38535",2020,0,186,233,419
"38536",2015,0,1,35,36
"38536",2016,0,22,22,44
"38536",2017,0,95,95,190
"38536",2018,0,18,54,72
"38536",2019,0,73,140,213
"38536",2020,0,60,167,227
"38537",2015,0,0,91,91
"38537",2016,0,0,22,22
"38537",2017,0,0,95,95
"38537",2018,0,18,54,72
"38537",2019,0,93,140,233
"38537",2020,0,126,233,359
"38538",2015,0,0,91,91
"38538",2016,0,0,22,22
"38538",2017,0,0,95,95
"38538",2018,0,18,54,72
"38538",2019,0,134,160,294
"38538",2020,0,186,186,372
"38539",2015,0,0,91,91
"38539",2016,0,0,22,22
"38539",2017,0,0,95,95
"38539",2018,0,18,54,72
"38539",2019,0,166,166,332
"38539",2020,0,186,233,419
"38540",2015,0,0,91,91
"38540",2016,0,0,22,22
"38540",2017,0,0,95,95
"38540",2018,0,18,54,72
"38540",2019,0,93,140,233
"38540",2020,0,96,233,329
"38542",2015,0,0,91,91
"38542",2016,0,0,22,22
"38542",2017,0,0,95,95
"38542",2018,0,18,54,72
"38542",2019,0,93,140,233
"38542",2020,0,126,233,359
"38543",2015,0,0,91,91
"38543",2016,0,0,22,22
"38543",2017,0,0,95,95
"38543",2018,0,18,54,72
"38543",2019,0,93,140,233
"38543",2020,0,126,233,359
"38544",2015,0,1,35,36
"38544",2016,0,22,22,44
"38544",2017,0,95,95,190
"38544",2018,0,46,54,100
"38544",2019,0,73,140,213
"38544",2020,0,60,167,227
"38545",2015,0,0,91,91
"38545",2016,0,0,22,22
"38545",2017,0,0,95,95
"38545",2018,0,18,54,72
"38545",2019,0,47,135,182
"38545",2020,0,186,186,372
"38546",2015,0,0,91,91
"38546",2016,0,0,22,22
"38546",2017,0,0,95,95
"38546",2018,0,18,54,72
"38546",2019,0,93,140,233
"38546",2020,0,126,233,359
"38547",2015,0,0,91,91
"38547",2016,0,0,22,22
"38547",2017,0,0,95,95
"38547",2018,0,18,54,72
"38547",2019,0,134,160,294
"38547",2020,0,186,186,372
"38548",2015,0,0,91,91
"38548",2016,0,0,22,22
"38548",2017,0,0,95,95
"38548",2018,0,18,54,72
"38548",2019,0,135,73,208
"38548",2020,0,186,186,372
"38549",2015,0,0,91,91
"38549",2016,0,0,22,22
"38549",2017,0,0,95,95
"38549",2018,0,18,54,72
"38549",2019,0,47,135,182
"38549",2020,0,186,186,372
"38550",2015,0,0,91,91
"38550",2016,0,0,22,22
"38550",2017,0,0,95,95
"38550",2018,0,18,54,72
"38550",2019,0,47,135,182
"38550",2020,0,186,186,372
"38551",2015,0,0,91,91
"38551",2016,0,0,22,22
"38551",2017,0,0,95,95
"38551",2018,0,18,54,72
"38551",2019,0,47,135,182
"38551",2020,0,186,186,372
"38552",2015,0,0,91,91
"38552",2016,0,0,22,22
"38552",2017,0,0,95,95
"38552",2018,0,18,54,72
"38552",2019,0,47,135,182
"38552",2020,0,186,186,372
"38553",2015,0,0,91,91
"38553",2016,0,0,22,22
"38553",2017,0,0,95,95
"38553",2018,0,18,54,72
"38553",2019,0,93,140,233
"38553",2020,0,126,233,359
"38554",2015,0,0,91,91
"38554",2016,0,0,22,22
"38554",2017,0,0,95,95
"38554",2018,0,18,54,72
"38554",2019,0,93,140,233
"38554",2020,0,126,233,359
"38555",2015,0,1,35,36
"38555",2016,0,22,22,44
"38555",2017,0,95,95,190
"38555",2018,0,18,54,72
"38555",2019,0,73,140,213
"38555",2020,0,60,167,227
"38556",2015,0,0,91,91
"38556",2016,0,22,22,44
"38556",2017,0,95,95,190
"38556",2018,0,18,54,72
"38556",2019,0,93,140,233
"38556",2020,0,96,233,329
"38557",2015,0,1,91,92
"38557",2016,0,0,22,22
"38557",2017,0,95,95,190
"38557",2018,0,100,36,136
"38557",2019,0,0,140,140
"38557",2020,0,0,186,186
"38558",2015,0,1,35,36
"38558",2016,0,22,22,44
"38558",2017,0,95,95,190
"38558",2018,0,46,54,100
"38558",2019,0,73,140,213
"38558",2020,0,60,167,227
"38559",2015,0,0,91,91
"38559",2016,0,0,22,22
"38559",2017,0,0,95,95
"38559",2018,0,18,54,72
"38559",2019,0,93,140,233
"38559",2020,0,96,233,329
"38560",2015,0,0,91,91
"38560",2016,0,0,22,22
"38560",2017,0,89,95,184
"38560",2018,0,18,54,72
"38560",2019,0,93,140,233
"38560",2020,0,96,233,329
"38561",2015,0,0,91,91
"38561",2016,0,22,22,44
"38561",2017,0,95,95,190
"38561",2018,0,18,54,72
"38561",2019,0,93,140,233
"38561",2020,0,96,120,216
"38562",2015,0,0,91,91
"38562",2016,0,0,22,22
"38562",2017,0,0,95,95
"38562",2018,0,18,54,72
"38562",2019,0,109,135,244
"38562",2020,0,186,186,372
"38563",2015,0,1,91,92
"38563",2016,0,22,22,44
"38563",2017,0,95,95,190
"38563",2018,0,18,54,72
"38563",2019,0,166,140,306
"38563",2020,0,156,203,359
"38564",2015,0,1,91,92
"38564",2016,0,22,22,44
"38564",2017,0,95,95,190
"38564",2018,0,18,54,72
"38564",2019,0,166,140,306
"38564",2020,0,156,156,312
"38565",2015,0,1,91,92
"38565",2016,0,22,22,44
"38565",2017,0,95,95,190
"38565",2018,0,18,54,72
"38565",2019,0,93,140,233
"38565",2020,0,96,203,299
"38566",2015,0,0,91,91
"38566",2016,0,0,22,22
"38566",2017,0,0,95,95
"38566",2018,0,18,54,72
"38566",2019,0,93,140,233
"38566",2020,0,96,233,329
"38567",2015,0,0,91,91
"38567",2016,0,0,22,22
"38567",2017,0,0,95,95
"38567",2018,0,18,54,72
"38567",2019,0,109,135,244
"38567",2020,0,186,186,372
"39001",2015,0,21,0,21
"39001",2020,0,0,91,91
"39002",2015,0,21,0,21
"39002",2020,0,0,91,91
"39003",2015,0,21,0,21
"39003",2020,0,0,91,91
"39004",2015,0,21,0,21
"39004",2020,0,0,91,91
"39006",2015,0,21,0,21
"39006",2020,0,0,91,91
"39007",2015,0,21,0,21
"39007",2020,0,0,91,91
"39008",2015,0,21,0,21
"39008",2020,0,0,91,91
"39009",2015,0,21,0,21
"39009",2020,0,0,91,91
"39010",2015,0,21,0,21
"39010",2020,0,0,91,91
"39011",2015,0,21,0,21
"39011",2020,0,0,91,91
"39013",2015,0,21,0,21
"39013",2020,0,0,91,91
"39014",2015,0,21,0,21
"39014",2020,0,0,91,91
"39015",2015,0,21,0,21
"39015",2020,0,0,91,91
"39016",2015,0,21,0,21
"39016",2020,0,0,91,91
"39017",2015,0,21,0,21
"39017",2020,0,0,91,91
"39018",2015,0,21,0,21
"39018",2020,0,0,91,91
"39019",2015,0,21,0,21
"39019",2020,0,0,91,91
"39020",2015,0,21,0,21
"39020",2020,0,0,91,91
"39021",2015,0,21,0,21
"39021",2020,0,0,91,91
"39022",2015,0,21,0,21
"39022",2020,0,0,91,91
"39024",2015,0,21,0,21
"39024",2020,0,0,91,91
"39025",2015,0,21,0,21
"39025",2020,0,0,91,91
"39026",2015,0,21,0,21
"39026",2020,0,0,91,91
"39027",2015,0,21,0,21
"39027",2020,0,0,91,91
"39028",2015,0,21,0,21
"39028",2020,0,0,91,91
"39029",2015,0,21,0,21
"39029",2020,0,0,91,91
"39030",2015,0,21,0,21
"39030",2020,0,0,91,91
"39031",2015,0,21,0,21
"39031",2020,0,0,91,91
"39032",2015,0,21,0,21
"39032",2020,0,0,91,91
"39034",2015,0,21,0,21
"39034",2020,0,0,91,91
"39035",2015,0,21,0,21
"39035",2020,0,0,91,91
"39037",2015,0,21,0,21
"39037",2020,0,0,91,91
"39038",2015,0,21,0,21
"39038",2020,0,0,91,91
"39039",2015,0,21,0,21
"39039",2020,0,0,91,91
"39040",2015,0,21,0,21
"39040",2020,0,0,91,91
"39041",2015,0,21,0,21
"39041",2020,0,0,91,91
"39042",2015,0,21,0,21
"39042",2020,0,0,91,91
"39043",2015,0,21,0,21
"39043",2020,0,0,91,91
"39045",2015,0,21,0,21
"39045",2020,0,0,91,91
"39046",2015,0,21,0,21
"39046",2020,0,0,91,91
"39047",2015,0,21,0,21
"39047",2020,0,0,91,91
"39048",2015,0,21,0,21
"39048",2020,0,0,91,91
"39049",2015,0,21,0,21
"39049",2020,0,0,91,91
"39050",2015,0,21,0,21
"39050",2020,0,0,91,91
"39051",2015,0,21,0,21
"39051",2020,0,0,91,91
"39052",2015,0,21,0,21
"39052",2020,0,0,91,91
"39053",2015,0,21,0,21
"39053",2020,0,0,91,91
"39054",2015,0,21,0,21
"39054",2020,0,0,91,91
"39055",2015,0,21,0,21
"39055",2020,0,0,91,91
"39056",2015,0,21,0,21
"39056",2020,0,0,91,91
"39057",2015,0,21,0,21
"39057",2020,0,0,91,91
"39058",2015,0,21,0,21
"39058",2020,0,0,91,91
"39059",2015,0,21,0,21
"39059",2020,0,0,91,91
"39060",2015,0,21,0,21
"39060",2020,0,0,91,91
"39061",2015,0,21,0,21
"39061",2020,0,0,91,91
"39062",2015,0,21,0,21
"39062",2020,0,0,91,91
"39063",2015,0,21,0,21
"39063",2020,0,0,91,91
"39065",2015,0,21,0,21
"39065",2020,0,0,91,91
"39066",2015,0,21,0,21
"39066",2020,0,0,91,91
"39068",2015,0,21,0,21
"39068",2020,0,0,91,91
"39070",2015,0,21,0,21
"39070",2020,0,0,91,91
"39072",2015,0,21,0,21
"39072",2020,0,0,91,91
"39073",2015,0,21,0,21
"39073",2020,0,0,91,91
"39074",2015,0,21,0,21
"39074",2020,0,0,91,91
"39076",2015,0,21,0,21
"39076",2020,0,0,91,91
"39077",2015,0,21,0,21
"39077",2020,0,0,91,91
"39078",2015,0,21,0,21
"39078",2020,0,0,91,91
"39079",2015,0,21,0,21
"39079",2020,0,0,91,91
"39080",2015,0,21,0,21
"39080",2020,0,0,91,91
"39081",2015,0,21,0,21
"39081",2020,0,0,91,91
"39083",2015,0,21,0,21
"39083",2020,0,0,91,91
"39084",2015,0,21,0,21
"39084",2020,0,0,91,91
"39085",2015,0,21,0,21
"39085",2020,0,0,91,91
"39086",2015,0,21,0,21
"39086",2020,0,0,91,91
"39088",2015,0,21,0,21
"39088",2020,0,0,91,91
"39090",2015,0,21,0,21
"39090",2020,0,0,91,91
"39091",2015,0,21,0,21
"39091",2020,0,0,91,91
"39092",2015,0,21,0,21
"39092",2020,0,0,91,91
"39093",2015,0,21,0,21
"39093",2020,0,0,91,91
"39094",2015,0,21,0,21
"39094",2020,0,0,91,91
"39095",2015,0,21,0,21
"39095",2020,0,0,91,91
"39096",2015,0,21,0,21
"39096",2020,0,0,91,91
"39097",2015,0,21,0,21
"39097",2020,0,0,91,91
"39099",2015,0,21,0,21
"39099",2020,0,0,91,91
"39100",2015,0,21,0,21
"39100",2020,0,0,91,91
"39101",2015,0,21,0,21
"39101",2020,0,0,91,91
"39102",2015,0,21,0,21
"39102",2020,0,0,91,91
"39103",2015,0,21,0,21
"39103",2020,0,0,91,91
"39104",2015,0,21,0,21
"39104",2020,0,0,91,91
"39105",2015,0,21,0,21
"39105",2020,0,0,91,91
"39106",2015,0,21,0,21
"39106",2020,0,0,91,91
"39107",2015,0,21,0,21
"39107",2020,0,0,91,91
"39108",2015,0,21,0,21
"39108",2020,0,0,91,91
"39109",2015,0,21,0,21
"39109",2020,0,0,91,91
"39110",2015,0,21,0,21
"39110",2020,0,0,91,91
"39111",2015,0,21,0,21
"39111",2020,0,0,91,91
"39112",2015,0,21,0,21
"39112",2020,0,0,91,91
"39114",2015,0,21,0,21
"39114",2020,0,0,91,91
"39116",2015,0,21,0,21
"39116",2020,0,0,91,91
"39117",2015,0,21,0,21
"39117",2020,0,0,91,91
"39118",2015,0,21,0,21
"39118",2020,0,0,91,91
"39119",2015,0,21,0,21
"39119",2020,0,0,91,91
"39120",2015,0,21,0,21
"39120",2020,0,0,91,91
"39121",2015,0,21,0,21
"39121",2020,0,0,91,91
"39122",2015,0,21,0,21
"39122",2020,0,0,91,91
"39124",2015,0,21,0,21
"39124",2020,0,0,91,91
"39126",2015,0,21,0,21
"39126",2020,0,0,91,91
"39127",2015,0,21,0,21
"39127",2020,0,0,91,91
"39128",2015,0,21,0,21
"39128",2020,0,0,91,91
"39129",2015,0,21,0,21
"39129",2020,0,0,91,91
"39130",2015,0,21,0,21
"39130",2020,0,0,91,91
"39131",2015,0,21,0,21
"39131",2020,0,0,91,91
"39132",2015,0,21,0,21
"39132",2020,0,0,91,91
"39133",2015,0,21,0,21
"39133",2020,0,0,91,91
"39134",2015,0,21,0,21
"39134",2020,0,0,91,91
"39136",2015,0,21,0,21
"39136",2020,0,0,91,91
"39137",2015,0,21,0,21
"39137",2020,0,0,91,91
"39138",2015,0,21,0,21
"39138",2020,0,0,91,91
"39139",2015,0,21,0,21
"39139",2020,0,0,91,91
"39140",2015,0,21,0,21
"39141",2015,0,21,0,21
"39141",2020,0,0,91,91
"39142",2015,0,21,0,21
"39142",2020,0,0,91,91
"39143",2015,0,21,0,21
"39143",2020,0,0,91,91
"39145",2015,0,21,0,21
"39145",2020,0,0,91,91
"39146",2015,0,21,0,21
"39146",2020,0,0,91,91
"39147",2015,0,21,0,21
"39147",2020,0,0,91,91
"39149",2015,0,21,0,21
"39149",2020,0,0,91,91
"39150",2015,0,21,0,21
"39150",2020,0,0,91,91
"39151",2015,0,21,0,21
"39151",2020,0,0,91,91
"39153",2015,0,21,0,21
"39153",2020,0,0,91,91
"39154",2015,0,21,0,21
"39154",2020,0,0,91,91
"39155",2015,0,21,0,21
"39155",2020,0,0,91,91
"39156",2015,0,21,0,21
"39156",2020,0,0,91,91
"39157",2015,0,21,0,21
"39157",2020,0,0,91,91
"39159",2015,0,21,0,21
"39159",2020,0,0,91,91
"39160",2015,0,21,0,21
"39160",2020,0,0,91,91
"39162",2015,0,21,0,21
"39162",2020,0,0,91,91
"39163",2015,0,21,0,21
"39163",2020,0,0,91,91
"39164",2015,0,21,0,21
"39164",2020,0,0,91,91
"39165",2015,0,21,0,21
"39165",2020,0,0,91,91
"39166",2015,0,21,0,21
"39166",2020,0,0,91,91
"39167",2015,0,21,0,21
"39167",2020,0,0,91,91
"39168",2015,0,21,0,21
"39168",2020,0,0,91,91
"39169",2015,0,21,0,21
"39169",2020,0,0,91,91
"39170",2015,0,21,0,21
"39170",2020,0,0,91,91
"39171",2015,0,21,0,21
"39171",2020,0,0,91,91
"39172",2015,0,21,0,21
"39172",2020,0,0,91,91
"39173",2015,0,21,0,21
"39173",2020,0,0,91,91
"39174",2015,0,21,0,21
"39174",2020,0,0,91,91
"39175",2015,0,21,0,21
"39175",2020,0,0,91,91
"39176",2015,0,21,0,21
"39176",2020,0,0,91,91
"39177",2015,0,21,0,21
"39177",2020,0,0,91,91
"39178",2015,0,21,0,21
"39178",2020,0,0,91,91
"39179",2015,0,21,0,21
"39179",2020,0,0,91,91
"39180",2015,0,21,0,21
"39180",2020,0,0,91,91
"39182",2015,0,21,0,21
"39182",2020,0,0,91,91
"39183",2015,0,21,0,21
"39183",2020,0,0,91,91
"39184",2015,0,21,0,21
"39184",2020,0,0,91,91
"39185",2015,0,21,0,21
"39185",2020,0,0,91,91
"39187",2015,0,21,0,21
"39187",2020,0,0,91,91
"39188",2015,0,21,0,21
"39188",2020,0,0,91,91
"39189",2015,0,21,0,21
"39189",2020,0,0,91,91
"39190",2015,0,21,0,21
"39190",2020,0,0,91,91
"39191",2015,0,21,0,21
"39191",2020,0,0,91,91
"39192",2015,0,21,0,21
"39192",2020,0,0,91,91
"39193",2015,0,21,0,21
"39193",2020,0,0,91,91
"39194",2015,0,21,0,21
"39194",2020,0,0,91,91
"39196",2015,0,21,0,21
"39196",2020,0,0,91,91
"39197",2015,0,21,0,21
"39197",2020,0,0,91,91
"39198",2015,0,21,0,21
"39198",2020,0,0,91,91
"39199",2015,0,21,0,21
"39199",2020,0,0,91,91
"39200",2015,0,21,0,21
"39200",2020,0,0,91,91
"39201",2015,0,21,0,21
"39201",2020,0,0,91,91
"39202",2015,0,21,0,21
"39202",2020,0,0,91,91
"39203",2015,0,21,0,21
"39203",2020,0,0,91,91
"39204",2015,0,21,0,21
"39204",2020,0,0,91,91
"39205",2015,0,21,0,21
"39205",2020,0,0,91,91
"39206",2015,0,21,0,21
"39206",2020,0,0,91,91
"39207",2015,0,21,0,21
"39207",2020,0,0,91,91
"39208",2015,0,21,0,21
"39208",2020,0,0,91,91
"39209",2015,0,21,0,21
"39209",2020,0,0,91,91
"39210",2015,0,21,0,21
"39210",2020,0,0,91,91
"39211",2015,0,21,0,21
"39211",2020,0,0,91,91
"39214",2015,0,21,0,21
"39214",2020,0,0,91,91
"39216",2015,0,21,0,21
"39216",2020,0,0,91,91
"39217",2015,0,21,0,21
"39217",2020,0,0,91,91
"39218",2015,0,21,0,21
"39218",2020,0,0,91,91
"39219",2015,0,21,0,21
"39219",2020,0,0,91,91
"39220",2015,0,21,0,21
"39220",2020,0,0,91,91
"39221",2015,0,21,0,21
"39221",2020,0,0,91,91
"39222",2015,0,21,0,21
"39222",2020,0,0,91,91
"39223",2015,0,21,0,21
"39223",2020,0,0,91,91
"39225",2015,0,21,0,21
"39225",2020,0,0,91,91
"39227",2015,0,21,0,21
"39227",2020,0,0,91,91
"39228",2015,0,21,0,21
"39228",2020,0,0,91,91
"39229",2015,0,21,0,21
"39229",2020,0,0,91,91
"39230",2015,0,21,0,21
"39230",2020,0,0,91,91
"39232",2015,0,21,0,21
"39232",2020,0,0,91,91
"39233",2015,0,21,0,21
"39233",2020,0,0,91,91
"39234",2015,0,21,0,21
"39234",2020,0,0,91,91
"39235",2015,0,21,0,21
"39235",2020,0,0,91,91
"39236",2015,0,21,0,21
"39236",2020,0,0,91,91
"39237",2015,0,21,0,21
"39237",2020,0,0,91,91
"39238",2015,0,21,0,21
"39238",2020,0,0,91,91
"39239",2015,0,21,0,21
"39239",2020,0,0,91,91
"39240",2015,0,21,0,21
"39240",2020,0,0,91,91
"39241",2015,0,21,0,21
"39241",2020,0,0,91,91
"39244",2015,0,21,0,21
"39244",2020,0,0,91,91
"39245",2015,0,21,0,21
"39245",2020,0,0,91,91
"39246",2015,0,21,0,21
"39246",2020,0,0,91,91
"39247",2015,0,21,0,21
"39247",2020,0,0,91,91
"39248",2015,0,21,0,21
"39248",2020,0,0,91,91
"39249",2015,0,21,0,21
"39249",2020,0,0,91,91
"39250",2015,0,21,0,21
"39250",2020,0,0,91,91
"39251",2015,0,21,0,21
"39251",2020,0,0,91,91
"39252",2015,0,21,0,21
"39252",2020,0,0,91,91
"39253",2015,0,21,0,21
"39253",2020,0,0,91,91
"39254",2015,0,21,0,21
"39254",2020,0,0,91,91
"39255",2015,0,21,0,21
"39255",2020,0,0,91,91
"39258",2015,0,21,0,21
"39258",2020,0,0,91,91
"39259",2015,0,21,0,21
"39259",2020,0,0,91,91
"39261",2015,0,21,0,21
"39261",2020,0,0,91,91
"39262",2015,0,21,0,21
"39262",2020,0,0,91,91
"39263",2015,0,21,0,21
"39263",2020,0,0,91,91
"39265",2015,0,21,0,21
"39265",2020,0,0,91,91
"39266",2015,0,21,0,21
"39266",2020,0,0,91,91
"39267",2015,0,21,0,21
"39267",2020,0,0,91,91
"39268",2015,0,21,0,21
"39268",2020,0,0,91,91
"39269",2015,0,21,0,21
"39269",2020,0,0,91,91
"39270",2015,0,21,0,21
"39270",2020,0,0,91,91
"39271",2015,0,21,0,21
"39271",2020,0,0,91,91
"39272",2015,0,21,0,21
"39272",2020,0,0,91,91
"39273",2015,0,21,0,21
"39273",2020,0,0,91,91
"39274",2015,0,21,0,21
"39274",2020,0,0,91,91
"39275",2015,0,21,0,21
"39275",2020,0,0,91,91
"39277",2015,0,21,0,21
"39277",2020,0,0,91,91
"39278",2015,0,21,0,21
"39278",2020,0,0,91,91
"39279",2015,0,21,0,21
"39279",2020,0,0,91,91
"39280",2015,0,21,0,21
"39280",2020,0,0,91,91
"39281",2015,0,21,0,21
"39281",2020,0,0,91,91
"39282",2015,0,21,0,21
"39282",2020,0,0,91,91
"39283",2015,0,21,0,21
"39283",2020,0,0,91,91
"39284",2015,0,21,0,21
"39284",2020,0,0,91,91
"39285",2015,0,21,0,21
"39285",2020,0,0,91,91
"39286",2015,0,21,0,21
"39286",2020,0,0,91,91
"39288",2015,0,21,0,21
"39288",2020,0,0,91,91
"39289",2015,0,21,0,21
"39289",2020,0,0,91,91
"39290",2015,0,21,0,21
"39290",2020,0,0,91,91
"39291",2015,0,21,0,21
"39291",2020,0,0,91,91
"39292",2015,0,21,0,21
"39292",2020,0,0,91,91
"39293",2015,0,21,0,21
"39293",2020,0,0,91,91
"39295",2015,0,21,0,21
"39295",2020,0,0,91,91
"39296",2015,0,21,0,21
"39296",2020,0,0,91,91
"39297",2015,0,21,0,21
"39297",2020,0,0,91,91
"39298",2015,0,21,0,21
"39298",2020,0,0,91,91
"39299",2015,0,21,0,21
"39299",2020,0,0,91,91
"39300",2015,0,21,0,21
"39300",2020,0,0,91,91
"39301",2015,0,21,0,21
"39301",2020,0,0,91,91
"39302",2015,0,21,0,21
"39302",2020,0,0,91,91
"39304",2015,0,21,0,21
"39304",2020,0,0,91,91
"39305",2015,0,21,0,21
"39305",2020,0,0,91,91
"39306",2015,0,21,0,21
"39306",2020,0,0,91,91
"39307",2015,0,21,0,21
"39307",2020,0,0,91,91
"39308",2015,0,21,0,21
"39308",2020,0,0,91,91
"39310",2015,0,21,0,21
"39310",2020,0,0,91,91
"39312",2015,0,21,0,21
"39312",2020,0,0,91,91
"39313",2015,0,21,0,21
"39313",2020,0,0,91,91
"39314",2015,0,21,0,21
"39314",2020,0,0,91,91
"39315",2015,0,21,0,21
"39315",2020,0,0,91,91
"39317",2015,0,21,0,21
"39317",2020,0,0,91,91
"39318",2015,0,21,0,21
"39318",2020,0,0,91,91
"39319",2015,0,21,0,21
"39319",2020,0,0,91,91
"39320",2015,0,21,0,21
"39320",2020,0,0,91,91
"39321",2015,0,21,0,21
"39321",2020,0,0,91,91
"39322",2015,0,21,0,21
"39322",2020,0,0,91,91
"39323",2015,0,21,0,21
"39323",2020,0,0,91,91
"39324",2015,0,21,0,21
"39324",2020,0,0,91,91
"39325",2015,0,21,0,21
"39325",2020,0,0,91,91
"39326",2015,0,21,0,21
"39326",2020,0,0,91,91
"39327",2015,0,21,0,21
"39327",2020,0,0,91,91
"39328",2015,0,21,0,21
"39328",2020,0,0,91,91
"39329",2015,0,21,0,21
"39329",2020,0,0,91,91
"39330",2015,0,21,0,21
"39330",2020,0,0,91,91
"39331",2015,0,21,0,21
"39331",2020,0,0,91,91
"39333",2015,0,21,0,21
"39333",2020,0,0,91,91
"39334",2015,0,21,0,21
"39334",2020,0,0,91,91
"39335",2015,0,21,0,21
"39335",2020,0,0,91,91
"39336",2015,0,21,0,21
"39336",2020,0,0,91,91
"39337",2015,0,21,0,21
"39337",2020,0,0,91,91
"39338",2015,0,21,0,21
"39338",2020,0,0,91,91
"39339",2015,0,21,0,21
"39339",2020,0,0,91,91
"39342",2015,0,21,0,21
"39342",2020,0,0,91,91
"39343",2015,0,21,0,21
"39343",2020,0,0,91,91
"39344",2015,0,21,0,21
"39344",2020,0,0,91,91
"39345",2015,0,21,0,21
"39345",2020,0,0,91,91
"39346",2015,0,21,0,21
"39346",2020,0,0,91,91
"39348",2015,0,21,0,21
"39348",2020,0,0,91,91
"39349",2015,0,21,0,21
"39349",2020,0,0,91,91
"39350",2015,0,21,0,21
"39350",2020,0,0,91,91
"39351",2015,0,21,0,21
"39351",2020,0,0,91,91
"39352",2015,0,21,0,21
"39352",2020,0,0,91,91
"39353",2015,0,21,0,21
"39353",2020,0,0,91,91
"39354",2015,0,21,0,21
"39354",2020,0,0,91,91
"39355",2015,0,21,0,21
"39355",2020,0,0,91,91
"39356",2015,0,21,0,21
"39356",2020,0,0,91,91
"39359",2015,0,21,0,21
"39359",2020,0,0,91,91
"39360",2015,0,21,0,21
"39360",2020,0,0,91,91
"39361",2015,0,21,0,21
"39361",2020,0,0,91,91
"39362",2015,0,21,0,21
"39362",2020,0,0,91,91
"39363",2015,0,21,0,21
"39363",2020,0,0,91,91
"39364",2015,0,21,0,21
"39364",2020,0,0,91,91
"39365",2015,0,21,0,21
"39365",2020,0,0,91,91
"39366",2015,0,21,0,21
"39366",2020,0,0,91,91
"39367",2015,0,21,0,21
"39367",2020,0,0,91,91
"39368",2015,0,21,0,21
"39368",2020,0,0,91,91
"39370",2015,0,21,0,21
"39370",2020,0,0,91,91
"39372",2015,0,21,0,21
"39372",2020,0,0,91,91
"39373",2015,0,21,0,21
"39373",2020,0,0,91,91
"39375",2015,0,21,0,21
"39375",2020,0,0,91,91
"39376",2015,0,21,0,21
"39376",2020,0,0,91,91
"39377",2015,0,21,0,21
"39377",2020,0,0,91,91
"39378",2015,0,21,0,21
"39378",2020,0,0,91,91
"39379",2015,0,21,0,21
"39379",2020,0,0,91,91
"39380",2015,0,21,0,21
"39380",2020,0,0,91,91
"39381",2015,0,21,0,21
"39381",2020,0,0,91,91
"39385",2015,0,21,0,21
"39385",2020,0,0,91,91
"39386",2015,0,21,0,21
"39386",2020,0,0,91,91
"39387",2015,0,21,0,21
"39387",2020,0,0,91,91
"39388",2015,0,21,0,21
"39388",2020,0,0,91,91
"39389",2015,0,21,0,21
"39389",2020,0,0,91,91
"39390",2015,0,21,0,21
"39390",2020,0,0,91,91
"39391",2015,0,21,0,21
"39391",2020,0,0,91,91
"39392",2015,0,21,0,21
"39392",2020,0,0,91,91
"39393",2015,0,21,0,21
"39393",2020,0,0,91,91
"39394",2015,0,21,0,21
"39394",2020,0,0,91,91
"39396",2015,0,21,0,21
"39396",2020,0,0,91,91
"39397",2015,0,21,0,21
"39397",2020,0,0,91,91
"39398",2015,0,21,0,21
"39398",2020,0,0,91,91
"39399",2015,0,21,0,21
"39399",2020,0,0,91,91
"39400",2015,0,21,0,21
"39400",2020,0,0,91,91
"39401",2015,0,21,0,21
"39401",2020,0,0,91,91
"39402",2015,0,21,0,21
"39402",2020,0,0,91,91
"39403",2015,0,21,0,21
"39403",2020,0,0,91,91
"39404",2015,0,21,0,21
"39404",2020,0,0,91,91
"39405",2015,0,21,0,21
"39405",2020,0,0,91,91
"39406",2015,0,21,0,21
"39406",2020,0,0,91,91
"39407",2015,0,21,0,21
"39407",2020,0,0,91,91
"39408",2015,0,21,0,21
"39408",2020,0,0,91,91
"39409",2015,0,21,0,21
"39409",2020,0,0,91,91
"39411",2015,0,21,0,21
"39411",2020,0,0,91,91
"39412",2015,0,21,0,21
"39412",2020,0,0,91,91
"39413",2015,0,21,0,21
"39413",2020,0,0,91,91
"39415",2015,0,21,0,21
"39415",2020,0,0,91,91
"39418",2015,0,21,0,21
"39418",2020,0,0,91,91
"39419",2015,0,21,0,21
"39419",2020,0,0,91,91
"39420",2015,0,21,0,21
"39420",2020,0,0,91,91
"39421",2015,0,21,0,21
"39421",2020,0,0,91,91
"39422",2015,0,21,0,21
"39422",2020,0,0,91,91
"39423",2015,0,21,0,21
"39423",2020,0,0,91,91
"39424",2015,0,21,0,21
"39424",2020,0,0,91,91
"39425",2015,0,21,0,21
"39425",2020,0,0,91,91
"39426",2015,0,21,0,21
"39426",2020,0,0,91,91
"39427",2015,0,21,0,21
"39427",2020,0,0,91,91
"39428",2015,0,21,0,21
"39428",2020,0,0,91,91
"39429",2015,0,21,0,21
"39429",2020,0,0,91,91
"39430",2015,0,21,0,21
"39430",2020,0,0,91,91
"39431",2015,0,21,0,21
"39431",2020,0,0,91,91
"39432",2015,0,21,0,21
"39432",2020,0,0,91,91
"39434",2015,0,21,0,21
"39434",2020,0,0,91,91
"39435",2015,0,21,0,21
"39435",2020,0,0,91,91
"39436",2015,0,21,0,21
"39436",2020,0,0,91,91
"39437",2015,0,21,0,21
"39437",2020,0,0,91,91
"39439",2015,0,21,0,21
"39439",2020,0,0,91,91
"39441",2015,0,21,0,21
"39441",2020,0,0,91,91
"39443",2015,0,21,0,21
"39443",2020,0,0,91,91
"39444",2015,0,21,0,21
"39444",2020,0,0,91,91
"39445",2015,0,21,0,21
"39445",2020,0,0,91,91
"39446",2015,0,21,0,21
"39446",2020,0,0,91,91
"39447",2015,0,21,0,21
"39447",2020,0,0,91,91
"39448",2015,0,21,0,21
"39448",2020,0,0,91,91
"39449",2015,0,21,0,21
"39449",2020,0,0,91,91
"39451",2015,0,21,0,21
"39451",2020,0,0,91,91
"39452",2015,0,21,0,21
"39452",2020,0,0,91,91
"39453",2015,0,21,0,21
"39453",2020,0,0,91,91
"39454",2015,0,21,0,21
"39454",2020,0,0,91,91
"39455",2015,0,21,0,21
"39455",2020,0,0,91,91
"39456",2015,0,21,0,21
"39456",2020,0,0,91,91
"39457",2015,0,21,0,21
"39457",2020,0,0,91,91
"39458",2015,0,21,0,21
"39458",2020,0,0,91,91
"39460",2015,0,21,0,21
"39460",2020,0,0,91,91
"39461",2015,0,21,0,21
"39461",2020,0,0,91,91
"39462",2015,0,21,0,21
"39462",2020,0,0,91,91
"39463",2015,0,21,0,21
"39463",2020,0,0,91,91
"39464",2015,0,21,0,21
"39464",2020,0,0,91,91
"39465",2015,0,21,0,21
"39465",2020,0,0,91,91
"39466",2015,0,21,0,21
"39466",2020,0,0,91,91
"39467",2015,0,21,0,21
"39467",2020,0,0,91,91
"39468",2015,0,21,0,21
"39468",2020,0,0,91,91
"39469",2015,0,21,0,21
"39469",2020,0,0,91,91
"39470",2015,0,21,0,21
"39470",2020,0,0,91,91
"39471",2015,0,21,0,21
"39471",2020,0,0,91,91
"39472",2015,0,21,0,21
"39472",2020,0,0,91,91
"39473",2015,0,21,0,21
"39473",2020,0,0,91,91
"39474",2015,0,21,0,21
"39474",2020,0,0,91,91
"39475",2015,0,21,0,21
"39475",2020,0,0,91,91
"39476",2015,0,21,0,21
"39476",2020,0,0,91,91
"39477",2015,0,21,0,21
"39477",2020,0,0,91,91
"39478",2015,0,21,0,21
"39478",2020,0,0,91,91
"39479",2015,0,21,0,21
"39479",2020,0,0,91,91
"39480",2015,0,21,0,21
"39480",2020,0,0,91,91
"39481",2015,0,21,0,21
"39481",2020,0,0,91,91
"39485",2015,0,21,0,21
"39485",2020,0,0,91,91
"39486",2015,0,21,0,21
"39486",2020,0,0,91,91
"39487",2015,0,21,0,21
"39487",2020,0,0,91,91
"39489",2015,0,21,0,21
"39489",2020,0,0,91,91
"39490",2015,0,21,0,21
"39490",2020,0,0,91,91
"39491",2015,0,21,0,21
"39491",2020,0,0,91,91
"39492",2015,0,21,0,21
"39492",2020,0,0,91,91
"39493",2015,0,21,0,21
"39493",2020,0,0,91,91
"39494",2015,0,21,0,21
"39494",2020,0,0,91,91
"39495",2015,0,21,0,21
"39495",2020,0,0,91,91
"39497",2015,0,21,0,21
"39497",2020,0,0,91,91
"39498",2015,0,21,0,21
"39498",2020,0,0,91,91
"39499",2015,0,21,0,21
"39499",2020,0,0,91,91
"39500",2015,0,21,0,21
"39500",2020,0,0,91,91
"39501",2015,0,21,0,21
"39501",2020,0,0,91,91
"39502",2015,0,21,0,21
"39502",2020,0,0,91,91
"39503",2015,0,21,0,21
"39503",2020,0,0,91,91
"39504",2015,0,21,0,21
"39504",2020,0,0,91,91
"39505",2015,0,21,0,21
"39505",2020,0,0,91,91
"39507",2015,0,21,0,21
"39507",2020,0,0,91,91
"39508",2015,0,21,0,21
"39508",2020,0,0,91,91
"39510",2015,0,21,0,21
"39510",2020,0,0,91,91
"39511",2015,0,21,0,21
"39511",2020,0,0,91,91
"39512",2015,0,21,0,21
"39512",2020,0,0,91,91
"39513",2015,0,21,0,21
"39513",2020,0,0,91,91
"39514",2015,0,21,0,21
"39514",2020,0,0,91,91
"39517",2015,0,21,0,21
"39517",2020,0,0,91,91
"39518",2015,0,21,0,21
"39518",2020,0,0,91,91
"39519",2015,0,21,0,21
"39519",2020,0,0,91,91
"39520",2015,0,21,0,21
"39520",2020,0,0,91,91
"39522",2015,0,21,0,21
"39522",2020,0,0,91,91
"39523",2015,0,21,0,21
"39523",2020,0,0,91,91
"39525",2015,0,21,0,21
"39525",2020,0,0,91,91
"39526",2015,0,21,0,21
"39526",2020,0,0,91,91
"39527",2015,0,21,0,21
"39527",2020,0,0,91,91
"39528",2015,0,21,0,21
"39528",2020,0,0,91,91
"39529",2015,0,21,0,21
"39529",2020,0,0,91,91
"39530",2015,0,21,0,21
"39530",2020,0,0,91,91
"39531",2015,0,21,0,21
"39531",2020,0,0,91,91
"39532",2015,0,21,0,21
"39532",2020,0,0,91,91
"39533",2015,0,21,0,21
"39533",2020,0,0,91,91
"39534",2015,0,21,0,21
"39534",2020,0,0,91,91
"39535",2015,0,21,0,21
"39535",2020,0,0,91,91
"39537",2015,0,21,0,21
"39537",2020,0,0,91,91
"39538",2015,0,21,0,21
"39538",2020,0,0,91,91
"39539",2015,0,21,0,21
"39539",2020,0,0,91,91
"39540",2015,0,21,0,21
"39540",2020,0,0,91,91
"39543",2015,0,21,0,21
"39543",2020,0,0,91,91
"39545",2015,0,21,0,21
"39545",2020,0,0,91,91
"39546",2015,0,21,0,21
"39546",2020,0,0,91,91
"39547",2015,0,21,0,21
"39547",2020,0,0,91,91
"39548",2015,0,21,0,21
"39548",2020,0,0,91,91
"39550",2015,0,21,0,21
"39550",2020,0,0,91,91
"39551",2015,0,21,0,21
"39551",2020,0,0,91,91
"39552",2015,0,21,0,21
"39552",2020,0,0,91,91
"39553",2015,0,21,0,21
"39553",2020,0,0,91,91
"39554",2015,0,21,0,21
"39554",2020,0,0,91,91
"39555",2015,0,21,0,21
"39555",2020,0,0,91,91
"39556",2015,0,21,0,21
"39556",2020,0,0,91,91
"39557",2015,0,21,0,21
"39557",2020,0,0,91,91
"39558",2015,0,21,0,21
"39558",2020,0,0,91,91
"39559",2015,0,21,0,21
"39559",2020,0,0,91,91
"39560",2015,0,21,0,21
"39560",2020,0,0,91,91
"39561",2015,0,21,0,21
"39561",2020,0,0,91,91
"39565",2015,0,21,0,21
"39565",2020,0,0,91,91
"39567",2015,0,21,0,21
"39567",2020,0,0,91,91
"39568",2015,0,21,0,21
"39568",2020,0,0,91,91
"39569",2015,0,21,0,21
"39569",2020,0,0,91,91
"39570",2015,0,21,0,21
"39570",2020,0,0,91,91
"39571",2015,0,21,0,21
"39571",2020,0,0,91,91
"39572",2015,0,21,0,21
"39572",2020,0,0,91,91
"39573",2015,0,21,0,21
"39573",2020,0,0,91,91
"39574",2015,0,21,0,21
"39574",2020,0,0,91,91
"39575",2015,0,21,0,21
"39575",2020,0,0,91,91
"39576",2015,0,21,0,21
"39576",2020,0,0,91,91
"39577",2015,0,21,0,21
"39577",2020,0,0,91,91
"39579",2015,0,21,0,21
"39579",2020,0,0,91,91
"39581",2015,0,21,0,21
"39581",2020,0,0,91,91
"39582",2015,0,21,0,21
"39582",2020,0,0,91,91
"39583",2015,0,21,0,21
"39583",2020,0,0,91,91
"39584",2015,0,21,0,21
"39584",2020,0,0,91,91
"39585",2015,0,21,0,21
"39585",2020,0,0,91,91
"39586",2015,0,21,0,21
"39586",2020,0,0,91,91
"40001",2013,0,0,36,36
"40001",2015,0,0,85,85
"40001",2016,0,0,57,57
"40001",2017,0,0,68,68
"40001",2018,0,0,69,69
"40001",2019,0,0,105,105
"40001",2020,0,0,96,96
"40002",2015,0,0,77,77
"40002",2016,0,0,27,27
"40002",2017,0,0,58,58
"40002",2018,0,0,66,66
"40002",2019,0,0,59,59
"40002",2020,0,0,90,90
"40005",2013,0,0,36,36
"40005",2015,0,0,85,85
"40005",2016,0,0,57,57
"40005",2017,0,0,68,68
"40005",2018,0,0,69,69
"40005",2019,0,0,105,105
"40005",2020,0,0,96,96
"40006",2015,0,0,77,77
"40006",2016,0,0,49,49
"40006",2017,0,0,99,99
"40006",2019,0,0,98,98
"40006",2020,0,0,82,82
"40007",2015,0,0,77,77
"40007",2016,0,0,27,27
"40007",2017,0,0,58,58
"40007",2018,0,0,66,66
"40007",2019,0,0,59,59
"40007",2020,0,0,90,90
"40011",2015,0,0,77,77
"40011",2016,0,0,27,27
"40011",2017,0,0,58,58
"40011",2018,0,0,66,66
"40011",2019,0,0,59,59
"40011",2020,0,0,90,90
"40012",2013,0,0,27,27
"40012",2015,0,0,28,28
"40012",2016,0,0,15,15
"40012",2017,0,0,19,19
"40012",2018,0,0,31,31
"40012",2020,0,0,61,61
"40013",2013,0,0,41,41
"40013",2015,0,0,61,61
"40013",2016,0,0,15,15
"40013",2017,0,0,44,44
"40013",2018,0,0,51,51
"40013",2019,0,0,101,101
"40014",2015,0,0,75,75
"40014",2016,0,0,64,64
"40014",2017,0,0,79,79
"40014",2018,0,0,56,56
"40014",2019,0,0,101,101
"40016",2013,0,0,36,36
"40016",2015,0,0,85,85
"40016",2016,0,0,57,57
"40016",2017,0,0,68,68
"40016",2018,0,0,69,69
"40016",2019,0,0,105,105
"40016",2020,0,0,96,96
"40017",2013,0,0,36,36
"40017",2015,0,0,85,85
"40017",2016,0,0,57,57
"40017",2017,0,0,68,68
"40017",2018,0,0,69,69
"40017",2019,0,0,105,105
"40017",2020,0,0,96,96
"40018",2013,0,0,36,36
"40018",2015,0,0,85,85
"40018",2016,0,0,57,57
"40018",2017,0,0,68,68
"40018",2018,0,0,69,69
"40018",2019,0,0,105,105
"40018",2020,0,0,96,96
"40020",2013,0,0,36,36
"40020",2015,0,0,85,85
"40020",2016,0,0,57,57
"40020",2017,0,0,68,68
"40020",2018,0,0,69,69
"40020",2019,0,0,105,105
"40020",2020,0,0,96,96
"40022",2013,0,0,36,36
"40022",2015,0,0,85,85
"40022",2016,0,0,57,57
"40022",2017,0,0,68,68
"40022",2018,0,0,69,69
"40022",2019,0,0,105,105
"40022",2020,0,0,96,96
"40023",2015,0,0,77,77
"40023",2016,0,0,27,27
"40023",2017,0,0,99,99
"40023",2018,0,0,66,66
"40023",2019,0,0,59,59
"40023",2020,0,0,90,90
"40024",2013,0,0,36,36
"40024",2015,0,0,85,85
"40024",2016,0,0,57,57
"40024",2017,0,0,68,68
"40024",2018,0,0,69,69
"40024",2019,0,0,105,105
"40024",2020,0,0,96,96
"40025",2013,0,0,41,41
"40025",2015,0,0,57,57
"40025",2016,0,0,15,15
"40025",2017,0,0,42,42
"40025",2018,0,0,51,51
"40025",2019,0,0,105,105
"40025",2020,0,0,96,96
"40026",2013,0,0,36,36
"40026",2015,0,0,85,85
"40026",2016,0,0,57,57
"40026",2017,0,0,68,68
"40026",2018,0,0,69,69
"40026",2019,0,0,105,105
"40026",2020,0,0,96,96
"40027",2015,0,0,77,77
"40027",2016,0,0,27,27
"40027",2017,0,0,58,58
"40027",2018,0,0,66,66
"40027",2019,0,0,59,59
"40027",2020,0,0,90,90
"40028",2015,0,0,77,77
"40028",2016,0,0,27,27
"40028",2017,0,0,58,58
"40028",2018,0,0,66,66
"40028",2019,0,0,59,59
"40028",2020,0,0,90,90
"40029",2013,0,0,36,36
"40029",2015,0,0,85,85
"40029",2016,0,0,57,57
"40029",2017,0,0,68,68
"40029",2018,0,0,69,69
"40029",2019,0,0,105,105
"40029",2020,0,0,96,96
"40031",2015,0,0,77,77
"40031",2016,0,0,49,49
"40031",2017,0,0,99,99
"40031",2019,0,0,98,98
"40031",2020,0,0,82,82
"40033",2015,0,0,75,75
"40033",2016,0,0,64,64
"40033",2017,0,0,79,79
"40033",2018,0,0,56,56
"40033",2019,0,0,101,101
"40035",2015,0,0,77,77
"40035",2016,0,0,27,27
"40035",2017,0,0,58,58
"40035",2018,0,0,66,66
"40035",2019,0,0,59,59
"40035",2020,0,0,90,90
"40037",2013,0,0,36,36
"40037",2015,0,0,85,85
"40037",2016,0,0,57,57
"40037",2017,0,0,68,68
"40037",2018,0,0,69,69
"40037",2019,0,0,105,105
"40037",2020,0,0,96,96
"40038",2015,0,0,77,77
"40038",2016,0,0,27,27
"40038",2017,0,0,99,99
"40038",2018,0,0,66,66
"40038",2019,0,0,59,59
"40038",2020,0,0,90,90
"40039",2015,0,0,75,75
"40039",2016,0,0,64,64
"40039",2017,0,0,79,79
"40039",2018,0,0,56,56
"40039",2019,0,0,101,101
"40040",2015,0,0,77,77
"40040",2016,0,0,49,49
"40040",2017,0,0,99,99
"40040",2019,0,0,98,98
"40040",2020,0,0,82,82
"40041",2015,0,0,77,77
"40041",2016,0,0,27,27
"40041",2017,0,0,58,58
"40041",2018,0,0,66,66
"40041",2019,0,0,59,59
"40041",2020,0,0,90,90
"40047",2015,0,0,77,77
"40047",2016,0,0,27,27
"40047",2017,0,0,58,58
"40047",2018,0,0,66,66
"40047",2019,0,0,59,59
"40047",2020,0,0,90,90
"40049",2013,0,0,36,36
"40049",2015,0,0,85,85
"40049",2016,0,0,57,57
"40049",2017,0,0,68,68
"40049",2018,0,0,69,69
"40049",2019,0,0,105,105
"40049",2020,0,0,96,96
"40050",2013,0,0,41,41
"40050",2015,0,0,61,61
"40050",2016,0,0,15,15
"40050",2017,0,0,44,44
"40050",2018,0,0,51,51
"40050",2019,0,0,101,101
"40051",2013,0,0,27,27
"40051",2015,0,0,29,29
"40051",2016,0,0,15,15
"40051",2017,0,0,19,19
"40051",2018,0,0,31,31
"40052",2013,0,0,27,27
"40052",2015,0,0,29,29
"40052",2016,0,0,15,15
"40052",2017,0,0,19,19
"40052",2018,0,0,31,31
"40053",2015,0,0,75,75
"40053",2016,0,0,64,64
"40053",2017,0,0,79,79
"40053",2018,0,0,56,56
"40053",2019,0,0,101,101
"40054",2015,0,0,77,77
"40054",2016,0,0,27,27
"40054",2017,0,0,99,99
"40054",2018,0,0,66,66
"40054",2019,0,0,59,59
"40054",2020,0,0,90,90
"40055",2013,0,0,41,41
"40055",2015,0,0,57,57
"40055",2016,0,0,15,15
"40055",2017,0,0,42,42
"40055",2018,0,0,51,51
"40055",2019,0,0,105,105
"40055",2020,0,0,96,96
"40056",2015,0,0,75,75
"40056",2016,0,0,64,64
"40056",2017,0,0,79,79
"40056",2018,0,0,56,56
"40056",2019,0,0,101,101
"40057",2013,0,0,36,36
"40057",2015,0,0,85,85
"40057",2016,0,0,57,57
"40057",2017,0,0,68,68
"40057",2018,0,0,69,69
"40057",2019,0,0,105,105
"40057",2020,0,0,96,96
"40058",2015,0,0,75,75
"40058",2016,0,0,64,64
"40058",2017,0,0,79,79
"40058",2018,0,0,56,56
"40058",2019,0,0,101,101
"40059",2015,0,0,77,77
"40059",2016,0,0,27,27
"40059",2017,0,0,58,58
"40059",2018,0,0,66,66
"40059",2019,0,0,59,59
"40059",2020,0,0,90,90
"40061",2013,0,0,36,36
"40061",2015,0,0,85,85
"40061",2016,0,0,57,57
"40061",2017,0,0,67,67
"40061",2018,0,0,69,69
"40061",2019,0,0,105,105
"40061",2020,0,0,96,96
"40062",2015,0,0,75,75
"40062",2016,0,0,64,64
"40062",2017,0,0,79,79
"40062",2018,0,0,56,56
"40062",2019,0,0,101,101
"40063",2015,0,0,77,77
"40063",2016,0,0,27,27
"40063",2017,0,0,99,99
"40063",2018,0,0,66,66
"40063",2019,0,0,59,59
"40063",2020,0,0,90,90
"40064",2015,0,0,75,75
"40064",2016,0,0,64,64
"40064",2017,0,0,79,79
"40064",2018,0,0,56,56
"40064",2019,0,0,101,101
"40066",2015,0,0,77,77
"40066",2016,0,0,49,49
"40066",2017,0,0,99,99
"40066",2019,0,0,98,98
"40066",2020,0,0,82,82
"40067",2015,0,0,77,77
"40067",2016,0,0,49,49
"40067",2017,0,0,99,99
"40067",2019,0,0,98,98
"40067",2020,0,0,82,82
"40068",2015,0,0,77,77
"40068",2016,0,0,49,49
"40068",2017,0,0,99,99
"40068",2020,0,0,82,82
"40069",2015,0,0,77,77
"40069",2016,0,0,27,27
"40069",2017,0,0,58,58
"40069",2018,0,0,66,66
"40069",2019,0,0,59,59
"40069",2020,0,0,90,90
"40070",2013,0,0,27,27
"40070",2015,0,0,28,28
"40070",2016,0,0,16,16
"40070",2017,0,0,19,19
"40070",2018,0,0,31,31
"40070",2020,0,0,61,61
"40071",2015,0,0,77,77
"40071",2016,0,0,27,27
"40071",2017,0,0,58,58
"40071",2018,0,0,66,66
"40071",2019,0,0,59,59
"40071",2020,0,0,90,90
"40072",2013,0,0,36,36
"40072",2015,0,0,85,85
"40072",2016,0,0,57,57
"40072",2017,0,0,68,68
"40072",2018,0,0,69,69
"40072",2019,0,0,105,105
"40072",2020,0,0,96,96
"40073",2015,0,0,77,77
"40073",2016,0,0,27,27
"40073",2017,0,0,58,58
"40073",2018,0,0,66,66
"40073",2019,0,0,59,59
"40073",2020,0,0,90,90
"40074",2015,0,0,77,77
"40074",2016,0,0,27,27
"40074",2017,0,0,58,58
"40074",2018,0,0,66,66
"40074",2019,0,0,59,59
"40074",2020,0,0,90,90
"40076",2013,0,0,36,36
"40076",2015,0,0,85,85
"40076",2016,0,0,57,57
"40076",2017,0,0,68,68
"40076",2018,0,0,69,69
"40076",2019,0,0,105,105
"40076",2020,0,0,96,96
"40077",2015,0,0,77,77
"40077",2016,0,0,27,27
"40077",2017,0,0,58,58
"40077",2018,0,0,66,66
"40077",2019,0,0,59,59
"40077",2020,0,0,90,90
"40078",2015,0,0,77,77
"40078",2016,0,0,27,27
"40078",2017,0,0,99,99
"40078",2018,0,0,66,66
"40078",2019,0,0,59,59
"40078",2020,0,0,90,90
"40079",2015,0,0,77,77
"40079",2016,0,0,27,27
"40079",2017,0,0,99,99
"40079",2018,0,0,66,66
"40079",2019,0,0,59,59
"40079",2020,0,0,90,90
"40080",2013,0,0,36,36
"40080",2015,0,0,85,85
"40080",2016,0,0,57,57
"40080",2017,0,0,68,68
"40080",2018,0,0,69,69
"40080",2019,0,0,105,105
"40080",2020,0,0,96,96
"40081",2015,0,0,75,75
"40081",2016,0,0,64,64
"40081",2017,0,0,79,79
"40081",2018,0,0,56,56
"40081",2019,0,0,101,101
"40082",2013,0,0,36,36
"40082",2015,0,0,85,85
"40082",2016,0,0,57,57
"40082",2017,0,0,68,68
"40082",2018,0,0,69,69
"40082",2019,0,0,105,105
"40082",2020,0,0,96,96
"40083",2013,0,0,36,36
"40083",2015,0,0,85,85
"40083",2016,0,0,57,57
"40083",2017,0,0,68,68
"40083",2018,0,0,69,69
"40083",2019,0,0,105,105
"40083",2020,0,0,96,96
"40084",2015,0,0,77,77
"40084",2016,0,0,27,27
"40084",2017,0,0,58,58
"40084",2018,0,0,66,66
"40084",2019,0,0,59,59
"40084",2020,0,0,90,90
"40086",2013,0,0,36,36
"40086",2015,0,0,85,85
"40086",2016,0,0,57,57
"40086",2017,0,0,68,68
"40086",2018,0,0,69,69
"40086",2019,0,0,105,105
"40086",2020,0,0,96,96
"40087",2015,0,0,75,75
"40087",2016,0,0,64,64
"40087",2017,0,0,79,79
"40087",2018,0,0,56,56
"40087",2019,0,0,101,101
"40088",2015,0,0,77,77
"40088",2016,0,0,27,27
"40088",2017,0,0,58,58
"40088",2018,0,0,66,66
"40088",2019,0,0,59,59
"40088",2020,0,0,90,90
"40089",2013,0,0,36,36
"40089",2015,0,0,85,85
"40089",2016,0,0,57,57
"40089",2017,0,0,68,68
"40089",2018,0,0,69,69
"40089",2019,0,0,105,105
"40089",2020,0,0,96,96
"40090",2015,0,0,77,77
"40090",2016,0,0,27,27
"40090",2017,0,0,58,58
"40090",2018,0,0,66,66
"40090",2019,0,0,59,59
"40090",2020,0,0,90,90
"40091",2013,0,0,36,36
"40091",2015,0,0,85,85
"40091",2016,0,0,57,57
"40091",2017,0,0,68,68
"40091",2018,0,0,69,69
"40091",2019,0,0,105,105
"40091",2020,0,0,96,96
"40092",2013,0,0,36,36
"40092",2015,0,0,85,85
"40092",2016,0,0,57,57
"40092",2017,0,0,68,68
"40092",2018,0,0,69,69
"40092",2019,0,0,105,105
"40092",2020,0,0,96,96
"40095",2015,0,0,77,77
"40095",2016,0,0,27,27
"40095",2017,0,0,58,58
"40095",2018,0,0,66,66
"40095",2019,0,0,59,59
"40095",2020,0,0,90,90
"40096",2015,0,0,75,75
"40096",2016,0,0,64,64
"40096",2017,0,0,79,79
"40096",2018,0,0,56,56
"40096",2019,0,0,101,101
"40097",2013,0,0,36,36
"40097",2015,0,0,85,85
"40097",2016,0,0,57,57
"40097",2017,0,0,68,68
"40097",2018,0,0,69,69
"40097",2019,0,0,105,105
"40097",2020,0,0,96,96
"40098",2013,0,0,36,36
"40098",2015,0,0,85,85
"40098",2016,0,0,57,57
"40098",2017,0,0,68,68
"40098",2018,0,0,69,69
"40098",2019,0,0,105,105
"40098",2020,0,0,96,96
"40099",2013,0,0,36,36
"40099",2015,0,0,85,85
"40099",2016,0,0,57,57
"40099",2017,0,0,68,68
"40099",2018,0,0,69,69
"40099",2019,0,0,105,105
"40099",2020,0,0,96,96
"40100",2013,0,0,41,41
"40100",2015,0,0,61,61
"40100",2016,0,0,15,15
"40100",2017,0,0,44,44
"40100",2018,0,0,51,51
"40100",2019,0,0,101,101
"40101",2015,0,0,77,77
"40101",2016,0,0,27,27
"40101",2017,0,0,58,58
"40101",2018,0,0,66,66
"40101",2019,0,0,59,59
"40101",2020,0,0,90,90
"40102",2015,0,0,75,75
"40102",2016,0,0,64,64
"40102",2017,0,0,79,79
"40102",2018,0,0,56,56
"40102",2019,0,0,101,101
"40103",2013,0,0,41,41
"40103",2015,0,0,61,61
"40103",2016,0,0,15,15
"40103",2017,0,0,44,44
"40103",2018,0,0,51,51
"40103",2019,0,0,101,101
"40104",2015,0,0,77,77
"40104",2016,0,0,27,27
"40104",2017,0,0,99,99
"40104",2018,0,0,66,66
"40104",2019,0,0,59,59
"40104",2020,0,0,90,90
"40105",2015,0,0,75,75
"40105",2016,0,0,64,64
"40105",2017,0,0,79,79
"40105",2018,0,0,56,56
"40105",2019,0,0,101,101
"40106",2015,0,0,77,77
"40106",2016,0,0,27,27
"40106",2017,0,0,58,58
"40106",2018,0,0,66,66
"40106",2019,0,0,59,59
"40106",2020,0,0,90,90
"40109",2015,0,0,77,77
"40109",2016,0,0,27,27
"40109",2017,0,0,99,99
"40109",2018,0,0,66,66
"40109",2019,0,0,59,59
"40109",2020,0,0,90,90
"40110",2013,0,0,36,36
"40110",2015,0,0,85,85
"40110",2016,0,0,57,57
"40110",2017,0,0,68,68
"40110",2018,0,0,69,69
"40110",2019,0,0,105,105
"40110",2020,0,0,96,96
"40111",2015,0,0,77,77
"40111",2016,0,0,64,64
"40111",2017,0,0,79,79
"40111",2018,0,0,56,56
"40111",2019,0,0,101,101
"40111",2020,0,0,82,82
"40112",2015,0,0,77,77
"40112",2016,0,0,27,27
"40112",2017,0,0,58,58
"40112",2018,0,0,66,66
"40112",2019,0,0,59,59
"40112",2020,0,0,90,90
"40113",2015,0,0,77,77
"40113",2016,0,0,49,49
"40113",2017,0,0,99,99
"40113",2019,0,0,98,98
"40113",2020,0,0,82,82
"40114",2015,0,0,77,77
"40114",2016,0,0,49,49
"40114",2017,0,0,99,99
"40114",2019,0,0,98,98
"40114",2020,0,0,82,82
"40115",2015,0,0,77,77
"40115",2016,0,0,49,49
"40115",2017,0,0,99,99
"40115",2019,0,0,98,98
"40115",2020,0,0,82,82
"40116",2013,0,0,36,36
"40116",2015,0,0,85,85
"40116",2016,0,0,57,57
"40116",2017,0,0,68,68
"40116",2018,0,0,69,69
"40116",2019,0,0,105,105
"40116",2020,0,0,96,96
"40117",2013,0,0,36,36
"40117",2015,0,0,85,85
"40117",2016,0,0,57,57
"40117",2017,0,0,68,68
"40117",2018,0,0,69,69
"40117",2019,0,0,105,105
"40117",2020,0,0,96,96
"40118",2015,0,0,77,77
"40118",2016,0,0,27,27
"40118",2017,0,0,58,58
"40118",2018,0,0,66,66
"40118",2019,0,0,59,59
"40118",2020,0,0,90,90
"40119",2013,0,0,36,36
"40119",2015,0,0,85,85
"40119",2016,0,0,57,57
"40119",2017,0,0,68,68
"40119",2018,0,0,69,69
"40119",2019,0,0,105,105
"40119",2020,0,0,96,96
"40121",2013,0,0,36,36
"40121",2015,0,0,85,85
"40121",2016,0,0,57,57
"40121",2017,0,0,68,68
"40121",2018,0,0,69,69
"40121",2019,0,0,105,105
"40121",2020,0,0,96,96
"40122",2013,0,0,36,36
"40122",2015,0,0,85,85
"40122",2016,0,0,57,57
"40122",2017,0,0,68,68
"40122",2018,0,0,69,69
"40122",2019,0,0,105,105
"40122",2020,0,0,96,96
"40124",2015,0,0,75,75
"40124",2016,0,0,64,64
"40124",2017,0,0,79,79
"40124",2018,0,0,56,56
"40124",2019,0,0,101,101
"40125",2015,0,0,77,77
"40125",2016,0,0,27,27
"40125",2017,0,0,58,58
"40125",2018,0,0,66,66
"40125",2019,0,0,59,59
"40125",2020,0,0,90,90
"40126",2015,0,0,77,77
"40126",2016,0,0,27,27
"40126",2017,0,0,99,99
"40126",2018,0,0,66,66
"40126",2019,0,0,94,94
"40126",2020,0,0,90,90
"40127",2013,0,0,27,27
"40127",2015,0,0,28,28
"40127",2016,0,0,15,15
"40127",2017,0,0,19,19
"40127",2018,0,0,31,31
"40127",2020,0,0,61,61
"40128",2013,0,0,36,36
"40128",2015,0,0,85,85
"40128",2016,0,0,57,57
"40128",2017,0,0,68,68
"40128",2018,0,0,69,69
"40128",2019,0,0,105,105
"40128",2020,0,0,96,96
"40130",2015,0,0,77,77
"40130",2016,0,0,27,27
"40130",2017,0,0,99,99
"40130",2018,0,0,66,66
"40130",2019,0,0,59,59
"40130",2020,0,0,90,90
"40131",2013,0,0,41,41
"40131",2015,0,0,61,61
"40131",2016,0,0,15,15
"40131",2017,0,0,44,44
"40131",2018,0,0,51,51
"40131",2019,0,0,101,101
"40132",2015,0,0,77,77
"40132",2016,0,0,27,27
"40132",2017,0,0,58,58
"40132",2018,0,0,66,66
"40132",2019,0,0,59,59
"40132",2020,0,0,90,90
"40135",2015,0,0,75,75
"40135",2016,0,0,64,64
"40135",2017,0,0,79,79
"40135",2018,0,0,56,56
"40135",2019,0,0,101,101
"40136",2013,0,0,36,36
"40136",2015,0,0,85,85
"40136",2016,0,0,57,57
"40136",2017,0,0,68,68
"40136",2018,0,0,69,69
"40136",2019,0,0,105,105
"40136",2020,0,0,96,96
"40137",2013,0,0,41,41
"40137",2015,0,0,61,61
"40137",2016,0,0,15,15
"40137",2017,0,0,44,44
"40137",2018,0,0,51,51
"40137",2019,0,0,101,101
"40138",2015,0,0,77,77
"40138",2016,0,0,27,27
"40138",2017,0,0,99,99
"40138",2018,0,0,66,66
"40138",2019,0,0,59,59
"40138",2020,0,0,90,90
"40139",2013,0,0,27,27
"40139",2015,0,0,28,28
"40139",2016,0,0,15,15
"40139",2017,0,0,19,19
"40139",2018,0,0,31,31
"40139",2020,0,0,61,61
"40140",2015,0,0,75,75
"40140",2016,0,0,64,64
"40140",2017,0,0,79,79
"40140",2018,0,0,56,56
"40140",2019,0,0,101,101
"40141",2015,0,0,77,77
"40141",2016,0,0,27,27
"40141",2017,0,0,99,99
"40141",2018,0,0,66,66
"40141",2019,0,0,59,59
"40141",2020,0,0,90,90
"40142",2015,0,0,77,77
"40142",2016,0,0,49,49
"40142",2017,0,0,99,99
"40142",2019,0,0,98,98
"40142",2020,0,0,82,82
"40143",2013,0,0,36,36
"40143",2015,0,0,85,85
"40143",2016,0,0,57,57
"40143",2017,0,0,68,68
"40143",2018,0,0,69,69
"40143",2019,0,0,105,105
"40143",2020,0,0,96,96
"40144",2015,0,0,77,77
"40144",2016,0,0,49,49
"40144",2017,0,0,99,99
"40144",2020,0,0,82,82
"40145",2013,0,0,36,36
"40145",2015,0,0,85,85
"40145",2016,0,0,57,57
"40145",2017,0,0,68,68
"40145",2018,0,0,69,69
"40145",2019,0,0,105,105
"40145",2020,0,0,96,96
"40146",2013,0,0,36,36
"40146",2015,0,0,85,85
"40146",2016,0,0,57,57
"40146",2017,0,0,68,68
"40146",2018,0,0,69,69
"40146",2019,0,0,105,105
"40146",2020,0,0,96,96
"40147",2013,0,0,36,36
"40147",2015,0,0,85,85
"40147",2016,0,0,57,57
"40147",2017,0,0,68,68
"40147",2018,0,0,69,69
"40147",2019,0,0,105,105
"40147",2020,0,0,96,96
"40148",2013,0,0,36,36
"40148",2015,0,0,85,85
"40148",2016,0,0,57,57
"40148",2017,0,0,68,68
"40148",2018,0,0,69,69
"40148",2019,0,0,105,105
"40148",2020,0,0,96,96
"40149",2015,0,0,75,75
"40149",2016,0,0,64,64
"40149",2017,0,0,79,79
"40149",2018,0,0,56,56
"40149",2019,0,0,101,101
"40151",2015,0,0,77,77
"40151",2016,0,0,49,49
"40151",2017,0,0,99,99
"40151",2019,0,0,98,98
"40151",2020,0,0,82,82
"40152",2015,0,0,77,77
"40152",2016,0,0,49,49
"40152",2017,0,0,99,99
"40152",2019,0,0,98,98
"40152",2020,0,0,82,82
"40153",2013,0,0,36,36
"40153",2015,0,0,85,85
"40153",2016,0,0,57,57
"40153",2017,0,0,68,68
"40153",2018,0,0,69,69
"40153",2019,0,0,105,105
"40153",2020,0,0,96,96
"40158",2015,0,0,75,75
"40158",2016,0,0,64,64
"40158",2017,0,0,79,79
"40158",2018,0,0,56,56
"40158",2019,0,0,101,101
"40159",2015,0,0,77,77
"40159",2016,0,0,49,49
"40159",2017,0,0,99,99
"40159",2020,0,0,82,82
"40160",2015,0,0,77,77
"40160",2016,0,0,49,49
"40160",2017,0,0,99,99
"40160",2020,0,0,82,82
"40161",2015,0,0,75,75
"40161",2016,0,0,64,64
"40161",2017,0,0,79,79
"40161",2018,0,0,56,56
"40161",2019,0,0,101,101
"40162",2015,0,0,75,75
"40162",2016,0,0,64,64
"40162",2017,0,0,79,79
"40162",2018,0,0,56,56
"40162",2019,0,0,101,101
"40164",2015,0,0,75,75
"40164",2016,0,0,64,64
"40164",2017,0,0,79,79
"40164",2018,0,0,56,56
"40164",2019,0,0,101,101
"40165",2015,0,0,77,77
"40165",2016,0,0,64,64
"40165",2017,0,0,79,79
"40165",2018,0,0,56,56
"40165",2019,0,0,101,101
"40165",2020,0,0,82,82
"40166",2013,0,0,27,27
"40166",2015,0,0,28,28
"40166",2016,0,0,16,16
"40166",2017,0,0,19,19
"40166",2018,0,0,31,31
"40166",2020,0,0,61,61
"40167",2015,0,0,75,75
"40167",2016,0,0,64,64
"40167",2017,0,0,79,79
"40167",2018,0,0,56,56
"40167",2019,0,0,101,101
"40169",2015,0,0,75,75
"40169",2016,0,0,64,64
"40169",2017,0,0,79,79
"40169",2018,0,0,56,56
"40169",2019,0,0,101,101
"40170",2015,0,0,75,75
"40170",2016,0,0,64,64
"40170",2017,0,0,79,79
"40170",2018,0,0,56,56
"40170",2019,0,0,101,101
"40172",2015,0,0,77,77
"40172",2016,0,0,27,27
"40172",2017,0,0,58,58
"40172",2018,0,0,66,66
"40172",2019,0,0,59,59
"40172",2020,0,0,90,90
"40173",2015,0,0,77,77
"40173",2016,0,0,27,27
"40173",2017,0,0,58,58
"40173",2018,0,0,66,66
"40173",2019,0,0,59,59
"40173",2020,0,0,90,90
"40174",2013,0,0,36,36
"40174",2015,0,0,85,85
"40174",2016,0,0,57,57
"40174",2017,0,0,68,68
"40174",2018,0,0,69,69
"40174",2019,0,0,105,105
"40174",2020,0,0,96,96
"40175",2013,0,0,27,27
"40175",2015,0,0,28,28
"40175",2016,0,0,16,16
"40175",2017,0,0,19,19
"40175",2018,0,0,31,31
"40175",2020,0,0,61,61
"40176",2015,0,0,75,75
"40176",2016,0,0,64,64
"40176",2017,0,0,79,79
"40176",2018,0,0,56,56
"40176",2019,0,0,101,101
"40177",2015,0,0,77,77
"40177",2016,0,0,49,49
"40177",2017,0,0,99,99
"40177",2020,0,0,82,82
"40178",2013,0,0,41,41
"40178",2015,0,0,57,57
"40178",2016,0,0,15,15
"40178",2017,0,0,42,42
"40178",2018,0,0,51,51
"40178",2019,0,0,105,105
"40178",2020,0,0,96,96
"40180",2013,0,0,36,36
"40180",2015,0,0,85,85
"40180",2016,0,0,57,57
"40180",2017,0,0,68,68
"40180",2018,0,0,69,69
"40180",2019,0,0,105,105
"40180",2020,0,0,96,96
"40183",2015,0,0,77,77
"40183",2016,0,0,27,27
"40183",2017,0,0,58,58
"40183",2018,0,0,66,66
"40183",2019,0,0,59,59
"40183",2020,0,0,90,90
"40185",2013,0,0,36,36
"40185",2015,0,0,85,85
"40185",2016,0,0,57,57
"40185",2017,0,0,68,68
"40185",2018,0,0,69,69
"40185",2019,0,0,105,105
"40185",2020,0,0,96,96
"40186",2015,0,0,77,77
"40186",2016,0,0,27,27
"40186",2017,0,0,58,58
"40186",2018,0,0,66,66
"40186",2019,0,0,59,59
"40186",2020,0,0,90,90
"40188",2015,0,0,77,77
"40188",2016,0,0,27,27
"40188",2017,0,0,99,99
"40188",2018,0,0,66,66
"40188",2019,0,0,59,59
"40188",2020,0,0,90,90
"40189",2015,0,0,77,77
"40189",2016,0,0,27,27
"40189",2017,0,0,58,58
"40189",2018,0,0,66,66
"40189",2019,0,0,59,59
"40189",2020,0,0,90,90
"40190",2015,0,0,77,77
"40190",2016,0,0,27,27
"40190",2017,0,0,99,99
"40190",2018,0,0,66,66
"40190",2019,0,0,59,59
"40190",2020,0,0,90,90
"40191",2013,0,0,36,36
"40191",2015,0,0,85,85
"40191",2016,0,0,57,57
"40191",2017,0,0,68,68
"40191",2018,0,0,69,69
"40191",2019,0,0,105,105
"40191",2020,0,0,96,96
"40192",2013,0,0,41,41
"40192",2015,0,0,57,57
"40192",2016,0,0,15,15
"40192",2017,0,0,42,42
"40192",2018,0,0,51,51
"40192",2019,0,0,105,105
"40192",2020,0,0,96,96
"40193",2013,0,0,41,41
"40193",2015,0,0,61,61
"40193",2016,0,0,15,15
"40193",2017,0,0,44,44
"40193",2018,0,0,51,51
"40193",2019,0,0,101,101
"40194",2015,0,0,77,77
"40194",2016,0,0,27,27
"40194",2017,0,0,99,99
"40194",2018,0,0,66,66
"40194",2019,0,0,59,59
"40194",2020,0,0,90,90
"40195",2013,0,0,36,36
"40195",2015,0,0,85,85
"40195",2016,0,0,57,57
"40195",2017,0,0,68,68
"40195",2018,0,0,69,69
"40195",2019,0,0,105,105
"40195",2020,0,0,96,96
"40196",2013,0,0,36,36
"40196",2015,0,0,85,85
"40196",2016,0,0,57,57
"40196",2017,0,0,68,68
"40196",2018,0,0,69,69
"40196",2019,0,0,105,105
"40196",2020,0,0,96,96
"40197",2015,0,0,77,77
"40197",2016,0,0,49,49
"40197",2017,0,0,99,99
"40197",2019,0,0,98,98
"40197",2020,0,0,82,82
"40198",2015,0,0,77,77
"40198",2016,0,0,27,27
"40198",2017,0,0,99,99
"40198",2018,0,0,66,66
"40198",2019,0,0,59,59
"40198",2020,0,0,90,90
"40199",2015,0,0,77,77
"40199",2016,0,0,27,27
"40199",2017,0,0,58,58
"40199",2018,0,0,66,66
"40199",2019,0,0,59,59
"40199",2020,0,0,90,90
"40201",2013,0,0,36,36
"40201",2015,0,0,85,85
"40201",2016,0,0,57,57
"40201",2017,0,0,68,68
"40201",2018,0,0,69,69
"40201",2019,0,0,105,105
"40201",2020,0,0,96,96
"40202",2015,0,0,77,77
"40202",2016,0,0,27,27
"40202",2017,0,0,58,58
"40202",2018,0,0,66,66
"40202",2019,0,0,59,59
"40202",2020,0,0,90,90
"40203",2015,0,0,77,77
"40203",2016,0,0,27,27
"40203",2017,0,0,58,58
"40203",2018,0,0,66,66
"40203",2019,0,0,59,59
"40203",2020,0,0,90,90
"40204",2013,0,0,36,36
"40204",2015,0,0,85,85
"40204",2016,0,0,57,57
"40204",2017,0,0,68,68
"40204",2018,0,0,69,69
"40204",2019,0,0,105,105
"40204",2020,0,0,96,96
"40205",2015,0,0,77,77
"40205",2016,0,0,27,27
"40205",2017,0,0,99,99
"40205",2018,0,0,66,66
"40205",2019,0,0,59,59
"40205",2020,0,0,90,90
"40208",2013,0,0,36,36
"40208",2015,0,0,85,85
"40208",2016,0,0,57,57
"40208",2017,0,0,68,68
"40208",2018,0,0,69,69
"40208",2019,0,0,105,105
"40208",2020,0,0,96,96
"40210",2015,0,0,77,77
"40210",2016,0,0,49,49
"40210",2017,0,0,99,99
"40210",2019,0,0,98,98
"40210",2020,0,0,82,82
"40214",2015,0,0,77,77
"40214",2016,0,0,27,27
"40214",2017,0,0,58,58
"40214",2018,0,0,66,66
"40214",2019,0,0,59,59
"40214",2020,0,0,90,90
"40215",2015,0,0,77,77
"40215",2016,0,0,49,49
"40215",2017,0,0,99,99
"40215",2019,0,0,98,98
"40215",2020,0,0,82,82
"40216",2015,0,0,77,77
"40216",2016,0,0,27,27
"40216",2017,0,0,58,58
"40216",2018,0,0,66,66
"40216",2019,0,0,59,59
"40216",2020,0,0,90,90
"40218",2015,0,0,75,75
"40218",2016,0,0,64,64
"40218",2017,0,0,79,79
"40218",2018,0,0,56,56
"40218",2019,0,0,101,101
"40219",2013,0,0,36,36
"40219",2015,0,0,85,85
"40219",2016,0,0,57,57
"40219",2017,0,0,68,68
"40219",2018,0,0,69,69
"40219",2019,0,0,105,105
"40219",2020,0,0,96,96
"40220",2013,0,0,36,36
"40220",2015,0,0,85,85
"40220",2016,0,0,57,57
"40220",2017,0,0,68,68
"40220",2018,0,0,69,69
"40220",2019,0,0,105,105
"40220",2020,0,0,96,96
"40221",2013,0,0,41,41
"40221",2015,0,0,61,61
"40221",2016,0,0,15,15
"40221",2017,0,0,44,44
"40221",2018,0,0,51,51
"40221",2019,0,0,101,101
"40223",2015,0,0,77,77
"40223",2016,0,0,27,27
"40223",2017,0,0,58,58
"40223",2018,0,0,66,66
"40223",2019,0,0,59,59
"40223",2020,0,0,90,90
"40224",2015,0,0,77,77
"40224",2016,0,0,27,27
"40224",2017,0,0,58,58
"40224",2018,0,0,66,66
"40224",2019,0,0,59,59
"40224",2020,0,0,90,90
"40225",2013,0,0,36,36
"40225",2015,0,0,85,85
"40225",2016,0,0,38,38
"40225",2017,0,0,68,68
"40225",2018,0,0,66,66
"40225",2019,0,0,98,98
"40225",2020,0,0,96,96
"40226",2013,0,0,36,36
"40226",2015,0,0,85,85
"40226",2016,0,0,57,57
"40226",2017,0,0,68,68
"40226",2018,0,0,69,69
"40226",2019,0,0,105,105
"40226",2020,0,0,96,96
"40228",2015,0,0,77,77
"40228",2016,0,0,27,27
"40228",2017,0,0,58,58
"40228",2018,0,0,66,66
"40228",2019,0,0,59,59
"40228",2020,0,0,90,90
"40230",2015,0,0,77,77
"40230",2016,0,0,49,49
"40230",2017,0,0,99,99
"40230",2019,0,0,98,98
"40230",2020,0,0,82,82
"40232",2015,0,0,77,77
"40232",2016,0,0,27,27
"40232",2017,0,0,58,58
"40232",2018,0,0,66,66
"40232",2019,0,0,59,59
"40232",2020,0,0,90,90
"40233",2015,0,0,77,77
"40233",2016,0,0,27,27
"40233",2017,0,0,58,58
"40233",2018,0,0,66,66
"40233",2019,0,0,59,59
"40233",2020,0,0,90,90
"40234",2013,0,0,41,41
"40234",2015,0,0,61,61
"40234",2016,0,0,15,15
"40234",2017,0,0,44,44
"40234",2018,0,0,51,51
"40234",2019,0,0,101,101
"40235",2013,0,0,36,36
"40235",2015,0,0,85,85
"40235",2016,0,0,57,57
"40235",2017,0,0,68,68
"40235",2018,0,0,69,69
"40235",2019,0,0,105,105
"40235",2020,0,0,96,96
"40236",2015,0,0,77,77
"40236",2016,0,0,27,27
"40236",2017,0,0,58,58
"40236",2018,0,0,66,66
"40236",2019,0,0,59,59
"40236",2020,0,0,90,90
"40237",2015,0,0,77,77
"40237",2016,0,0,49,49
"40237",2017,0,0,99,99
"40237",2019,0,0,98,98
"40237",2020,0,0,82,82
"40238",2013,0,0,27,27
"40238",2015,0,0,29,29
"40238",2016,0,0,15,15
"40238",2017,0,0,19,19
"40238",2018,0,0,31,31
"40239",2013,0,0,36,36
"40239",2015,0,0,85,85
"40239",2016,0,0,57,57
"40239",2017,0,0,68,68
"40239",2018,0,0,69,69
"40239",2019,0,0,105,105
"40239",2020,0,0,96,96
"40240",2013,0,0,36,36
"40240",2015,0,0,85,85
"40240",2016,0,0,57,57
"40240",2017,0,0,68,68
"40240",2018,0,0,69,69
"40240",2019,0,0,105,105
"40240",2020,0,0,96,96
"40243",2015,0,0,77,77
"40243",2016,0,0,49,49
"40243",2017,0,0,99,99
"40243",2019,0,0,98,98
"40243",2020,0,0,82,82
"40245",2015,0,0,75,75
"40245",2016,0,0,64,64
"40245",2017,0,0,79,79
"40245",2018,0,0,56,56
"40245",2019,0,0,101,101
"40246",2015,0,0,77,77
"40246",2016,0,0,49,49
"40246",2017,0,0,99,99
"40246",2019,0,0,98,98
"40246",2020,0,0,82,82
"40247",2013,0,0,36,36
"40247",2015,0,0,85,85
"40247",2016,0,0,57,57
"40247",2017,0,0,68,68
"40247",2018,0,0,69,69
"40247",2019,0,0,105,105
"40247",2020,0,0,96,96
"40249",2015,0,0,77,77
"40249",2016,0,0,49,49
"40249",2017,0,0,99,99
"40249",2020,0,0,82,82
"40250",2015,0,0,75,75
"40250",2016,0,0,64,64
"40250",2017,0,0,79,79
"40250",2018,0,0,56,56
"40250",2019,0,0,101,101
"40252",2013,0,0,36,36
"40252",2015,0,0,85,85
"40252",2016,0,0,57,57
"40252",2017,0,0,68,68
"40252",2018,0,0,69,69
"40252",2019,0,0,105,105
"40252",2020,0,0,96,96
"40253",2015,0,0,77,77
"40253",2016,0,0,27,27
"40253",2017,0,0,99,99
"40253",2018,0,0,66,66
"40253",2019,0,0,59,59
"40253",2020,0,0,90,90
"40255",2013,0,0,27,27
"40255",2015,0,0,29,29
"40255",2016,0,0,15,15
"40255",2017,0,0,19,19
"40255",2018,0,0,31,31
"40258",2013,0,0,41,41
"40258",2015,0,0,61,61
"40258",2016,0,0,15,15
"40258",2017,0,0,44,44
"40258",2018,0,0,51,51
"40258",2019,0,0,101,101
"40259",2013,0,0,27,27
"40259",2015,0,0,28,28
"40259",2016,0,0,15,15
"40259",2017,0,0,19,19
"40259",2018,0,0,31,31
"40259",2020,0,0,61,61
"40260",2013,0,0,36,36
"40260",2015,0,0,85,85
"40260",2016,0,0,57,57
"40260",2017,0,0,68,68
"40260",2018,0,0,69,69
"40260",2019,0,0,105,105
"40260",2020,0,0,96,96
"40262",2015,0,0,75,75
"40262",2016,0,0,64,64
"40262",2017,0,0,79,79
"40262",2018,0,0,56,56
"40262",2019,0,0,101,101
"40263",2015,0,0,77,77
"40263",2016,0,0,49,49
"40263",2017,0,0,99,99
"40263",2019,0,0,98,98
"40263",2020,0,0,82,82
"40265",2015,0,0,75,75
"40265",2016,0,0,64,64
"40265",2017,0,0,79,79
"40265",2018,0,0,56,56
"40265",2019,0,0,101,101
"40267",2013,0,0,41,41
"40267",2015,0,0,61,61
"40267",2016,0,0,15,15
"40267",2017,0,0,44,44
"40267",2018,0,0,51,51
"40267",2019,0,0,101,101
"40270",2013,0,0,36,36
"40270",2015,0,0,85,85
"40270",2016,0,0,57,57
"40270",2017,0,0,68,68
"40270",2018,0,0,69,69
"40270",2019,0,0,105,105
"40270",2020,0,0,96,96
"40274",2015,0,0,77,77
"40274",2016,0,0,64,64
"40274",2017,0,0,79,79
"40274",2018,0,0,56,56
"40274",2019,0,0,101,101
"40274",2020,0,0,82,82
"40275",2013,0,0,36,36
"40275",2015,0,0,85,85
"40275",2016,0,0,57,57
"40275",2017,0,0,68,68
"40275",2018,0,0,69,69
"40275",2019,0,0,105,105
"40275",2020,0,0,96,96
"40277",2015,0,0,77,77
"40277",2016,0,0,27,27
"40277",2017,0,0,58,58
"40277",2018,0,0,66,66
"40277",2019,0,0,59,59
"40277",2020,0,0,90,90
"40280",2013,0,0,36,36
"40280",2015,0,0,85,85
"40280",2016,0,0,57,57
"40280",2017,0,0,67,67
"40280",2018,0,0,69,69
"40280",2019,0,0,105,105
"40280",2020,0,0,96,96
"40281",2013,0,0,41,41
"40281",2015,0,0,57,57
"40281",2016,0,0,15,15
"40281",2017,0,0,42,42
"40281",2018,0,0,51,51
"40281",2019,0,0,105,105
"40281",2020,0,0,96,96
"40282",2013,0,0,36,36
"40282",2015,0,0,85,85
"40282",2016,0,0,57,57
"40282",2017,0,0,68,68
"40282",2018,0,0,69,69
"40282",2019,0,0,105,105
"40282",2020,0,0,96,96
"40283",2015,0,0,77,77
"40283",2016,0,0,49,49
"40283",2017,0,0,99,99
"40283",2019,0,0,98,98
"40283",2020,0,0,82,82
"40285",2015,0,0,77,77
"40285",2016,0,0,49,49
"40285",2017,0,0,99,99
"40285",2019,0,0,98,98
"40285",2020,0,0,82,82
"40286",2013,0,0,36,36
"40286",2015,0,0,85,85
"40286",2016,0,0,38,38
"40286",2017,0,0,68,68
"40286",2018,0,0,66,66
"40286",2019,0,0,98,98
"40286",2020,0,0,96,96
"40288",2015,0,0,75,75
"40288",2016,0,0,64,64
"40288",2017,0,0,79,79
"40288",2018,0,0,56,56
"40288",2019,0,0,101,101
"40289",2013,0,0,36,36
"40289",2015,0,0,85,85
"40289",2016,0,0,57,57
"40289",2017,0,0,68,68
"40289",2018,0,0,69,69
"40289",2019,0,0,105,105
"40289",2020,0,0,96,96
"40290",2013,0,0,36,36
"40290",2015,0,0,85,85
"40290",2016,0,0,57,57
"40290",2017,0,0,68,68
"40290",2018,0,0,69,69
"40290",2019,0,0,105,105
"40290",2020,0,0,96,96
"40294",2015,0,0,77,77
"40294",2016,0,0,27,27
"40294",2017,0,0,58,58
"40294",2018,0,0,66,66
"40294",2019,0,0,59,59
"40294",2020,0,0,90,90
"40297",2015,0,0,75,75
"40297",2016,0,0,64,64
"40297",2017,0,0,79,79
"40297",2018,0,0,56,56
"40297",2019,0,0,101,101
"40298",2013,0,0,36,36
"40298",2015,0,0,85,85
"40298",2016,0,0,57,57
"40298",2017,0,0,68,68
"40298",2018,0,0,69,69
"40298",2019,0,0,105,105
"40298",2020,0,0,96,96
"40299",2015,0,0,77,77
"40299",2016,0,0,49,49
"40299",2017,0,0,99,99
"40299",2020,0,0,82,82
"40303",2015,0,0,77,77
"40303",2016,0,0,49,49
"40303",2017,0,0,99,99
"40303",2019,0,0,98,98
"40303",2020,0,0,82,82
"40305",2013,0,0,36,36
"40305",2015,0,0,85,85
"40305",2016,0,0,57,57
"40305",2017,0,0,68,68
"40305",2018,0,0,69,69
"40305",2019,0,0,105,105
"40305",2020,0,0,96,96
"40308",2015,0,0,77,77
"40308",2016,0,0,27,27
"40308",2017,0,0,58,58
"40308",2018,0,0,66,66
"40308",2019,0,0,59,59
"40308",2020,0,0,90,90
"40309",2013,0,0,36,36
"40309",2015,0,0,85,85
"40309",2016,0,0,57,57
"40309",2017,0,0,68,68
"40309",2018,0,0,69,69
"40309",2019,0,0,105,105
"40309",2020,0,0,96,96
"40311",2015,0,0,77,77
"40311",2016,0,0,49,49
"40311",2017,0,0,99,99
"40311",2019,0,0,98,98
"40311",2020,0,0,82,82
"40313",2013,0,0,36,36
"40313",2015,0,0,85,85
"40313",2016,0,0,57,57
"40313",2017,0,0,68,68
"40313",2018,0,0,69,69
"40313",2019,0,0,105,105
"40313",2020,0,0,96,96
"40315",2015,0,0,77,77
"40315",2016,0,0,49,49
"40315",2017,0,0,99,99
"40315",2019,0,0,98,98
"40315",2020,0,0,82,82
"40316",2015,0,0,77,77
"40316",2016,0,0,27,27
"40316",2017,0,0,58,58
"40316",2018,0,0,66,66
"40316",2019,0,0,59,59
"40316",2020,0,0,90,90
"40318",2013,0,0,36,36
"40318",2015,0,0,85,85
"40318",2016,0,0,57,57
"40318",2017,0,0,68,68
"40318",2018,0,0,69,69
"40318",2019,0,0,105,105
"40318",2020,0,0,96,96
"40320",2015,0,0,75,75
"40320",2016,0,0,64,64
"40320",2017,0,0,79,79
"40320",2018,0,0,56,56
"40320",2019,0,0,101,101
"40321",2013,0,0,36,36
"40321",2015,0,0,85,85
"40321",2016,0,0,57,57
"40321",2017,0,0,68,68
"40321",2018,0,0,69,69
"40321",2019,0,0,105,105
"40321",2020,0,0,96,96
"40323",2015,0,0,75,75
"40323",2016,0,0,64,64
"40323",2017,0,0,79,79
"40323",2018,0,0,56,56
"40323",2019,0,0,101,101
"40324",2015,0,0,77,77
"40324",2016,0,0,49,49
"40324",2017,0,0,99,99
"40324",2019,0,0,98,98
"40324",2020,0,0,82,82
"40325",2013,0,0,36,36
"40325",2015,0,0,85,85
"40325",2016,0,0,57,57
"40325",2017,0,0,68,68
"40325",2018,0,0,69,69
"40325",2019,0,0,105,105
"40325",2020,0,0,96,96
"40327",2015,0,0,75,75
"40327",2016,0,0,64,64
"40327",2017,0,0,79,79
"40327",2018,0,0,56,56
"40327",2019,0,0,101,101
"40329",2013,0,0,36,36
"40329",2015,0,0,85,85
"40329",2016,0,0,57,57
"40329",2017,0,0,68,68
"40329",2018,0,0,69,69
"40329",2019,0,0,105,105
"40329",2020,0,0,96,96
"40330",2015,0,0,77,77
"40330",2016,0,0,49,49
"40330",2017,0,0,99,99
"40330",2019,0,0,98,98
"40330",2020,0,0,82,82
"40331",2013,0,0,41,41
"40331",2015,0,0,61,61
"40331",2016,0,0,15,15
"40331",2017,0,0,44,44
"40331",2018,0,0,51,51
"40331",2019,0,0,101,101
"40333",2015,0,0,77,77
"40333",2016,0,0,64,64
"40333",2017,0,0,79,79
"40333",2018,0,0,56,56
"40333",2019,0,0,101,101
"40333",2020,0,0,82,82
"42001",2013,0,0,77,77
"42001",2014,0,0,110,110
"42001",2015,0,15,8,23
"42001",2017,0,0,49,49
"42001",2018,0,0,43,43
"42001",2019,0,0,32,32
"42001",2020,0,0,104,104
"42002",2013,0,0,77,77
"42002",2014,0,0,110,110
"42002",2015,0,15,8,23
"42002",2017,0,0,90,90
"42002",2018,0,0,43,43
"42002",2019,0,0,32,32
"42002",2020,0,0,104,104
"42003",2013,0,0,77,77
"42003",2014,0,0,110,110
"42003",2015,0,15,8,23
"42003",2016,0,0,26,26
"42003",2017,0,0,98,98
"42003",2018,0,0,54,54
"42003",2019,0,0,8,8
"42003",2020,0,0,104,104
"42005",2013,0,0,77,77
"42005",2014,0,0,110,110
"42005",2015,0,15,8,23
"42005",2017,0,0,57,57
"42005",2018,0,0,43,43
"42005",2019,0,0,43,43
"42005",2020,0,0,84,84
"42006",2013,0,0,77,77
"42006",2014,0,0,110,110
"42006",2015,0,15,85,100
"42006",2017,0,0,64,64
"42006",2018,0,0,43,43
"42006",2019,0,0,109,109
"42006",2020,0,0,124,124
"42007",2013,0,0,77,77
"42007",2014,0,0,110,110
"42007",2015,0,15,8,23
"42007",2016,0,0,26,26
"42007",2017,0,0,90,90
"42007",2018,0,0,54,54
"42007",2019,0,0,43,43
"42007",2020,0,0,84,84
"42008",2013,0,0,77,77
"42008",2014,0,0,110,110
"42008",2015,0,15,8,23
"42008",2017,0,0,90,90
"42008",2018,0,0,43,43
"42008",2019,0,0,4,4
"42008",2020,0,0,104,104
"42009",2013,0,0,77,77
"42009",2014,0,0,110,110
"42009",2015,0,15,8,23
"42009",2017,0,0,90,90
"42009",2018,0,0,43,43
"42009",2019,0,0,32,32
"42009",2020,0,0,104,104
"42010",2013,0,0,77,77
"42010",2014,0,0,110,110
"42010",2015,0,15,8,23
"42010",2017,0,0,57,57
"42010",2018,0,0,43,43
"42010",2019,0,0,43,43
"42010",2020,0,0,84,84
"42011",2013,0,0,77,77
"42011",2014,0,0,110,110
"42011",2015,0,15,8,23
"42011",2017,0,0,49,49
"42011",2018,0,0,74,74
"42011",2019,0,0,43,43
"42011",2020,0,0,84,84
"42012",2013,0,0,77,77
"42012",2014,0,0,110,110
"42012",2015,0,15,8,23
"42012",2017,0,0,90,90
"42012",2018,0,0,43,43
"42012",2019,0,0,32,32
"42012",2020,0,0,104,104
"42013",2013,0,0,77,77
"42013",2014,0,0,110,110
"42013",2015,0,15,8,23
"42013",2016,0,0,26,26
"42013",2017,0,0,86,86
"42013",2018,0,0,74,74
"42013",2019,0,0,43,43
"42013",2020,0,0,84,84
"42014",2013,0,0,77,77
"42014",2014,0,0,110,110
"42014",2015,0,15,8,23
"42014",2016,0,0,26,26
"42014",2017,0,0,90,90
"42014",2018,0,0,54,54
"42014",2019,0,0,43,43
"42014",2020,0,0,84,84
"42015",2013,0,0,77,77
"42015",2014,0,0,110,110
"42015",2015,0,15,8,23
"42015",2016,0,0,26,26
"42015",2017,0,0,90,90
"42015",2018,0,0,54,54
"42015",2019,0,0,43,43
"42015",2020,0,0,84,84
"42016",2013,0,0,77,77
"42016",2014,0,0,110,110
"42016",2015,0,15,8,23
"42016",2016,0,0,26,26
"42016",2017,0,0,98,98
"42016",2018,0,0,54,54
"42016",2019,0,0,8,8
"42016",2020,0,0,104,104
"42017",2013,0,0,77,77
"42017",2014,0,0,110,110
"42017",2015,0,15,85,100
"42017",2017,0,0,26,26
"42017",2018,0,0,43,43
"42017",2019,0,0,24,24
"42017",2020,0,0,84,84
"42018",2013,0,0,77,77
"42018",2014,0,0,110,110
"42018",2015,0,15,85,100
"42018",2016,0,0,26,26
"42018",2017,0,0,130,130
"42018",2018,0,0,43,43
"42018",2019,0,0,52,52
"42018",2020,0,0,84,84
"42019",2013,0,0,77,77
"42019",2014,0,0,110,110
"42019",2015,0,15,8,23
"42019",2017,0,0,90,90
"42019",2018,0,0,43,43
"42019",2019,0,0,32,32
"42019",2020,0,0,104,104
"42020",2013,0,0,77,77
"42020",2014,0,0,110,110
"42020",2015,0,15,8,23
"42020",2017,0,0,49,49
"42020",2018,0,0,43,43
"42020",2019,0,0,32,32
"42020",2020,0,0,104,104
"42021",2013,0,0,77,77
"42021",2014,0,0,110,110
"42021",2015,0,15,8,23
"42021",2017,0,0,90,90
"42021",2018,0,0,43,43
"42021",2019,0,0,32,32
"42021",2020,0,0,104,104
"42022",2013,0,0,77,77
"42022",2014,0,0,110,110
"42022",2015,0,15,8,23
"42022",2017,0,0,49,49
"42022",2018,0,0,43,43
"42022",2019,0,0,32,32
"42022",2020,0,0,104,104
"42023",2013,0,0,77,77
"42023",2014,0,0,110,110
"42023",2015,0,15,85,100
"42023",2016,0,0,26,26
"42023",2017,0,0,130,130
"42023",2018,0,0,43,43
"42023",2019,0,0,52,52
"42023",2020,0,0,84,84
"42025",2013,0,0,77,77
"42025",2014,0,0,110,110
"42025",2015,0,15,8,23
"42025",2016,0,0,26,26
"42025",2017,0,0,90,90
"42025",2018,0,0,54,54
"42025",2019,0,0,43,43
"42025",2020,0,0,84,84
"42026",2013,0,0,77,77
"42026",2014,0,0,110,110
"42026",2015,0,15,8,23
"42026",2016,0,0,26,26
"42026",2017,0,0,90,90
"42026",2018,0,0,54,54
"42026",2019,0,0,8,8
"42026",2020,0,0,84,84
"42027",2013,0,0,77,77
"42027",2014,0,0,110,110
"42027",2015,0,15,8,23
"42027",2017,0,0,90,90
"42027",2018,0,0,43,43
"42027",2019,0,0,32,32
"42027",2020,0,0,104,104
"42028",2013,0,0,77,77
"42028",2014,0,0,110,110
"42028",2015,0,15,85,100
"42028",2016,0,0,26,26
"42028",2017,0,0,130,130
"42028",2018,0,0,43,43
"42028",2019,0,0,52,52
"42028",2020,0,0,84,84
"42029",2013,0,0,77,77
"42029",2014,0,0,110,110
"42029",2015,0,15,8,23
"42029",2016,0,0,26,26
"42029",2017,0,0,86,86
"42029",2018,0,0,74,74
"42029",2019,0,0,43,43
"42029",2020,0,0,84,84
"42030",2013,0,0,77,77
"42030",2014,0,0,110,110
"42030",2015,0,15,8,23
"42030",2017,0,0,90,90
"42030",2018,0,0,43,43
"42030",2019,0,0,32,32
"42030",2020,0,0,104,104
"42031",2013,0,0,77,77
"42031",2014,0,0,110,110
"42031",2015,0,15,8,23
"42031",2017,0,0,49,49
"42031",2018,0,0,43,43
"42031",2019,0,0,32,32
"42031",2020,0,0,104,104
"42032",2013,0,0,77,77
"42032",2014,0,0,110,110
"42032",2015,0,15,85,100
"42032",2017,0,0,26,26
"42032",2018,0,0,43,43
"42032",2019,0,0,24,24
"42032",2020,0,0,84,84
"42033",2013,0,0,77,77
"42033",2014,0,0,110,110
"42033",2015,0,15,8,23
"42033",2016,0,0,26,26
"42033",2017,0,0,90,90
"42033",2018,0,0,54,54
"42033",2019,0,0,43,43
"42033",2020,0,0,84,84
"42034",2013,0,0,77,77
"42034",2014,0,0,110,110
"42034",2015,0,15,8,23
"42034",2017,0,0,90,90
"42034",2018,0,0,43,43
"42034",2019,0,0,32,32
"42034",2020,0,0,104,104
"42035",2013,0,0,77,77
"42035",2014,0,0,110,110
"42035",2015,0,15,8,23
"42035",2017,0,0,90,90
"42035",2018,0,0,43,43
"42035",2019,0,0,32,32
"42035",2020,0,0,104,104
"42036",2013,0,0,77,77
"42036",2014,0,0,110,110
"42036",2015,0,15,85,100
"42036",2017,0,0,26,26
"42036",2018,0,0,43,43
"42036",2019,0,0,24,24
"42036",2020,0,0,84,84
"42037",2013,0,0,77,77
"42037",2014,0,0,110,110
"42037",2015,0,15,8,23
"42037",2017,0,0,90,90
"42037",2018,0,0,43,43
"42037",2019,0,0,32,32
"42037",2020,0,0,104,104
"42038",2013,0,0,77,77
"42038",2014,0,0,110,110
"42038",2015,0,15,8,23
"42038",2017,0,0,49,49
"42038",2018,0,0,43,43
"42038",2019,0,0,32,32
"42038",2020,0,0,104,104
"42039",2013,0,0,77,77
"42039",2014,0,0,110,110
"42039",2015,0,15,8,23
"42039",2017,0,0,90,90
"42039",2018,0,0,43,43
"42039",2019,0,0,32,32
"42039",2020,0,0,104,104
"42040",2013,0,0,77,77
"42040",2014,0,0,110,110
"42040",2015,0,15,8,23
"42040",2017,0,0,90,90
"42040",2018,0,0,43,43
"42040",2019,0,0,32,32
"42040",2020,0,0,104,104
"42041",2013,0,0,77,77
"42041",2014,0,0,110,110
"42041",2015,0,15,8,23
"42041",2017,0,0,49,49
"42041",2018,0,0,43,43
"42041",2019,0,0,32,32
"42041",2020,0,0,104,104
"42042",2013,0,0,77,77
"42042",2014,0,0,110,110
"42042",2015,0,15,8,23
"42042",2017,0,0,49,49
"42042",2018,0,0,43,43
"42042",2019,0,0,32,32
"42042",2020,0,0,104,104
"42043",2013,0,0,77,77
"42043",2014,0,0,110,110
"42043",2015,0,15,8,23
"42043",2016,0,0,26,26
"42043",2017,0,0,86,86
"42043",2018,0,0,74,74
"42043",2019,0,0,43,43
"42043",2020,0,0,84,84
"42044",2013,0,0,77,77
"42044",2014,0,0,110,110
"42044",2015,0,15,85,100
"42044",2017,0,0,64,64
"42044",2018,0,0,43,43
"42044",2019,0,0,109,109
"42044",2020,0,0,124,124
"42045",2013,0,0,77,77
"42045",2014,0,0,110,110
"42045",2015,0,15,8,23
"42045",2017,0,0,90,90
"42045",2018,0,0,43,43
"42045",2019,0,0,32,32
"42045",2020,0,0,104,104
"42046",2013,0,0,77,77
"42046",2014,0,0,110,110
"42046",2015,0,15,8,23
"42046",2017,0,0,90,90
"42046",2018,0,0,43,43
"42046",2019,0,0,32,32
"42046",2020,0,0,104,104
"42047",2013,0,0,77,77
"42047",2014,0,0,110,110
"42047",2015,0,15,8,23
"42047",2017,0,0,90,90
"42047",2018,0,0,43,43
"42047",2019,0,0,32,32
"42047",2020,0,0,104,104
"42048",2013,0,0,77,77
"42048",2014,0,0,110,110
"42048",2015,0,15,8,23
"42048",2016,0,0,26,26
"42048",2017,0,0,90,90
"42048",2018,0,0,54,54
"42048",2019,0,0,43,43
"42048",2020,0,0,84,84
"42049",2013,0,0,77,77
"42049",2014,0,0,110,110
"42049",2015,0,15,8,23
"42049",2016,0,0,26,26
"42049",2017,0,0,98,98
"42049",2018,0,0,54,54
"42049",2019,0,0,8,8
"42049",2020,0,0,104,104
"42050",2013,0,0,77,77
"42050",2014,0,0,110,110
"42050",2015,0,15,8,23
"42050",2017,0,0,49,49
"42050",2018,0,0,43,43
"42050",2019,0,0,32,32
"42050",2020,0,0,104,104
"42051",2013,0,0,77,77
"42051",2014,0,0,110,110
"42051",2015,0,15,85,100
"42051",2017,0,0,26,26
"42051",2018,0,0,43,43
"42051",2019,0,0,24,24
"42051",2020,0,0,84,84
"42052",2013,0,0,77,77
"42052",2014,0,0,110,110
"42052",2015,0,15,8,23
"42052",2016,0,0,26,26
"42052",2017,0,0,90,90
"42052",2018,0,0,54,54
"42052",2019,0,0,43,43
"42052",2020,0,0,84,84
"42053",2013,0,0,77,77
"42053",2014,0,0,110,110
"42053",2015,0,15,85,100
"42053",2017,0,0,26,26
"42053",2018,0,0,43,43
"42053",2019,0,0,24,24
"42053",2020,0,0,84,84
"42054",2013,0,0,77,77
"42054",2014,0,0,110,110
"42054",2015,0,15,8,23
"42054",2017,0,0,90,90
"42054",2018,0,0,43,43
"42054",2019,0,0,32,32
"42054",2020,0,0,104,104
"42055",2013,0,0,77,77
"42055",2014,0,0,110,110
"42055",2015,0,15,8,23
"42055",2016,0,0,26,26
"42055",2017,0,0,86,86
"42055",2018,0,0,74,74
"42055",2019,0,0,43,43
"42055",2020,0,0,84,84
"42056",2013,0,0,77,77
"42056",2014,0,0,110,110
"42056",2015,0,15,85,100
"42056",2016,0,0,26,26
"42056",2017,0,0,130,130
"42056",2018,0,0,43,43
"42056",2019,0,0,52,52
"42056",2020,0,0,84,84
"42058",2013,0,0,77,77
"42058",2014,0,0,110,110
"42058",2015,0,15,8,23
"42058",2017,0,0,90,90
"42058",2018,0,0,43,43
"42058",2019,0,0,32,32
"42058",2020,0,0,104,104
"42059",2013,0,0,77,77
"42059",2014,0,0,110,110
"42059",2015,0,15,8,23
"42059",2016,0,0,26,26
"42059",2017,0,0,86,86
"42059",2018,0,0,74,74
"42059",2019,0,0,43,43
"42059",2020,0,0,84,84
"42060",2013,0,0,77,77
"42060",2014,0,0,110,110
"42060",2015,0,15,8,23
"42060",2017,0,0,90,90
"42060",2018,0,0,43,43
"42060",2019,0,0,32,32
"42060",2020,0,0,104,104
"42061",2013,0,0,77,77
"42061",2014,0,0,110,110
"42061",2015,0,15,8,23
"42061",2017,0,0,90,90
"42061",2018,0,0,43,43
"42061",2019,0,0,4,4
"42061",2020,0,0,104,104
"42062",2013,0,0,77,77
"42062",2014,0,0,110,110
"42062",2015,0,15,8,23
"42062",2016,0,0,26,26
"42062",2017,0,0,86,86
"42062",2018,0,0,74,74
"42062",2019,0,0,43,43
"42062",2020,0,0,84,84
"42063",2013,0,0,77,77
"42063",2014,0,0,110,110
"42063",2015,0,15,8,23
"42063",2016,0,0,26,26
"42063",2017,0,0,78,78
"42063",2018,0,0,54,54
"42063",2019,0,0,43,43
"42063",2020,0,0,84,84
"42064",2013,0,0,77,77
"42064",2014,0,0,110,110
"42064",2015,0,15,85,100
"42064",2017,0,0,26,26
"42064",2018,0,0,43,43
"42064",2019,0,0,24,24
"42064",2020,0,0,84,84
"42065",2013,0,0,77,77
"42065",2014,0,0,110,110
"42065",2015,0,15,8,23
"42065",2016,0,0,26,26
"42065",2017,0,0,57,57
"42065",2018,0,0,74,74
"42065",2019,0,0,43,43
"42065",2020,0,0,84,84
"42066",2013,0,0,77,77
"42066",2014,0,0,110,110
"42066",2015,0,15,8,23
"42066",2017,0,0,49,49
"42066",2018,0,0,43,43
"42066",2019,0,0,32,32
"42066",2020,0,0,104,104
"42067",2013,0,0,77,77
"42067",2014,0,0,110,110
"42067",2015,0,15,85,100
"42067",2017,0,0,26,26
"42067",2018,0,0,43,43
"42067",2019,0,0,24,24
"42067",2020,0,0,84,84
"42068",2013,0,0,77,77
"42068",2014,0,0,110,110
"42068",2015,0,15,8,23
"42068",2016,0,0,26,26
"42068",2017,0,0,90,90
"42068",2018,0,0,54,54
"42068",2019,0,0,43,43
"42068",2020,0,0,84,84
"42069",2013,0,0,77,77
"42069",2014,0,0,110,110
"42069",2015,0,15,8,23
"42069",2016,0,0,26,26
"42069",2017,0,0,78,78
"42069",2018,0,0,54,54
"42069",2019,0,0,8,8
"42069",2020,0,0,84,84
"42070",2013,0,0,77,77
"42070",2014,0,0,110,110
"42070",2015,0,15,8,23
"42070",2017,0,0,78,78
"42070",2018,0,0,54,54
"42070",2019,0,0,43,43
"42070",2020,0,0,84,84
"42071",2013,0,0,77,77
"42071",2014,0,0,110,110
"42071",2015,0,15,8,23
"42071",2016,0,0,26,26
"42071",2017,0,0,90,90
"42071",2018,0,0,54,54
"42071",2019,0,0,43,43
"42071",2020,0,0,84,84
"42072",2013,0,0,77,77
"42072",2014,0,0,110,110
"42072",2015,0,15,8,23
"42072",2017,0,0,90,90
"42072",2018,0,0,43,43
"42072",2019,0,0,32,32
"42072",2020,0,0,104,104
"42073",2013,0,0,77,77
"42073",2014,0,0,110,110
"42073",2015,0,15,8,23
"42073",2016,0,0,26,26
"42073",2017,0,0,86,86
"42073",2018,0,0,74,74
"42073",2019,0,0,43,43
"42073",2020,0,0,84,84
"42074",2013,0,0,77,77
"42074",2014,0,0,110,110
"42074",2015,0,15,8,23
"42074",2016,0,0,26,26
"42074",2017,0,0,90,90
"42074",2018,0,0,54,54
"42074",2019,0,0,43,43
"42074",2020,0,0,84,84
"42075",2013,0,0,77,77
"42075",2014,0,0,110,110
"42075",2015,0,15,8,23
"42075",2017,0,0,49,49
"42075",2018,0,0,43,43
"42075",2019,0,0,32,32
"42075",2020,0,0,104,104
"42076",2013,0,0,77,77
"42076",2014,0,0,110,110
"42076",2015,0,15,8,23
"42076",2017,0,0,90,90
"42076",2018,0,0,43,43
"42076",2019,0,0,32,32
"42076",2020,0,0,104,104
"42077",2013,0,0,77,77
"42077",2014,0,0,110,110
"42077",2015,0,15,8,23
"42077",2016,0,0,26,26
"42077",2017,0,0,78,78
"42077",2018,0,0,54,54
"42077",2019,0,0,43,43
"42077",2020,0,0,84,84
"42078",2013,0,0,77,77
"42078",2014,0,0,110,110
"42078",2015,0,15,8,23
"42078",2016,0,0,26,26
"42078",2017,0,0,98,98
"42078",2018,0,0,54,54
"42078",2019,0,0,8,8
"42078",2020,0,0,104,104
"42079",2013,0,0,77,77
"42079",2014,0,0,110,110
"42079",2015,0,15,8,23
"42079",2016,0,0,26,26
"42079",2017,0,0,90,90
"42079",2018,0,0,54,54
"42079",2019,0,0,43,43
"42079",2020,0,0,84,84
"42081",2013,0,0,77,77
"42081",2014,0,0,110,110
"42081",2015,0,15,8,23
"42081",2016,0,0,26,26
"42081",2017,0,0,57,57
"42081",2018,0,0,74,74
"42081",2019,0,0,43,43
"42081",2020,0,0,84,84
"42083",2013,0,0,77,77
"42083",2014,0,0,110,110
"42083",2015,0,15,85,100
"42083",2017,0,0,26,26
"42083",2018,0,0,43,43
"42083",2019,0,0,24,24
"42083",2020,0,0,84,84
"42084",2013,0,0,77,77
"42084",2014,0,0,110,110
"42084",2015,0,15,8,23
"42084",2017,0,0,90,90
"42084",2018,0,0,43,43
"42084",2019,0,0,32,32
"42084",2020,0,0,104,104
"42085",2013,0,0,77,77
"42085",2014,0,0,110,110
"42085",2015,0,15,85,100
"42085",2017,0,0,26,26
"42085",2018,0,0,43,43
"42085",2019,0,0,24,24
"42085",2020,0,0,84,84
"42086",2013,0,0,77,77
"42086",2014,0,0,110,110
"42086",2015,0,15,8,23
"42086",2016,0,0,26,26
"42086",2017,0,0,90,90
"42086",2018,0,0,54,54
"42086",2019,0,0,43,43
"42086",2020,0,0,84,84
"42087",2013,0,0,77,77
"42087",2014,0,0,110,110
"42087",2015,0,15,8,23
"42087",2017,0,0,90,90
"42087",2018,0,0,43,43
"42087",2019,0,0,32,32
"42087",2020,0,0,104,104
"42088",2013,0,0,77,77
"42088",2014,0,0,110,110
"42088",2015,0,15,8,23
"42088",2016,0,0,26,26
"42088",2017,0,0,57,57
"42088",2018,0,0,74,74
"42088",2019,0,0,43,43
"42088",2020,0,0,84,84
"42089",2013,0,0,77,77
"42089",2014,0,0,110,110
"42089",2015,0,15,8,23
"42089",2017,0,0,90,90
"42089",2018,0,0,43,43
"42089",2019,0,0,32,32
"42089",2020,0,0,104,104
"42090",2013,0,0,77,77
"42090",2014,0,0,110,110
"42090",2015,0,15,8,23
"42090",2016,0,0,26,26
"42090",2017,0,0,86,86
"42090",2018,0,0,74,74
"42090",2019,0,0,43,43
"42090",2020,0,0,84,84
"42091",2013,0,0,77,77
"42091",2014,0,0,110,110
"42091",2015,0,15,8,23
"42091",2017,0,0,49,49
"42091",2018,0,0,43,43
"42091",2019,0,0,32,32
"42091",2020,0,0,104,104
"42092",2013,0,0,77,77
"42092",2014,0,0,110,110
"42092",2015,0,15,85,100
"42092",2017,0,0,64,64
"42092",2018,0,0,43,43
"42092",2019,0,0,109,109
"42092",2020,0,0,124,124
"42093",2013,0,0,77,77
"42093",2014,0,0,110,110
"42093",2015,0,15,85,100
"42093",2017,0,0,26,26
"42093",2018,0,0,43,43
"42093",2019,0,0,24,24
"42093",2020,0,0,84,84
"42094",2013,0,0,77,77
"42094",2014,0,0,110,110
"42094",2015,0,15,8,23
"42094",2017,0,0,49,49
"42094",2018,0,0,43,43
"42094",2019,0,0,32,32
"42094",2020,0,0,84,84
"42095",2013,0,0,77,77
"42095",2014,0,0,110,110
"42095",2015,0,15,85,100
"42095",2017,0,0,64,64
"42095",2018,0,0,43,43
"42095",2019,0,0,109,109
"42095",2020,0,0,124,124
"42096",2013,0,0,77,77
"42096",2014,0,0,110,110
"42096",2015,0,15,8,23
"42096",2017,0,0,57,57
"42096",2018,0,0,43,43
"42096",2019,0,0,43,43
"42096",2020,0,0,84,84
"42097",2013,0,0,77,77
"42097",2014,0,0,110,110
"42097",2015,0,15,8,23
"42097",2017,0,0,57,57
"42097",2018,0,0,43,43
"42097",2019,0,0,43,43
"42097",2020,0,0,84,84
"42098",2013,0,0,77,77
"42098",2014,0,0,110,110
"42098",2015,0,15,8,23
"42098",2016,0,0,26,26
"42098",2017,0,0,78,78
"42098",2018,0,0,54,54
"42098",2019,0,0,43,43
"42098",2020,0,0,84,84
"42099",2013,0,0,77,77
"42099",2014,0,0,110,110
"42099",2015,0,15,85,100
"42099",2017,0,0,64,64
"42099",2018,0,0,43,43
"42099",2019,0,0,109,109
"42099",2020,0,0,124,124
"42100",2013,0,0,77,77
"42100",2014,0,0,110,110
"42100",2015,0,15,8,23
"42100",2017,0,0,57,57
"42100",2018,0,0,43,43
"42100",2019,0,0,43,43
"42100",2020,0,0,84,84
"42101",2013,0,0,77,77
"42101",2014,0,0,110,110
"42101",2015,0,15,85,100
"42101",2017,0,0,26,26
"42101",2018,0,0,43,43
"42101",2019,0,0,24,24
"42101",2020,0,0,84,84
"42102",2013,0,0,77,77
"42102",2014,0,0,110,110
"42102",2015,0,15,8,23
"42102",2017,0,0,57,57
"42102",2018,0,0,43,43
"42102",2019,0,0,43,43
"42102",2020,0,0,84,84
"42103",2013,0,0,77,77
"42103",2014,0,0,110,110
"42103",2015,0,15,85,100
"42103",2017,0,0,26,26
"42103",2018,0,0,43,43
"42103",2019,0,0,24,24
"42103",2020,0,0,84,84
"42104",2013,0,0,77,77
"42104",2014,0,0,110,110
"42104",2015,0,15,8,23
"42104",2016,0,0,26,26
"42104",2017,0,0,90,90
"42104",2018,0,0,54,54
"42104",2019,0,0,43,43
"42104",2020,0,0,84,84
"42105",2013,0,0,77,77
"42105",2014,0,0,110,110
"42105",2015,0,15,8,23
"42105",2017,0,0,90,90
"42105",2018,0,0,43,43
"42105",2019,0,0,32,32
"42105",2020,0,0,104,104
"42106",2013,0,0,77,77
"42106",2014,0,0,110,110
"42106",2015,0,15,8,23
"42106",2017,0,0,90,90
"42106",2018,0,0,43,43
"42106",2019,0,0,32,32
"42106",2020,0,0,104,104
"42107",2013,0,0,77,77
"42107",2014,0,0,110,110
"42107",2015,0,15,8,23
"42107",2017,0,0,90,90
"42107",2018,0,0,43,43
"42107",2019,0,0,32,32
"42107",2020,0,0,104,104
"42108",2013,0,0,77,77
"42108",2014,0,0,110,110
"42108",2015,0,15,8,23
"42108",2017,0,0,90,90
"42108",2018,0,0,43,43
"42108",2019,0,0,32,32
"42108",2020,0,0,104,104
"42109",2013,0,0,77,77
"42109",2014,0,0,110,110
"42109",2015,0,15,8,23
"42109",2017,0,0,90,90
"42109",2018,0,0,43,43
"42109",2019,0,0,32,32
"42109",2020,0,0,104,104
"42110",2013,0,0,77,77
"42110",2014,0,0,110,110
"42110",2015,0,15,85,100
"42110",2017,0,0,26,26
"42110",2018,0,0,43,43
"42110",2019,0,0,24,24
"42110",2020,0,0,84,84
"42112",2013,0,0,77,77
"42112",2014,0,0,110,110
"42112",2015,0,15,8,23
"42112",2016,0,0,26,26
"42112",2017,0,0,90,90
"42112",2018,0,0,54,54
"42112",2019,0,0,43,43
"42112",2020,0,0,84,84
"42113",2013,0,0,77,77
"42113",2014,0,0,110,110
"42113",2015,0,15,8,23
"42113",2016,0,0,26,26
"42113",2017,0,0,86,86
"42113",2018,0,0,74,74
"42113",2019,0,0,43,43
"42113",2020,0,0,84,84
"42115",2013,0,0,77,77
"42115",2014,0,0,110,110
"42115",2015,0,15,85,100
"42115",2017,0,0,64,64
"42115",2018,0,0,43,43
"42115",2019,0,0,109,109
"42115",2020,0,0,124,124
"42116",2013,0,0,77,77
"42116",2014,0,0,110,110
"42116",2015,0,15,8,23
"42116",2017,0,0,90,90
"42116",2018,0,0,43,43
"42116",2019,0,0,32,32
"42116",2020,0,0,104,104
"42117",2013,0,0,77,77
"42117",2014,0,0,110,110
"42117",2015,0,15,8,23
"42117",2017,0,0,90,90
"42117",2018,0,0,43,43
"42117",2019,0,0,32,32
"42117",2020,0,0,104,104
"42118",2013,0,0,77,77
"42118",2014,0,0,110,110
"42118",2015,0,15,8,23
"42118",2016,0,0,26,26
"42118",2017,0,0,90,90
"42118",2018,0,0,54,54
"42118",2019,0,0,43,43
"42118",2020,0,0,84,84
"42119",2013,0,0,77,77
"42119",2014,0,0,110,110
"42119",2015,0,15,8,23
"42119",2017,0,0,90,90
"42119",2018,0,0,43,43
"42119",2019,0,0,32,32
"42119",2020,0,0,104,104
"42120",2013,0,0,77,77
"42120",2014,0,0,110,110
"42120",2015,0,15,8,23
"42120",2017,0,0,90,90
"42120",2018,0,0,43,43
"42120",2019,0,0,4,4
"42120",2020,0,0,104,104
"42121",2013,0,0,77,77
"42121",2014,0,0,110,110
"42121",2015,0,15,8,23
"42121",2017,0,0,90,90
"42121",2018,0,0,43,43
"42121",2019,0,0,32,32
"42121",2020,0,0,104,104
"42122",2013,0,0,77,77
"42122",2014,0,0,110,110
"42122",2015,0,15,8,23
"42122",2017,0,0,90,90
"42122",2018,0,0,43,43
"42122",2019,0,0,32,32
"42122",2020,0,0,104,104
"42123",2013,0,0,77,77
"42123",2014,0,0,110,110
"42123",2015,0,15,85,100
"42123",2017,0,0,26,26
"42123",2018,0,0,43,43
"42123",2019,0,0,24,24
"42123",2020,0,0,84,84
"42124",2013,0,0,77,77
"42124",2014,0,0,110,110
"42124",2015,0,15,85,100
"42124",2016,0,0,26,26
"42124",2017,0,0,130,130
"42124",2018,0,0,43,43
"42124",2019,0,0,52,52
"42124",2020,0,0,84,84
"42125",2013,0,0,77,77
"42125",2014,0,0,110,110
"42125",2015,0,15,8,23
"42125",2017,0,0,90,90
"42125",2018,0,0,43,43
"42125",2019,0,0,32,32
"42125",2020,0,0,104,104
"42126",2013,0,0,77,77
"42126",2014,0,0,110,110
"42126",2015,0,15,8,23
"42126",2017,0,0,49,49
"42126",2018,0,0,43,43
"42126",2019,0,0,32,32
"42126",2020,0,0,104,104
"42127",2013,0,0,77,77
"42127",2014,0,0,110,110
"42127",2015,0,15,8,23
"42127",2016,0,0,26,26
"42127",2017,0,0,98,98
"42127",2018,0,0,54,54
"42127",2019,0,0,8,8
"42127",2020,0,0,104,104
"42128",2013,0,0,77,77
"42128",2014,0,0,110,110
"42128",2015,0,15,8,23
"42128",2016,0,0,26,26
"42128",2017,0,0,90,90
"42128",2018,0,0,54,54
"42128",2019,0,0,43,43
"42128",2020,0,0,84,84
"42129",2013,0,0,77,77
"42129",2014,0,0,110,110
"42129",2015,0,15,85,100
"42129",2016,0,0,26,26
"42129",2017,0,0,130,130
"42129",2018,0,0,43,43
"42129",2019,0,0,52,52
"42129",2020,0,0,84,84
"42130",2013,0,0,77,77
"42130",2014,0,0,110,110
"42130",2015,0,15,8,23
"42130",2017,0,0,49,49
"42130",2018,0,0,43,43
"42130",2019,0,0,32,32
"42130",2020,0,0,104,104
"42131",2013,0,0,77,77
"42131",2014,0,0,110,110
"42131",2015,0,15,8,23
"42131",2016,0,0,26,26
"42131",2017,0,0,90,90
"42131",2018,0,0,54,54
"42131",2019,0,0,43,43
"42131",2020,0,0,84,84
"42132",2013,0,0,77,77
"42132",2014,0,0,110,110
"42132",2015,0,15,85,100
"42132",2016,0,0,26,26
"42132",2017,0,0,130,130
"42132",2018,0,0,43,43
"42132",2019,0,0,52,52
"42132",2020,0,0,84,84
"42133",2013,0,0,77,77
"42133",2014,0,0,110,110
"42133",2015,0,15,8,23
"42133",2017,0,0,26,26
"42133",2018,0,0,43,43
"42133",2019,0,0,15,15
"42133",2020,0,0,84,84
"42134",2013,0,0,77,77
"42134",2014,0,0,110,110
"42134",2015,0,15,8,23
"42134",2017,0,0,90,90
"42134",2018,0,0,43,43
"42134",2019,0,0,32,32
"42134",2020,0,0,104,104
"42135",2013,0,0,77,77
"42135",2014,0,0,110,110
"42135",2015,0,15,8,23
"42135",2016,0,0,26,26
"42135",2017,0,0,57,57
"42135",2018,0,0,74,74
"42135",2019,0,0,43,43
"42135",2020,0,0,84,84
"42136",2013,0,0,77,77
"42136",2014,0,0,110,110
"42136",2015,0,15,8,23
"42136",2017,0,0,90,90
"42136",2018,0,0,43,43
"42136",2019,0,0,32,32
"42136",2020,0,0,104,104
"42137",2013,0,0,77,77
"42137",2014,0,0,110,110
"42137",2015,0,15,8,23
"42137",2017,0,0,90,90
"42137",2018,0,0,43,43
"42137",2019,0,0,32,32
"42137",2020,0,0,104,104
"42138",2013,0,0,77,77
"42138",2014,0,0,110,110
"42138",2015,0,15,8,23
"42138",2016,0,0,26,26
"42138",2017,0,0,86,86
"42138",2018,0,0,74,74
"42138",2019,0,0,43,43
"42138",2020,0,0,84,84
"42139",2013,0,0,77,77
"42139",2014,0,0,110,110
"42139",2015,0,15,85,100
"42139",2017,0,0,64,64
"42139",2018,0,0,43,43
"42139",2019,0,0,109,109
"42139",2020,0,0,124,124
"42140",2013,0,0,77,77
"42140",2014,0,0,110,110
"42140",2015,0,15,8,23
"42140",2017,0,0,49,49
"42140",2018,0,0,43,43
"42140",2019,0,0,32,32
"42140",2020,0,0,104,104
"42141",2013,0,0,77,77
"42141",2014,0,0,110,110
"42141",2015,0,15,8,23
"42141",2016,0,0,26,26
"42141",2017,0,0,90,90
"42141",2018,0,0,54,54
"42141",2019,0,0,43,43
"42141",2020,0,0,84,84
"42142",2013,0,0,77,77
"42142",2014,0,0,110,110
"42142",2015,0,15,8,23
"42142",2017,0,0,49,49
"42142",2018,0,0,43,43
"42142",2019,0,0,32,32
"42142",2020,0,0,104,104
"42143",2013,0,0,77,77
"42143",2014,0,0,110,110
"42143",2015,0,15,8,23
"42143",2017,0,0,49,49
"42143",2018,0,0,43,43
"42143",2019,0,0,32,32
"42143",2020,0,0,84,84
"42145",2013,0,0,77,77
"42145",2014,0,0,110,110
"42145",2015,0,15,8,23
"42145",2016,0,0,26,26
"42145",2017,0,0,90,90
"42145",2018,0,0,54,54
"42145",2019,0,0,43,43
"42145",2020,0,0,84,84
"42146",2013,0,0,77,77
"42146",2014,0,0,110,110
"42146",2015,0,15,8,23
"42146",2017,0,0,49,49
"42146",2018,0,0,43,43
"42146",2019,0,0,32,32
"42146",2020,0,0,104,104
"42147",2013,0,0,77,77
"42147",2014,0,0,110,110
"42147",2015,0,15,8,23
"42147",2017,0,0,90,90
"42147",2018,0,0,43,43
"42147",2019,0,0,32,32
"42147",2020,0,0,104,104
"42148",2013,0,0,77,77
"42148",2014,0,0,110,110
"42148",2015,0,15,8,23
"42148",2016,0,0,26,26
"42148",2017,0,0,86,86
"42148",2018,0,0,74,74
"42148",2019,0,0,43,43
"42148",2020,0,0,84,84
"42149",2013,0,0,77,77
"42149",2014,0,0,110,110
"42149",2015,0,15,8,23
"42149",2016,0,0,26,26
"42149",2017,0,0,57,57
"42149",2018,0,0,74,74
"42149",2019,0,0,43,43
"42149",2020,0,0,84,84
"42150",2013,0,0,77,77
"42150",2014,0,0,110,110
"42150",2015,0,15,8,23
"42150",2017,0,0,90,90
"42150",2018,0,0,43,43
"42150",2019,0,0,32,32
"42150",2020,0,0,104,104
"42151",2013,0,0,77,77
"42151",2014,0,0,110,110
"42151",2015,0,15,8,23
"42151",2017,0,0,90,90
"42151",2018,0,0,43,43
"42151",2019,0,0,32,32
"42151",2020,0,0,104,104
"42152",2013,0,0,77,77
"42152",2014,0,0,110,110
"42152",2015,0,15,8,23
"42152",2016,0,0,26,26
"42152",2017,0,0,90,90
"42152",2018,0,0,54,54
"42152",2019,0,0,43,43
"42152",2020,0,0,84,84
"42153",2013,0,0,77,77
"42153",2014,0,0,110,110
"42153",2015,0,15,8,23
"42153",2016,0,0,26,26
"42153",2017,0,0,78,78
"42153",2018,0,0,54,54
"42153",2019,0,0,43,43
"42153",2020,0,0,84,84
"42154",2013,0,0,77,77
"42154",2014,0,0,110,110
"42154",2015,0,15,8,23
"42154",2016,0,0,26,26
"42154",2017,0,0,86,86
"42154",2018,0,0,74,74
"42154",2019,0,0,43,43
"42154",2020,0,0,84,84
"42155",2013,0,0,77,77
"42155",2014,0,0,110,110
"42155",2015,0,15,8,23
"42155",2017,0,0,49,49
"42155",2018,0,0,43,43
"42155",2019,0,0,32,32
"42155",2020,0,0,104,104
"42156",2013,0,0,77,77
"42156",2014,0,0,110,110
"42156",2015,0,15,8,23
"42156",2016,0,0,26,26
"42156",2017,0,0,78,78
"42156",2018,0,0,54,54
"42156",2019,0,0,43,43
"42156",2020,0,0,84,84
"42157",2013,0,0,77,77
"42157",2014,0,0,110,110
"42157",2015,0,15,8,23
"42157",2016,0,0,26,26
"42157",2017,0,0,98,98
"42157",2018,0,0,54,54
"42157",2019,0,0,8,8
"42157",2020,0,0,104,104
"42158",2013,0,0,77,77
"42158",2014,0,0,110,110
"42158",2015,0,15,8,23
"42158",2016,0,0,26,26
"42158",2017,0,0,98,98
"42158",2018,0,0,54,54
"42158",2019,0,0,8,8
"42158",2020,0,0,104,104
"42159",2013,0,0,77,77
"42159",2014,0,0,110,110
"42159",2015,0,15,8,23
"42159",2017,0,0,90,90
"42159",2018,0,0,43,43
"42159",2019,0,0,32,32
"42159",2020,0,0,104,104
"42160",2013,0,0,77,77
"42160",2014,0,0,110,110
"42160",2015,0,15,8,23
"42160",2017,0,0,90,90
"42160",2018,0,0,43,43
"42160",2019,0,0,32,32
"42160",2020,0,0,104,104
"42161",2013,0,0,77,77
"42161",2014,0,0,110,110
"42161",2015,0,15,8,23
"42161",2016,0,0,26,26
"42161",2017,0,0,90,90
"42161",2018,0,0,54,54
"42161",2019,0,0,43,43
"42161",2020,0,0,84,84
"42162",2013,0,0,77,77
"42162",2014,0,0,110,110
"42162",2015,0,15,8,23
"42162",2016,0,0,26,26
"42162",2017,0,0,98,98
"42162",2018,0,0,54,54
"42162",2019,0,0,8,8
"42162",2020,0,0,104,104
"42163",2013,0,0,77,77
"42163",2014,0,0,110,110
"42163",2015,0,15,8,23
"42163",2016,0,0,26,26
"42163",2017,0,0,98,98
"42163",2018,0,0,54,54
"42163",2019,0,0,8,8
"42163",2020,0,0,104,104
"42164",2013,0,0,77,77
"42164",2014,0,0,110,110
"42164",2015,0,15,8,23
"42164",2017,0,0,90,90
"42164",2018,0,0,43,43
"42164",2019,0,0,32,32
"42164",2020,0,0,104,104
"42165",2013,0,0,77,77
"42165",2014,0,0,110,110
"42165",2015,0,15,8,23
"42165",2016,0,0,26,26
"42165",2017,0,0,86,86
"42165",2018,0,0,74,74
"42165",2019,0,0,43,43
"42165",2020,0,0,84,84
"42166",2013,0,0,77,77
"42166",2014,0,0,110,110
"42166",2015,0,15,8,23
"42166",2016,0,0,26,26
"42166",2017,0,0,90,90
"42166",2018,0,0,54,54
"42166",2019,0,0,43,43
"42166",2020,0,0,84,84
"42167",2013,0,0,77,77
"42167",2014,0,0,110,110
"42167",2015,0,15,85,100
"42167",2017,0,0,26,26
"42167",2018,0,0,43,43
"42167",2019,0,0,24,24
"42167",2020,0,0,84,84
"42168",2013,0,0,77,77
"42168",2014,0,0,110,110
"42168",2015,0,15,85,100
"42168",2017,0,0,26,26
"42168",2018,0,0,43,43
"42168",2019,0,0,24,24
"42168",2020,0,0,84,84
"42169",2013,0,0,77,77
"42169",2014,0,0,110,110
"42169",2015,0,15,8,23
"42169",2017,0,0,90,90
"42169",2018,0,0,43,43
"42169",2019,0,0,32,32
"42169",2020,0,0,104,104
"42170",2013,0,0,77,77
"42170",2014,0,0,110,110
"42170",2015,0,15,8,23
"42170",2016,0,0,26,26
"42170",2017,0,0,90,90
"42170",2018,0,0,54,54
"42170",2019,0,0,8,8
"42170",2020,0,0,84,84
"42171",2013,0,0,77,77
"42171",2014,0,0,110,110
"42171",2015,0,15,8,23
"42171",2017,0,0,78,78
"42171",2018,0,0,74,74
"42171",2019,0,0,43,43
"42171",2020,0,0,84,84
"42172",2013,0,0,77,77
"42172",2014,0,0,110,110
"42172",2015,0,15,85,100
"42172",2017,0,0,64,64
"42172",2018,0,0,43,43
"42172",2019,0,0,109,109
"42172",2020,0,0,124,124
"42173",2013,0,0,77,77
"42173",2014,0,0,110,110
"42173",2015,0,15,8,23
"42173",2017,0,0,90,90
"42173",2018,0,0,43,43
"42173",2019,0,0,32,32
"42173",2020,0,0,104,104
"42174",2013,0,0,77,77
"42174",2014,0,0,110,110
"42174",2015,0,15,8,23
"42174",2017,0,0,90,90
"42174",2018,0,0,43,43
"42174",2019,0,0,32,32
"42174",2020,0,0,104,104
"42175",2013,0,0,77,77
"42175",2014,0,0,110,110
"42175",2015,0,15,8,23
"42175",2016,0,0,26,26
"42175",2017,0,0,86,86
"42175",2018,0,0,74,74
"42175",2019,0,0,43,43
"42175",2020,0,0,84,84
"42176",2013,0,0,77,77
"42176",2014,0,0,110,110
"42176",2015,0,15,8,23
"42176",2016,0,0,26,26
"42176",2017,0,0,98,98
"42176",2018,0,0,54,54
"42176",2019,0,0,8,8
"42176",2020,0,0,104,104
"42177",2013,0,0,77,77
"42177",2014,0,0,110,110
"42177",2015,0,15,8,23
"42177",2016,0,0,26,26
"42177",2017,0,0,90,90
"42177",2018,0,0,54,54
"42177",2019,0,0,43,43
"42177",2020,0,0,84,84
"42178",2013,0,0,77,77
"42178",2014,0,0,110,110
"42178",2015,0,15,8,23
"42178",2016,0,0,26,26
"42178",2017,0,0,90,90
"42178",2018,0,0,54,54
"42178",2019,0,0,43,43
"42178",2020,0,0,84,84
"42179",2013,0,0,77,77
"42179",2014,0,0,110,110
"42179",2015,0,15,8,23
"42179",2017,0,0,90,90
"42179",2018,0,0,43,43
"42179",2019,0,0,32,32
"42179",2020,0,0,104,104
"42180",2013,0,0,77,77
"42180",2014,0,0,110,110
"42180",2015,0,15,8,23
"42180",2017,0,0,90,90
"42180",2018,0,0,43,43
"42180",2019,0,0,32,32
"42180",2020,0,0,104,104
"42181",2013,0,0,77,77
"42181",2014,0,0,110,110
"42181",2015,0,15,8,23
"42181",2016,0,0,26,26
"42181",2017,0,0,90,90
"42181",2018,0,0,54,54
"42181",2019,0,0,43,43
"42181",2020,0,0,84,84
"42182",2013,0,0,77,77
"42182",2014,0,0,110,110
"42182",2015,0,15,8,23
"42182",2016,0,0,26,26
"42182",2017,0,0,98,98
"42182",2018,0,0,54,54
"42182",2019,0,0,8,8
"42182",2020,0,0,104,104
"42183",2013,0,0,77,77
"42183",2014,0,0,110,110
"42183",2015,0,15,85,100
"42183",2017,0,0,64,64
"42183",2018,0,0,43,43
"42183",2019,0,0,109,109
"42183",2020,0,0,124,124
"42184",2013,0,0,77,77
"42184",2014,0,0,110,110
"42184",2015,0,15,8,23
"42184",2016,0,0,26,26
"42184",2017,0,0,98,98
"42184",2018,0,0,54,54
"42184",2019,0,0,8,8
"42184",2020,0,0,104,104
"42185",2013,0,0,77,77
"42185",2014,0,0,110,110
"42185",2015,0,15,8,23
"42185",2016,0,0,26,26
"42185",2017,0,0,57,57
"42185",2018,0,0,74,74
"42185",2019,0,0,43,43
"42185",2020,0,0,84,84
"42186",2013,0,0,77,77
"42186",2014,0,0,110,110
"42186",2015,0,15,85,100
"42186",2017,0,0,26,26
"42186",2018,0,0,43,43
"42186",2019,0,0,24,24
"42186",2020,0,0,84,84
"42187",2013,0,0,77,77
"42187",2014,0,0,110,110
"42187",2015,0,15,8,23
"42187",2016,0,0,26,26
"42187",2017,0,0,90,90
"42187",2018,0,0,54,54
"42187",2019,0,0,8,8
"42187",2020,0,0,84,84
"42188",2013,0,0,77,77
"42188",2014,0,0,110,110
"42188",2015,0,15,8,23
"42188",2017,0,0,90,90
"42188",2018,0,0,43,43
"42188",2019,0,0,32,32
"42188",2020,0,0,104,104
"42189",2013,0,0,77,77
"42189",2014,0,0,110,110
"42189",2015,0,15,85,100
"42189",2017,0,0,64,64
"42189",2018,0,0,43,43
"42189",2019,0,0,109,109
"42189",2020,0,0,124,124
"42191",2013,0,0,77,77
"42191",2014,0,0,110,110
"42191",2015,0,15,85,100
"42191",2017,0,0,26,26
"42191",2018,0,0,43,43
"42191",2019,0,0,24,24
"42191",2020,0,0,84,84
"42192",2013,0,0,77,77
"42192",2014,0,0,110,110
"42192",2015,0,15,8,23
"42192",2017,0,0,49,49
"42192",2018,0,0,43,43
"42192",2019,0,0,32,32
"42192",2020,0,0,104,104
"42193",2013,0,0,77,77
"42193",2014,0,0,110,110
"42193",2015,0,15,8,23
"42193",2016,0,0,26,26
"42193",2017,0,0,86,86
"42193",2018,0,0,74,74
"42193",2019,0,0,43,43
"42193",2020,0,0,84,84
"42194",2013,0,0,77,77
"42194",2014,0,0,110,110
"42194",2015,0,15,8,23
"42194",2016,0,0,26,26
"42194",2017,0,0,98,98
"42194",2018,0,0,54,54
"42194",2019,0,0,8,8
"42194",2020,0,0,104,104
"42195",2013,0,0,77,77
"42195",2014,0,0,110,110
"42195",2015,0,15,8,23
"42195",2017,0,0,90,90
"42195",2018,0,0,43,43
"42195",2019,0,0,32,32
"42195",2020,0,0,104,104
"42196",2013,0,0,77,77
"42196",2014,0,0,110,110
"42196",2015,0,15,8,23
"42196",2016,0,0,26,26
"42196",2017,0,0,86,86
"42196",2018,0,0,74,74
"42196",2019,0,0,43,43
"42196",2020,0,0,84,84
"42197",2013,0,0,77,77
"42197",2014,0,0,110,110
"42197",2015,0,15,8,23
"42197",2017,0,0,90,90
"42197",2018,0,0,43,43
"42197",2019,0,0,32,32
"42197",2020,0,0,104,104
"42198",2013,0,0,77,77
"42198",2014,0,0,110,110
"42198",2015,0,15,8,23
"42198",2017,0,0,90,90
"42198",2018,0,0,43,43
"42198",2019,0,0,4,4
"42198",2020,0,0,104,104
"42199",2013,0,0,77,77
"42199",2014,0,0,110,110
"42199",2015,0,15,8,23
"42199",2016,0,0,26,26
"42199",2017,0,0,98,98
"42199",2018,0,0,54,54
"42199",2019,0,0,8,8
"42199",2020,0,0,104,104
"42200",2013,0,0,77,77
"42200",2014,0,0,110,110
"42200",2015,0,15,8,23
"42200",2016,0,0,26,26
"42200",2017,0,0,86,86
"42200",2018,0,0,74,74
"42200",2019,0,0,43,43
"42200",2020,0,0,84,84
"42201",2013,0,0,77,77
"42201",2014,0,0,110,110
"42201",2015,0,15,85,100
"42201",2016,0,0,26,26
"42201",2017,0,0,130,130
"42201",2018,0,0,43,43
"42201",2019,0,0,52,52
"42201",2020,0,0,84,84
"42202",2013,0,0,77,77
"42202",2014,0,0,110,110
"42202",2015,0,15,8,23
"42202",2016,0,0,26,26
"42202",2017,0,0,86,86
"42202",2018,0,0,74,74
"42202",2019,0,0,43,43
"42202",2020,0,0,84,84
"42203",2013,0,0,77,77
"42203",2014,0,0,110,110
"42203",2015,0,15,8,23
"42203",2016,0,0,26,26
"42203",2017,0,0,98,98
"42203",2018,0,0,54,54
"42203",2019,0,0,8,8
"42203",2020,0,0,104,104
"42204",2013,0,0,77,77
"42204",2014,0,0,110,110
"42204",2015,0,15,8,23
"42204",2017,0,0,90,90
"42204",2018,0,0,43,43
"42204",2019,0,0,32,32
"42204",2020,0,0,104,104
"42205",2013,0,0,77,77
"42205",2014,0,0,110,110
"42205",2015,0,15,8,23
"42205",2017,0,0,90,90
"42205",2018,0,0,43,43
"42205",2019,0,0,32,32
"42205",2020,0,0,104,104
"42206",2013,0,0,77,77
"42206",2014,0,0,110,110
"42206",2015,0,15,8,23
"42206",2017,0,0,57,57
"42206",2018,0,0,43,43
"42206",2019,0,0,43,43
"42206",2020,0,0,84,84
"42207",2013,0,0,77,77
"42207",2014,0,0,110,110
"42207",2015,0,15,85,100
"42207",2017,0,0,26,26
"42207",2018,0,0,43,43
"42207",2019,0,0,15,15
"42207",2020,0,0,84,84
"42208",2013,0,0,77,77
"42208",2014,0,0,110,110
"42208",2015,0,15,8,23
"42208",2017,0,0,26,26
"42208",2018,0,0,43,43
"42208",2019,0,0,15,15
"42208",2020,0,0,84,84
"42209",2013,0,0,77,77
"42209",2014,0,0,110,110
"42209",2015,0,15,8,23
"42209",2016,0,0,26,26
"42209",2017,0,0,78,78
"42209",2018,0,0,54,54
"42209",2019,0,0,43,43
"42209",2020,0,0,84,84
"42210",2013,0,0,77,77
"42210",2014,0,0,110,110
"42210",2015,0,15,85,100
"42210",2017,0,0,26,26
"42210",2018,0,0,43,43
"42210",2019,0,0,24,24
"42210",2020,0,0,84,84
"42211",2013,0,0,77,77
"42211",2014,0,0,110,110
"42211",2015,0,15,8,23
"42211",2017,0,0,49,49
"42211",2018,0,0,43,43
"42211",2019,0,0,32,32
"42211",2020,0,0,104,104
"42212",2013,0,0,77,77
"42212",2014,0,0,110,110
"42212",2015,0,15,8,23
"42212",2016,0,0,26,26
"42212",2017,0,0,78,78
"42212",2018,0,0,54,54
"42212",2019,0,0,43,43
"42212",2020,0,0,84,84
"42213",2013,0,0,77,77
"42213",2014,0,0,110,110
"42213",2015,0,15,8,23
"42213",2016,0,0,26,26
"42213",2017,0,0,78,78
"42213",2018,0,0,54,54
"42213",2019,0,0,43,43
"42213",2020,0,0,84,84
"42214",2013,0,0,77,77
"42214",2014,0,0,110,110
"42214",2015,0,15,8,23
"42214",2016,0,0,26,26
"42214",2017,0,0,86,86
"42214",2018,0,0,74,74
"42214",2019,0,0,43,43
"42214",2020,0,0,84,84
"42215",2013,0,0,77,77
"42215",2014,0,0,110,110
"42215",2015,0,15,8,23
"42215",2016,0,0,26,26
"42215",2017,0,0,90,90
"42215",2018,0,0,54,54
"42215",2019,0,0,43,43
"42215",2020,0,0,84,84
"42216",2013,0,0,77,77
"42216",2014,0,0,110,110
"42216",2015,0,15,8,23
"42216",2016,0,0,26,26
"42216",2017,0,0,86,86
"42216",2018,0,0,74,74
"42216",2019,0,0,43,43
"42216",2020,0,0,84,84
"42217",2013,0,0,77,77
"42217",2014,0,0,110,110
"42217",2015,0,15,8,23
"42217",2017,0,0,90,90
"42217",2018,0,0,43,43
"42217",2019,0,0,32,32
"42217",2020,0,0,104,104
"42218",2013,0,0,77,77
"42218",2014,0,0,110,110
"42218",2015,0,15,85,100
"42218",2017,0,0,26,26
"42218",2018,0,0,43,43
"42218",2019,0,0,24,24
"42218",2020,0,0,84,84
"42219",2013,0,0,77,77
"42219",2014,0,0,110,110
"42219",2015,0,15,8,23
"42219",2017,0,0,90,90
"42219",2018,0,0,43,43
"42219",2019,0,0,32,32
"42219",2020,0,0,104,104
"42220",2013,0,0,77,77
"42220",2014,0,0,110,110
"42220",2015,0,15,8,23
"42220",2016,0,0,26,26
"42220",2017,0,0,98,98
"42220",2018,0,0,54,54
"42220",2019,0,0,8,8
"42220",2020,0,0,104,104
"42221",2013,0,0,77,77
"42221",2014,0,0,110,110
"42221",2015,0,15,8,23
"42221",2017,0,0,90,90
"42221",2018,0,0,43,43
"42221",2019,0,0,32,32
"42221",2020,0,0,104,104
"42222",2013,0,0,77,77
"42222",2014,0,0,110,110
"42222",2015,0,15,8,23
"42222",2016,0,0,26,26
"42222",2017,0,0,86,86
"42222",2018,0,0,74,74
"42222",2019,0,0,43,43
"42222",2020,0,0,84,84
"42223",2013,0,0,77,77
"42223",2014,0,0,110,110
"42223",2015,0,15,85,100
"42223",2017,0,0,64,64
"42223",2018,0,0,43,43
"42223",2019,0,0,109,109
"42223",2020,0,0,124,124
"42224",2013,0,0,77,77
"42224",2014,0,0,110,110
"42224",2015,0,15,85,100
"42224",2017,0,0,64,64
"42224",2018,0,0,43,43
"42224",2019,0,0,52,52
"42224",2020,0,0,84,84
"42225",2013,0,0,77,77
"42225",2014,0,0,110,110
"42225",2015,0,15,85,100
"42225",2017,0,0,26,26
"42225",2018,0,0,43,43
"42225",2019,0,0,24,24
"42225",2020,0,0,84,84
"42226",2013,0,0,77,77
"42226",2014,0,0,110,110
"42226",2015,0,15,8,23
"42226",2017,0,0,78,78
"42226",2018,0,0,43,43
"42226",2019,0,0,32,32
"42226",2020,0,0,104,104
"42227",2013,0,0,77,77
"42227",2014,0,0,110,110
"42227",2015,0,15,8,23
"42227",2017,0,0,90,90
"42227",2018,0,0,43,43
"42227",2019,0,0,32,32
"42227",2020,0,0,104,104
"42228",2013,0,0,77,77
"42228",2014,0,0,110,110
"42228",2015,0,15,8,23
"42228",2017,0,0,90,90
"42228",2018,0,0,43,43
"42228",2019,0,0,32,32
"42228",2020,0,0,104,104
"42229",2013,0,0,77,77
"42229",2014,0,0,110,110
"42229",2015,0,15,8,23
"42229",2016,0,0,26,26
"42229",2017,0,0,90,90
"42229",2018,0,0,54,54
"42229",2019,0,0,43,43
"42229",2020,0,0,84,84
"42230",2013,0,0,77,77
"42230",2014,0,0,110,110
"42230",2015,0,15,8,23
"42230",2017,0,0,90,90
"42230",2018,0,0,43,43
"42230",2019,0,0,32,32
"42230",2020,0,0,104,104
"42231",2013,0,0,77,77
"42231",2014,0,0,110,110
"42231",2015,0,15,8,23
"42231",2016,0,0,26,26
"42231",2017,0,0,98,98
"42231",2018,0,0,54,54
"42231",2019,0,0,8,8
"42231",2020,0,0,104,104
"42232",2013,0,0,77,77
"42232",2014,0,0,110,110
"42232",2015,0,15,8,23
"42232",2016,0,0,26,26
"42232",2017,0,0,98,98
"42232",2018,0,0,54,54
"42232",2019,0,0,8,8
"42232",2020,0,0,104,104
"42233",2013,0,0,77,77
"42233",2014,0,0,110,110
"42233",2015,0,15,8,23
"42233",2016,0,0,26,26
"42233",2017,0,0,98,98
"42233",2018,0,0,54,54
"42233",2019,0,0,8,8
"42233",2020,0,0,104,104
"42234",2013,0,0,77,77
"42234",2014,0,0,110,110
"42234",2015,0,15,8,23
"42234",2017,0,0,57,57
"42234",2018,0,0,43,43
"42234",2019,0,0,43,43
"42234",2020,0,0,84,84
"42235",2013,0,0,77,77
"42235",2014,0,0,110,110
"42235",2015,0,15,8,23
"42235",2017,0,0,49,49
"42235",2018,0,0,43,43
"42235",2019,0,0,32,32
"42235",2020,0,0,104,104
"42236",2013,0,0,77,77
"42236",2014,0,0,110,110
"42236",2015,0,15,8,23
"42236",2016,0,0,26,26
"42236",2017,0,0,90,90
"42236",2018,0,0,54,54
"42236",2019,0,0,43,43
"42236",2020,0,0,84,84
"42237",2013,0,0,77,77
"42237",2014,0,0,110,110
"42237",2015,0,15,85,100
"42237",2017,0,0,26,26
"42237",2018,0,0,43,43
"42237",2019,0,0,24,24
"42237",2020,0,0,84,84
"42238",2013,0,0,77,77
"42238",2014,0,0,110,110
"42238",2015,0,15,8,23
"42238",2017,0,0,90,90
"42238",2018,0,0,43,43
"42238",2019,0,0,32,32
"42238",2020,0,0,104,104
"42239",2013,0,0,77,77
"42239",2014,0,0,110,110
"42239",2015,0,15,8,23
"42239",2017,0,0,78,78
"42239",2018,0,0,43,43
"42239",2019,0,0,4,4
"42239",2020,0,0,84,84
"42240",2013,0,0,77,77
"42240",2014,0,0,110,110
"42240",2015,0,15,8,23
"42240",2017,0,0,49,49
"42240",2018,0,0,43,43
"42240",2019,0,0,32,32
"42240",2020,0,0,104,104
"42241",2013,0,0,77,77
"42241",2014,0,0,110,110
"42241",2015,0,15,8,23
"42241",2016,0,0,26,26
"42241",2017,0,0,86,86
"42241",2018,0,0,74,74
"42241",2019,0,0,43,43
"42241",2020,0,0,84,84
"42242",2013,0,0,77,77
"42242",2014,0,0,110,110
"42242",2015,0,15,85,100
"42242",2017,0,0,26,26
"42242",2018,0,0,43,43
"42242",2019,0,0,24,24
"42242",2020,0,0,84,84
"42243",2013,0,0,77,77
"42243",2014,0,0,110,110
"42243",2015,0,15,8,23
"42243",2017,0,0,90,90
"42243",2018,0,0,43,43
"42243",2019,0,0,32,32
"42243",2020,0,0,104,104
"42245",2013,0,0,77,77
"42245",2014,0,0,110,110
"42245",2015,0,15,8,23
"42245",2017,0,0,90,90
"42245",2018,0,0,43,43
"42245",2019,0,0,32,32
"42245",2020,0,0,104,104
"42246",2013,0,0,77,77
"42246",2014,0,0,110,110
"42246",2015,0,15,85,100
"42246",2016,0,0,26,26
"42246",2017,0,0,130,130
"42246",2018,0,0,43,43
"42246",2019,0,0,52,52
"42246",2020,0,0,84,84
"42247",2013,0,0,77,77
"42247",2014,0,0,110,110
"42247",2015,0,15,8,23
"42247",2017,0,0,90,90
"42247",2018,0,0,43,43
"42247",2019,0,0,32,32
"42247",2020,0,0,104,104
"42248",2013,0,0,77,77
"42248",2014,0,0,110,110
"42248",2015,0,15,8,23
"42248",2017,0,0,90,90
"42248",2018,0,0,43,43
"42248",2019,0,0,32,32
"42248",2020,0,0,104,104
"42249",2013,0,0,77,77
"42249",2014,0,0,110,110
"42249",2015,0,15,8,23
"42249",2016,0,0,26,26
"42249",2017,0,0,78,78
"42249",2018,0,0,54,54
"42249",2019,0,0,43,43
"42249",2020,0,0,84,84
"42251",2013,0,0,77,77
"42251",2014,0,0,110,110
"42251",2015,0,15,8,23
"42251",2016,0,0,26,26
"42251",2017,0,0,57,57
"42251",2018,0,0,74,74
"42251",2019,0,0,43,43
"42251",2020,0,0,84,84
"42252",2013,0,0,77,77
"42252",2014,0,0,110,110
"42252",2015,0,15,8,23
"42252",2017,0,0,90,90
"42252",2018,0,0,43,43
"42252",2019,0,0,32,32
"42252",2020,0,0,104,104
"42253",2013,0,0,77,77
"42253",2014,0,0,110,110
"42253",2015,0,15,8,23
"42253",2016,0,0,26,26
"42253",2017,0,0,98,98
"42253",2018,0,0,54,54
"42253",2019,0,0,8,8
"42253",2020,0,0,104,104
"42254",2013,0,0,77,77
"42254",2014,0,0,110,110
"42254",2015,0,15,8,23
"42254",2016,0,0,26,26
"42254",2017,0,0,86,86
"42254",2018,0,0,74,74
"42254",2019,0,0,43,43
"42254",2020,0,0,84,84
"42255",2013,0,0,77,77
"42255",2014,0,0,110,110
"42255",2015,0,15,8,23
"42255",2017,0,0,90,90
"42255",2018,0,0,43,43
"42255",2019,0,0,32,32
"42255",2020,0,0,104,104
"42256",2013,0,0,77,77
"42256",2014,0,0,110,110
"42256",2015,0,15,8,23
"42256",2017,0,0,90,90
"42256",2018,0,0,43,43
"42256",2019,0,0,32,32
"42256",2020,0,0,104,104
"42257",2013,0,0,77,77
"42257",2014,0,0,110,110
"42257",2015,0,15,8,23
"42257",2016,0,0,26,26
"42257",2017,0,0,98,98
"42257",2018,0,0,54,54
"42257",2019,0,0,8,8
"42257",2020,0,0,104,104
"42259",2013,0,0,77,77
"42259",2014,0,0,110,110
"42259",2015,0,15,85,100
"42259",2017,0,0,26,26
"42259",2018,0,0,43,43
"42259",2019,0,0,24,24
"42259",2020,0,0,84,84
"42260",2013,0,0,77,77
"42260",2014,0,0,110,110
"42260",2015,0,15,8,23
"42260",2017,0,0,90,90
"42260",2018,0,0,43,43
"42260",2019,0,0,32,32
"42260",2020,0,0,104,104
"42261",2013,0,0,77,77
"42261",2014,0,0,110,110
"42261",2015,0,15,8,23
"42261",2016,0,0,26,26
"42261",2017,0,0,86,86
"42261",2018,0,0,74,74
"42261",2019,0,0,43,43
"42261",2020,0,0,84,84
"42262",2013,0,0,77,77
"42262",2014,0,0,110,110
"42262",2015,0,15,8,23
"42262",2017,0,0,49,49
"42262",2018,0,0,43,43
"42262",2019,0,0,32,32
"42262",2020,0,0,104,104
"42264",2013,0,0,77,77
"42264",2014,0,0,110,110
"42264",2015,0,15,8,23
"42264",2016,0,0,26,26
"42264",2017,0,0,86,86
"42264",2018,0,0,74,74
"42264",2019,0,0,43,43
"42264",2020,0,0,84,84
"42265",2013,0,0,77,77
"42265",2014,0,0,110,110
"42265",2015,0,15,85,100
"42265",2016,0,0,26,26
"42265",2017,0,0,130,130
"42265",2018,0,0,43,43
"42265",2019,0,0,52,52
"42265",2020,0,0,84,84
"42266",2013,0,0,77,77
"42266",2014,0,0,110,110
"42266",2015,0,15,8,23
"42266",2017,0,0,49,49
"42266",2018,0,0,43,43
"42266",2019,0,0,32,32
"42266",2020,0,0,104,104
"42267",2013,0,0,77,77
"42267",2014,0,0,110,110
"42267",2015,0,15,8,23
"42267",2016,0,0,26,26
"42267",2017,0,0,90,90
"42267",2018,0,0,54,54
"42267",2019,0,0,43,43
"42267",2020,0,0,84,84
"42268",2013,0,0,77,77
"42268",2014,0,0,110,110
"42268",2015,0,15,8,23
"42268",2017,0,0,78,78
"42268",2018,0,0,43,43
"42268",2019,0,0,32,32
"42268",2020,0,0,104,104
"42269",2013,0,0,77,77
"42269",2014,0,0,110,110
"42269",2015,0,15,8,23
"42269",2017,0,0,90,90
"42269",2018,0,0,43,43
"42269",2019,0,0,32,32
"42269",2020,0,0,104,104
"42270",2013,0,0,77,77
"42270",2014,0,0,110,110
"42270",2015,0,15,8,23
"42270",2017,0,0,49,49
"42270",2018,0,0,43,43
"42270",2019,0,0,109,109
"42270",2020,0,0,124,124
"42271",2013,0,0,77,77
"42271",2014,0,0,110,110
"42271",2015,0,15,85,100
"42271",2017,0,0,26,26
"42271",2018,0,0,43,43
"42271",2019,0,0,24,24
"42271",2020,0,0,84,84
"42272",2013,0,0,77,77
"42272",2014,0,0,110,110
"42272",2015,0,15,85,100
"42272",2016,0,0,26,26
"42272",2017,0,0,130,130
"42272",2018,0,0,43,43
"42272",2019,0,0,52,52
"42272",2020,0,0,84,84
"42273",2013,0,0,77,77
"42273",2014,0,0,110,110
"42273",2015,0,15,8,23
"42273",2016,0,0,26,26
"42273",2017,0,0,90,90
"42273",2018,0,0,54,54
"42273",2019,0,0,43,43
"42273",2020,0,0,84,84
"42274",2013,0,0,77,77
"42274",2014,0,0,110,110
"42274",2015,0,15,8,23
"42274",2017,0,0,90,90
"42274",2018,0,0,43,43
"42274",2019,0,0,32,32
"42274",2020,0,0,104,104
"42275",2013,0,0,77,77
"42275",2014,0,0,110,110
"42275",2015,0,15,85,100
"42275",2017,0,0,64,64
"42275",2018,0,0,43,43
"42275",2019,0,0,109,109
"42275",2020,0,0,124,124
"42276",2013,0,0,77,77
"42276",2014,0,0,110,110
"42276",2015,0,15,8,23
"42276",2017,0,0,90,90
"42276",2018,0,0,43,43
"42276",2019,0,0,32,32
"42276",2020,0,0,104,104
"42277",2013,0,0,77,77
"42277",2014,0,0,110,110
"42277",2015,0,15,8,23
"42277",2016,0,0,26,26
"42277",2017,0,0,78,78
"42277",2018,0,0,54,54
"42277",2019,0,0,43,43
"42277",2020,0,0,84,84
"42278",2013,0,0,77,77
"42278",2014,0,0,110,110
"42278",2015,0,15,8,23
"42278",2017,0,0,90,90
"42278",2018,0,0,43,43
"42278",2019,0,0,32,32
"42278",2020,0,0,104,104
"42279",2013,0,0,77,77
"42279",2014,0,0,110,110
"42279",2015,0,15,8,23
"42279",2017,0,0,49,49
"42279",2018,0,0,43,43
"42279",2019,0,0,32,32
"42279",2020,0,0,84,84
"42280",2013,0,0,77,77
"42280",2014,0,0,110,110
"42280",2015,0,15,85,100
"42280",2017,0,0,64,64
"42280",2018,0,0,43,43
"42280",2019,0,0,52,52
"42280",2020,0,0,84,84
"42281",2013,0,0,77,77
"42281",2014,0,0,110,110
"42281",2015,0,15,8,23
"42281",2016,0,0,26,26
"42281",2017,0,0,98,98
"42281",2018,0,0,54,54
"42281",2019,0,0,8,8
"42281",2020,0,0,104,104
"42282",2013,0,0,77,77
"42282",2014,0,0,110,110
"42282",2015,0,15,8,23
"42282",2017,0,0,90,90
"42282",2018,0,0,43,43
"42282",2019,0,0,32,32
"42282",2020,0,0,104,104
"42283",2013,0,0,77,77
"42283",2014,0,0,110,110
"42283",2015,0,15,8,23
"42283",2017,0,0,26,26
"42283",2018,0,0,43,43
"42283",2019,0,0,15,15
"42283",2020,0,0,84,84
"42284",2013,0,0,77,77
"42284",2014,0,0,110,110
"42284",2015,0,15,8,23
"42284",2016,0,0,26,26
"42284",2017,0,0,98,98
"42284",2018,0,0,54,54
"42284",2019,0,0,8,8
"42284",2020,0,0,104,104
"42285",2013,0,0,77,77
"42285",2014,0,0,110,110
"42285",2015,0,15,8,23
"42285",2017,0,0,90,90
"42285",2018,0,0,43,43
"42285",2019,0,0,32,32
"42285",2020,0,0,104,104
"42286",2013,0,0,77,77
"42286",2014,0,0,110,110
"42286",2015,0,15,85,100
"42286",2017,0,0,64,64
"42286",2018,0,0,43,43
"42286",2019,0,0,109,109
"42286",2020,0,0,124,124
"42287",2013,0,0,77,77
"42287",2014,0,0,110,110
"42287",2015,0,15,85,100
"42287",2017,0,0,64,64
"42287",2018,0,0,43,43
"42287",2019,0,0,52,52
"42287",2020,0,0,84,84
"42288",2013,0,0,77,77
"42288",2014,0,0,110,110
"42288",2015,0,15,8,23
"42288",2017,0,0,90,90
"42288",2018,0,0,43,43
"42288",2019,0,0,32,32
"42288",2020,0,0,104,104
"42289",2013,0,0,77,77
"42289",2014,0,0,110,110
"42289",2015,0,15,8,23
"42289",2016,0,0,26,26
"42289",2017,0,0,78,78
"42289",2018,0,0,54,54
"42289",2019,0,0,43,43
"42289",2020,0,0,84,84
"42290",2013,0,0,77,77
"42290",2014,0,0,110,110
"42290",2015,0,15,8,23
"42290",2017,0,0,90,90
"42290",2018,0,0,43,43
"42290",2019,0,0,32,32
"42290",2020,0,0,104,104
"42293",2013,0,0,77,77
"42293",2014,0,0,110,110
"42293",2015,0,15,8,23
"42293",2016,0,0,26,26
"42293",2017,0,0,90,90
"42293",2018,0,0,54,54
"42293",2019,0,0,43,43
"42293",2020,0,0,84,84
"42294",2013,0,0,77,77
"42294",2014,0,0,110,110
"42294",2015,0,15,8,23
"42294",2016,0,0,26,26
"42294",2017,0,0,90,90
"42294",2018,0,0,54,54
"42294",2019,0,0,43,43
"42294",2020,0,0,84,84
"42295",2013,0,0,77,77
"42295",2014,0,0,110,110
"42295",2015,0,15,8,23
"42295",2017,0,0,90,90
"42295",2018,0,0,43,43
"42295",2019,0,0,32,32
"42295",2020,0,0,104,104
"42296",2013,0,0,77,77
"42296",2014,0,0,110,110
"42296",2015,0,15,8,23
"42296",2016,0,0,26,26
"42296",2017,0,0,86,86
"42296",2018,0,0,74,74
"42296",2019,0,0,43,43
"42296",2020,0,0,84,84
"42297",2013,0,0,77,77
"42297",2014,0,0,110,110
"42297",2015,0,15,8,23
"42297",2016,0,0,26,26
"42297",2017,0,0,86,86
"42297",2018,0,0,74,74
"42297",2019,0,0,43,43
"42297",2020,0,0,84,84
"42298",2013,0,0,77,77
"42298",2014,0,0,110,110
"42298",2015,0,15,8,23
"42298",2017,0,0,90,90
"42298",2018,0,0,43,43
"42298",2019,0,0,32,32
"42298",2020,0,0,104,104
"42299",2013,0,0,77,77
"42299",2014,0,0,110,110
"42299",2015,0,15,8,23
"42299",2017,0,0,90,90
"42299",2018,0,0,43,43
"42299",2019,0,0,32,32
"42299",2020,0,0,104,104
"42300",2013,0,0,77,77
"42300",2014,0,0,110,110
"42300",2015,0,15,8,23
"42300",2016,0,0,26,26
"42300",2017,0,0,90,90
"42300",2018,0,0,54,54
"42300",2019,0,0,43,43
"42300",2020,0,0,84,84
"42301",2013,0,0,77,77
"42301",2014,0,0,110,110
"42301",2015,0,15,8,23
"42301",2017,0,0,90,90
"42301",2018,0,0,43,43
"42301",2019,0,0,32,32
"42301",2020,0,0,104,104
"42302",2013,0,0,77,77
"42302",2014,0,0,110,110
"42302",2015,0,15,8,23
"42302",2017,0,0,26,26
"42302",2018,0,0,43,43
"42302",2019,0,0,15,15
"42302",2020,0,0,84,84
"42303",2013,0,0,77,77
"42303",2014,0,0,110,110
"42303",2015,0,15,8,23
"42303",2017,0,0,90,90
"42303",2018,0,0,43,43
"42303",2019,0,0,32,32
"42303",2020,0,0,104,104
"42304",2013,0,0,77,77
"42304",2014,0,0,110,110
"42304",2015,0,15,8,23
"42304",2017,0,0,90,90
"42304",2018,0,0,43,43
"42304",2019,0,0,32,32
"42304",2020,0,0,104,104
"42305",2013,0,0,77,77
"42305",2014,0,0,110,110
"42305",2015,0,15,85,100
"42305",2017,0,0,64,64
"42305",2018,0,0,43,43
"42305",2019,0,0,109,109
"42305",2020,0,0,124,124
"42306",2013,0,0,77,77
"42306",2014,0,0,110,110
"42306",2015,0,15,85,100
"42306",2017,0,0,64,64
"42306",2018,0,0,43,43
"42306",2019,0,0,52,52
"42306",2020,0,0,84,84
"42307",2013,0,0,77,77
"42307",2014,0,0,110,110
"42307",2015,0,15,85,100
"42307",2017,0,0,26,26
"42307",2018,0,0,43,43
"42307",2019,0,0,24,24
"42307",2020,0,0,84,84
"42308",2013,0,0,77,77
"42308",2014,0,0,110,110
"42308",2015,0,15,85,100
"42308",2017,0,0,26,26
"42308",2018,0,0,43,43
"42308",2019,0,0,24,24
"42308",2020,0,0,84,84
"42310",2013,0,0,77,77
"42310",2014,0,0,110,110
"42310",2015,0,15,85,100
"42310",2017,0,0,64,64
"42310",2018,0,0,43,43
"42310",2019,0,0,52,52
"42310",2020,0,0,84,84
"42311",2013,0,0,77,77
"42311",2014,0,0,110,110
"42311",2015,0,15,85,100
"42311",2017,0,0,64,64
"42311",2018,0,0,43,43
"42311",2019,0,0,109,109
"42311",2020,0,0,124,124
"42312",2013,0,0,77,77
"42312",2014,0,0,110,110
"42312",2015,0,15,8,23
"42312",2017,0,0,90,90
"42312",2018,0,0,43,43
"42312",2019,0,0,32,32
"42312",2020,0,0,104,104
"42313",2013,0,0,77,77
"42313",2014,0,0,110,110
"42313",2015,0,15,8,23
"42313",2017,0,0,90,90
"42313",2018,0,0,43,43
"42313",2019,0,0,32,32
"42313",2020,0,0,104,104
"42314",2013,0,0,77,77
"42314",2014,0,0,110,110
"42314",2015,0,15,8,23
"42314",2017,0,0,90,90
"42314",2018,0,0,43,43
"42314",2019,0,0,32,32
"42314",2020,0,0,104,104
"42315",2013,0,0,77,77
"42315",2014,0,0,110,110
"42315",2015,0,15,8,23
"42315",2017,0,0,49,49
"42315",2018,0,0,43,43
"42315",2019,0,0,32,32
"42315",2020,0,0,104,104
"42316",2013,0,0,77,77
"42316",2014,0,0,110,110
"42316",2015,0,15,8,23
"42316",2017,0,0,49,49
"42316",2018,0,0,43,43
"42316",2019,0,0,109,109
"42316",2020,0,0,124,124
"42317",2013,0,0,77,77
"42317",2014,0,0,110,110
"42317",2015,0,15,8,23
"42317",2016,0,0,26,26
"42317",2017,0,0,98,98
"42317",2018,0,0,54,54
"42317",2019,0,0,8,8
"42317",2020,0,0,104,104
"42318",2013,0,0,77,77
"42318",2014,0,0,110,110
"42318",2015,0,15,85,100
"42318",2017,0,0,64,64
"42318",2018,0,0,43,43
"42318",2019,0,0,109,109
"42318",2020,0,0,124,124
"42319",2013,0,0,77,77
"42319",2014,0,0,110,110
"42319",2015,0,15,8,23
"42319",2016,0,0,26,26
"42319",2017,0,0,86,86
"42319",2018,0,0,74,74
"42319",2019,0,0,43,43
"42319",2020,0,0,84,84
"42320",2013,0,0,77,77
"42320",2014,0,0,110,110
"42320",2015,0,15,85,100
"42320",2017,0,0,26,26
"42320",2018,0,0,43,43
"42320",2019,0,0,15,15
"42320",2020,0,0,84,84
"42321",2013,0,0,77,77
"42321",2014,0,0,110,110
"42321",2015,0,15,8,23
"42321",2017,0,0,90,90
"42321",2018,0,0,43,43
"42321",2019,0,0,32,32
"42321",2020,0,0,104,104
"42322",2013,0,0,77,77
"42322",2014,0,0,110,110
"42322",2015,0,15,85,100
"42322",2017,0,0,26,26
"42322",2018,0,0,43,43
"42322",2019,0,0,24,24
"42322",2020,0,0,84,84
"42323",2013,0,0,77,77
"42323",2014,0,0,110,110
"42323",2015,0,15,8,23
"42323",2016,0,0,26,26
"42323",2017,0,0,57,57
"42323",2018,0,0,74,74
"42323",2019,0,0,43,43
"42323",2020,0,0,84,84
"42324",2013,0,0,77,77
"42324",2014,0,0,110,110
"42324",2015,0,15,8,23
"42324",2017,0,0,49,49
"42324",2018,0,0,43,43
"42324",2019,0,0,32,32
"42324",2020,0,0,104,104
"42325",2013,0,0,77,77
"42325",2014,0,0,110,110
"42325",2015,0,15,8,23
"42325",2016,0,0,26,26
"42325",2017,0,0,78,78
"42325",2018,0,0,54,54
"42325",2019,0,0,43,43
"42325",2020,0,0,84,84
"42326",2013,0,0,77,77
"42326",2014,0,0,110,110
"42326",2015,0,15,85,100
"42326",2017,0,0,26,26
"42326",2018,0,0,43,43
"42326",2019,0,0,24,24
"42326",2020,0,0,84,84
"42327",2013,0,0,77,77
"42327",2014,0,0,110,110
"42327",2015,0,15,85,100
"42327",2016,0,0,26,26
"42327",2017,0,0,130,130
"42327",2018,0,0,43,43
"42327",2019,0,0,52,52
"42327",2020,0,0,84,84
"42328",2013,0,0,77,77
"42328",2014,0,0,110,110
"42328",2015,0,15,8,23
"42328",2017,0,0,90,90
"42328",2018,0,0,43,43
"42328",2019,0,0,32,32
"42328",2020,0,0,104,104
"42329",2013,0,0,77,77
"42329",2014,0,0,110,110
"42329",2015,0,15,85,100
"42329",2017,0,0,64,64
"42329",2018,0,0,43,43
"42329",2019,0,0,52,52
"42329",2020,0,0,84,84
"42330",2013,0,0,77,77
"42330",2014,0,0,110,110
"42330",2015,0,15,85,100
"42330",2017,0,0,64,64
"42330",2018,0,0,43,43
"42330",2019,0,0,109,109
"42330",2020,0,0,124,124
"42331",2013,0,0,77,77
"42331",2014,0,0,110,110
"42331",2015,0,15,8,23
"42331",2017,0,0,90,90
"42331",2018,0,0,43,43
"42331",2019,0,0,4,4
"42331",2020,0,0,104,104
"42332",2013,0,0,77,77
"42332",2014,0,0,110,110
"42332",2015,0,15,8,23
"42332",2017,0,0,78,78
"42332",2018,0,0,43,43
"42332",2019,0,0,4,4
"42332",2020,0,0,84,84
"42333",2013,0,0,77,77
"42333",2014,0,0,110,110
"42333",2015,0,15,8,23
"42333",2016,0,0,26,26
"42333",2017,0,0,90,90
"42333",2018,0,0,54,54
"42333",2019,0,0,43,43
"42333",2020,0,0,84,84
"42334",2013,0,0,77,77
"42334",2014,0,0,110,110
"42334",2015,0,15,8,23
"42334",2016,0,0,26,26
"42334",2017,0,0,78,78
"42334",2018,0,0,54,54
"42334",2019,0,0,43,43
"42334",2020,0,0,84,84
"42335",2013,0,0,77,77
"42335",2014,0,0,110,110
"42335",2015,0,15,8,23
"42335",2016,0,0,26,26
"42335",2017,0,0,86,86
"42335",2018,0,0,74,74
"42335",2019,0,0,43,43
"42335",2020,0,0,84,84
"42336",2013,0,0,77,77
"42336",2014,0,0,110,110
"42336",2015,0,15,8,23
"42336",2016,0,0,26,26
"42336",2017,0,0,86,86
"42336",2018,0,0,74,74
"42336",2019,0,0,43,43
"42336",2020,0,0,84,84
"42337",2013,0,0,77,77
"42337",2014,0,0,110,110
"42337",2015,0,15,8,23
"42337",2016,0,0,26,26
"42337",2017,0,0,98,98
"42337",2018,0,0,54,54
"42337",2019,0,0,8,8
"42337",2020,0,0,104,104
"42338",2013,0,0,77,77
"42338",2014,0,0,110,110
"42338",2015,0,15,8,23
"42338",2016,0,0,26,26
"42338",2017,0,0,90,90
"42338",2018,0,0,54,54
"42338",2019,0,0,43,43
"42338",2020,0,0,84,84
"42339",2013,0,0,77,77
"42339",2014,0,0,110,110
"42339",2015,0,15,8,23
"42339",2017,0,0,90,90
"42339",2018,0,0,43,43
"42339",2019,0,0,32,32
"42339",2020,0,0,104,104
"43001",2016,0,0,33,33
"43001",2018,0,0,35,35
"43001",2019,0,0,7,7
"43001",2020,0,0,71,71
"43002",2015,0,0,8,8
"43002",2016,0,0,43,43
"43002",2018,0,0,70,70
"43002",2019,0,0,44,44
"43002",2020,0,0,71,71
"43003",2015,0,0,8,8
"43003",2016,0,0,33,33
"43003",2018,0,0,70,70
"43003",2019,0,0,32,32
"43003",2020,0,0,71,71
"43004",2016,0,0,33,33
"43004",2018,0,0,43,43
"43004",2019,0,0,7,7
"43004",2020,0,0,71,71
"43005",2015,0,0,22,22
"43005",2016,0,0,43,43
"43005",2018,0,0,43,43
"43005",2019,0,0,82,82
"43005",2020,0,0,113,113
"43006",2015,0,0,22,22
"43006",2016,0,0,33,33
"43006",2018,0,0,106,106
"43006",2019,0,0,32,32
"43006",2020,0,0,71,71
"43007",2015,0,0,171,171
"43007",2016,0,0,33,33
"43007",2018,0,0,35,35
"43007",2019,0,0,20,20
"43007",2020,0,0,71,71
"43008",2016,0,0,33,33
"43008",2018,0,0,43,43
"43008",2019,0,0,7,7
"43008",2020,0,0,71,71
"43009",2015,0,0,22,22
"43009",2016,0,0,33,33
"43009",2018,0,0,106,106
"43009",2019,0,0,32,32
"43009",2020,0,0,71,71
"43010",2016,0,0,33,33
"43010",2018,0,0,43,43
"43010",2019,0,0,7,7
"43010",2020,0,0,71,71
"43011",2015,0,0,22,22
"43011",2016,0,0,33,33
"43011",2018,0,0,106,106
"43011",2019,0,0,32,32
"43011",2020,0,0,71,71
"43012",2015,0,0,22,22
"43012",2016,0,0,33,33
"43012",2018,0,0,35,35
"43012",2019,0,0,82,82
"43012",2020,0,0,71,71
"43013",2016,0,0,33,33
"43013",2018,0,0,35,35
"43013",2019,0,0,7,7
"43013",2020,0,0,71,71
"43014",2016,0,0,33,33
"43014",2018,0,0,35,35
"43014",2019,0,0,7,7
"43014",2020,0,0,71,71
"43015",2015,0,0,22,22
"43015",2016,0,0,33,33
"43015",2018,0,0,106,106
"43015",2019,0,0,32,32
"43015",2020,0,0,71,71
"43016",2016,0,0,33,33
"43016",2018,0,0,35,35
"43016",2019,0,0,7,7
"43016",2020,0,0,71,71
"43017",2016,0,0,33,33
"43017",2018,0,0,35,35
"43017",2019,0,0,7,7
"43017",2020,0,0,71,71
"43018",2016,0,0,33,33
"43018",2018,0,0,43,43
"43018",2019,0,0,7,7
"43018",2020,0,0,71,71
"43019",2016,0,0,33,33
"43019",2018,0,0,43,43
"43019",2019,0,0,7,7
"43019",2020,0,0,71,71
"43020",2015,0,0,22,22
"43020",2016,0,0,33,33
"43020",2018,0,0,35,35
"43020",2019,0,0,82,82
"43020",2020,0,0,71,71
"43021",2015,0,0,22,22
"43021",2016,0,0,33,33
"43021",2018,0,0,35,35
"43021",2019,0,0,44,44
"43021",2020,0,0,71,71
"43022",2016,0,0,33,33
"43022",2018,0,0,35,35
"43022",2019,0,0,7,7
"43022",2020,0,0,71,71
"43023",2015,0,0,171,171
"43023",2016,0,0,33,33
"43023",2018,0,0,43,43
"43023",2019,0,0,82,82
"43023",2020,0,0,71,71
"43024",2015,0,0,22,22
"43024",2016,0,0,33,33
"43024",2018,0,0,35,35
"43024",2019,0,0,44,44
"43024",2020,0,0,71,71
"43025",2015,0,0,22,22
"43025",2016,0,0,33,33
"43025",2018,0,0,35,35
"43025",2019,0,0,44,44
"43025",2020,0,0,71,71
"43026",2015,0,0,8,8
"43026",2016,0,0,33,33
"43026",2018,0,0,43,43
"43026",2019,0,0,44,44
"43026",2020,0,0,71,71
"43027",2016,0,0,33,33
"43027",2018,0,0,35,35
"43027",2019,0,0,7,7
"43027",2020,0,0,71,71
"43028",2015,0,0,163,163
"43028",2016,0,0,33,33
"43028",2018,0,0,35,35
"43028",2019,0,0,44,44
"43028",2020,0,0,71,71
"43029",2015,0,0,22,22
"43029",2016,0,0,33,33
"43029",2018,0,0,43,43
"43029",2019,0,0,32,32
"43029",2020,0,0,71,71
"43030",2015,0,0,8,8
"43030",2016,0,0,33,33
"43030",2018,0,0,43,43
"43030",2019,0,0,44,44
"43030",2020,0,0,71,71
"43031",2015,0,0,22,22
"43031",2016,0,0,33,33
"43031",2018,0,0,106,106
"43031",2019,0,0,32,32
"43031",2020,0,0,71,71
"43032",2016,0,0,33,33
"43032",2018,0,0,35,35
"43032",2019,0,0,7,7
"43032",2020,0,0,71,71
"43033",2016,0,0,33,33
"43033",2018,0,0,35,35
"43033",2019,0,0,7,7
"43033",2020,0,0,71,71
"43034",2015,0,0,171,171
"43034",2016,0,0,33,33
"43034",2018,0,0,43,43
"43034",2019,0,0,82,82
"43034",2020,0,0,71,71
"43035",2016,0,0,33,33
"43035",2018,0,0,35,35
"43035",2019,0,0,7,7
"43035",2020,0,0,71,71
"43036",2015,0,0,8,8
"43036",2016,0,0,43,43
"43036",2018,0,0,70,70
"43036",2019,0,0,44,44
"43036",2020,0,0,71,71
"43037",2016,0,0,33,33
"43037",2018,0,0,43,43
"43037",2019,0,0,7,7
"43037",2020,0,0,71,71
"43038",2016,0,0,33,33
"43038",2018,0,0,35,35
"43038",2019,0,0,7,7
"43038",2020,0,0,71,71
"43039",2016,0,0,33,33
"43039",2018,0,0,43,43
"43039",2019,0,0,7,7
"43039",2020,0,0,71,71
"43040",2016,0,0,33,33
"43040",2018,0,0,35,35
"43040",2019,0,0,7,7
"43040",2020,0,0,71,71
"43041",2016,0,0,33,33
"43041",2018,0,0,43,43
"43041",2019,0,0,7,7
"43041",2020,0,0,71,71
"43042",2016,0,0,33,33
"43042",2018,0,0,43,43
"43042",2019,0,0,7,7
"43042",2020,0,0,71,71
"43043",2015,0,0,8,8
"43043",2016,0,0,43,43
"43043",2018,0,0,70,70
"43043",2019,0,0,44,44
"43043",2020,0,0,71,71
"43044",2016,0,0,33,33
"43044",2018,0,0,35,35
"43044",2019,0,0,7,7
"43044",2020,0,0,71,71
"43045",2016,0,0,33,33
"43045",2018,0,0,43,43
"43045",2019,0,0,7,7
"43045",2020,0,0,71,71
"43046",2016,0,0,33,33
"43046",2018,0,0,43,43
"43046",2019,0,0,7,7
"43046",2020,0,0,71,71
"43047",2016,0,0,33,33
"43047",2018,0,0,43,43
"43047",2019,0,0,7,7
"43047",2020,0,0,71,71
"43048",2016,0,0,33,33
"43048",2018,0,0,35,35
"43048",2019,0,0,7,7
"43048",2020,0,0,71,71
"43049",2015,0,0,22,22
"43049",2016,0,0,33,33
"43049",2018,0,0,35,35
"43049",2019,0,0,44,44
"43049",2020,0,0,71,71
"43050",2016,0,0,33,33
"43050",2018,0,0,35,35
"43050",2019,0,0,7,7
"43050",2020,0,0,71,71
"43051",2015,0,0,171,171
"43051",2016,0,0,33,33
"43051",2018,0,0,43,43
"43051",2019,0,0,20,20
"43051",2020,0,0,71,71
"43052",2016,0,0,33,33
"43052",2018,0,0,35,35
"43052",2019,0,0,7,7
"43052",2020,0,0,71,71
"43053",2016,0,0,33,33
"43053",2018,0,0,35,35
"43053",2019,0,0,7,7
"43053",2020,0,0,71,71
"43054",2015,0,0,22,22
"43054",2016,0,0,43,43
"43054",2018,0,0,43,43
"43054",2019,0,0,82,82
"43054",2020,0,0,113,113
"43055",2016,0,0,33,33
"43055",2018,0,0,35,35
"43055",2019,0,0,7,7
"43055",2020,0,0,71,71
"43056",2015,0,0,22,22
"43056",2016,0,0,33,33
"43056",2018,0,0,106,106
"43056",2019,0,0,32,32
"43056",2020,0,0,71,71
"43057",2016,0,0,33,33
"43057",2018,0,0,35,35
"43057",2019,0,0,7,7
"43057",2020,0,0,71,71
"43058",2015,0,0,22,22
"43058",2016,0,0,33,33
"43058",2018,0,0,35,35
"43058",2019,0,0,82,82
"43058",2020,0,0,71,71
"43059",2016,0,0,33,33
"43059",2018,0,0,35,35
"43059",2019,0,0,7,7
"43059",2020,0,0,71,71
"43060",2015,0,0,22,22
"43060",2016,0,0,33,33
"43060",2018,0,0,43,43
"43060",2019,0,0,32,32
"43060",2020,0,0,71,71
"43061",2016,0,0,33,33
"43061",2018,0,0,35,35
"43061",2019,0,0,7,7
"43061",2020,0,0,71,71
"43062",2015,0,0,8,8
"43062",2016,0,0,43,43
"43062",2018,0,0,70,70
"43062",2019,0,0,44,44
"43062",2020,0,0,71,71
"43063",2016,0,0,33,33
"43063",2018,0,0,35,35
"43063",2019,0,0,7,7
"43063",2020,0,0,71,71
"43064",2016,0,0,33,33
"43064",2018,0,0,35,35
"43064",2019,0,0,7,7
"43064",2020,0,0,71,71
"43065",2015,0,0,22,22
"43065",2016,0,0,33,33
"43065",2018,0,0,106,106
"43065",2019,0,0,32,32
"43065",2020,0,0,71,71
"43066",2016,0,0,33,33
"43066",2018,0,0,43,43
"43066",2019,0,0,7,7
"43066",2020,0,0,71,71
"43067",2016,0,0,33,33
"43067",2018,0,0,35,35
"43067",2019,0,0,7,7
"43067",2020,0,0,71,71
"43068",2015,0,0,22,22
"43068",2016,0,0,33,33
"43068",2018,0,0,43,43
"43068",2019,0,0,32,32
"43068",2020,0,0,71,71
"43069",2015,0,0,171,171
"43069",2016,0,0,33,33
"43069",2018,0,0,35,35
"43069",2019,0,0,20,20
"43069",2020,0,0,71,71
"43070",2015,0,0,22,22
"43070",2016,0,0,33,33
"43070",2018,0,0,106,106
"43070",2019,0,0,32,32
"43070",2020,0,0,71,71
"43071",2015,0,0,8,8
"43071",2016,0,0,33,33
"43071",2018,0,0,43,43
"43071",2019,0,0,44,44
"43071",2020,0,0,71,71
"43072",2016,0,0,33,33
"43072",2018,0,0,35,35
"43072",2019,0,0,7,7
"43072",2020,0,0,71,71
"43073",2016,0,0,33,33
"43073",2018,0,0,35,35
"43073",2019,0,0,7,7
"43073",2020,0,0,71,71
"43074",2016,0,0,33,33
"43074",2018,0,0,35,35
"43074",2019,0,0,7,7
"43074",2020,0,0,71,71
"43075",2016,0,0,33,33
"43075",2018,0,0,35,35
"43075",2019,0,0,7,7
"43075",2020,0,0,71,71
"43076",2016,0,0,33,33
"43076",2018,0,0,35,35
"43076",2019,0,0,7,7
"43076",2020,0,0,71,71
"43077",2016,0,0,33,33
"43077",2018,0,0,43,43
"43077",2019,0,0,7,7
"43077",2020,0,0,71,71
"43078",2016,0,0,33,33
"43078",2018,0,0,43,43
"43078",2019,0,0,7,7
"43078",2020,0,0,71,71
"43079",2016,0,0,33,33
"43079",2018,0,0,35,35
"43079",2019,0,0,7,7
"43079",2020,0,0,71,71
"43080",2015,0,0,171,171
"43080",2016,0,0,33,33
"43080",2018,0,0,35,35
"43080",2019,0,0,20,20
"43080",2020,0,0,71,71
"43082",2015,0,0,22,22
"43082",2016,0,0,33,33
"43082",2018,0,0,106,106
"43082",2019,0,0,32,32
"43082",2020,0,0,71,71
"43083",2015,0,0,22,22
"43083",2016,0,0,43,43
"43083",2018,0,0,43,43
"43083",2019,0,0,82,82
"43083",2020,0,0,113,113
"43084",2016,0,0,33,33
"43084",2018,0,0,43,43
"43084",2019,0,0,7,7
"43084",2020,0,0,71,71
"43085",2015,0,0,22,22
"43085",2016,0,0,33,33
"43085",2018,0,0,43,43
"43085",2019,0,0,32,32
"43085",2020,0,0,71,71
"43086",2016,0,0,33,33
"43086",2018,0,0,35,35
"43086",2019,0,0,7,7
"43086",2020,0,0,71,71
"43087",2015,0,0,171,171
"43087",2016,0,0,33,33
"43087",2018,0,0,35,35
"43087",2019,0,0,20,20
"43087",2020,0,0,71,71
"43088",2016,0,0,33,33
"43088",2018,0,0,35,35
"43088",2019,0,0,7,7
"43088",2020,0,0,71,71
"43089",2015,0,0,8,8
"43089",2016,0,0,43,43
"43089",2018,0,0,70,70
"43089",2019,0,0,44,44
"43089",2020,0,0,71,71
"43090",2015,0,0,22,22
"43090",2016,0,0,43,43
"43090",2018,0,0,43,43
"43090",2019,0,0,82,82
"43090",2020,0,0,113,113
"43091",2016,0,0,33,33
"43091",2018,0,0,43,43
"43091",2019,0,0,7,7
"43091",2020,0,0,71,71
"43092",2016,0,0,33,33
"43092",2018,0,0,43,43
"43092",2019,0,0,7,7
"43092",2020,0,0,71,71
"43093",2016,0,0,33,33
"43093",2018,0,0,35,35
"43093",2019,0,0,7,7
"43093",2020,0,0,71,71
"43094",2015,0,0,22,22
"43094",2016,0,0,33,33
"43094",2018,0,0,106,106
"43094",2019,0,0,32,32
"43094",2020,0,0,71,71
"43095",2016,0,0,33,33
"43095",2018,0,0,35,35
"43095",2019,0,0,7,7
"43095",2020,0,0,71,71
"43096",2016,0,0,33,33
"43096",2018,0,0,35,35
"43096",2019,0,0,7,7
"43096",2020,0,0,71,71
"43097",2016,0,0,33,33
"43097",2018,0,0,43,43
"43097",2019,0,0,7,7
"43097",2020,0,0,71,71
"43098",2016,0,0,33,33
"43098",2018,0,0,43,43
"43098",2019,0,0,7,7
"43098",2020,0,0,71,71
"43099",2016,0,0,33,33
"43099",2018,0,0,35,35
"43099",2019,0,0,7,7
"43099",2020,0,0,71,71
"43100",2016,0,0,33,33
"43100",2018,0,0,35,35
"43100",2019,0,0,7,7
"43100",2020,0,0,71,71
"43101",2016,0,0,33,33
"43101",2018,0,0,43,43
"43101",2019,0,0,7,7
"43101",2020,0,0,71,71
"43102",2015,0,0,171,171
"43102",2016,0,0,33,33
"43102",2018,0,0,35,35
"43102",2019,0,0,20,20
"43102",2020,0,0,71,71
"43103",2016,0,0,33,33
"43103",2018,0,0,35,35
"43103",2019,0,0,7,7
"43103",2020,0,0,71,71
"43104",2015,0,0,22,22
"43104",2016,0,0,43,43
"43104",2018,0,0,43,43
"43104",2019,0,0,82,82
"43104",2020,0,0,113,113
"43105",2016,0,0,33,33
"43105",2018,0,0,35,35
"43105",2019,0,0,7,7
"43105",2020,0,0,71,71
"43106",2016,0,0,33,33
"43106",2018,0,0,35,35
"43106",2019,0,0,7,7
"43106",2020,0,0,71,71
"43107",2016,0,0,33,33
"43107",2018,0,0,35,35
"43107",2019,0,0,7,7
"43107",2020,0,0,71,71
"43108",2015,0,0,171,171
"43108",2016,0,0,33,33
"43108",2018,0,0,35,35
"43108",2019,0,0,20,20
"43108",2020,0,0,71,71
"43109",2016,0,0,33,33
"43109",2018,0,0,43,43
"43109",2019,0,0,7,7
"43109",2020,0,0,71,71
"43110",2016,0,0,33,33
"43110",2018,0,0,35,35
"43110",2019,0,0,7,7
"43110",2020,0,0,71,71
"43111",2016,0,0,33,33
"43111",2018,0,0,43,43
"43111",2019,0,0,7,7
"43111",2020,0,0,71,71
"43112",2015,0,0,22,22
"43112",2016,0,0,33,33
"43112",2018,0,0,106,106
"43112",2019,0,0,32,32
"43112",2020,0,0,71,71
"43113",2016,0,0,33,33
"43113",2018,0,0,35,35
"43113",2019,0,0,7,7
"43113",2020,0,0,71,71
"43114",2015,0,0,171,171
"43114",2016,0,0,33,33
"43114",2018,0,0,35,35
"43114",2019,0,0,20,20
"43114",2020,0,0,71,71
"43115",2016,0,0,33,33
"43115",2018,0,0,35,35
"43115",2019,0,0,7,7
"43115",2020,0,0,71,71
"43116",2016,0,0,33,33
"43116",2018,0,0,35,35
"43116",2019,0,0,7,7
"43116",2020,0,0,71,71
"43117",2016,0,0,33,33
"43117",2018,0,0,35,35
"43117",2019,0,0,7,7
"43117",2020,0,0,71,71
"43118",2015,0,0,22,22
"43118",2016,0,0,33,33
"43118",2018,0,0,106,106
"43118",2019,0,0,32,32
"43118",2020,0,0,71,71
"43119",2015,0,0,8,8
"43119",2016,0,0,33,33
"43119",2018,0,0,35,35
"43119",2019,0,0,44,44
"43119",2020,0,0,71,71
"43120",2016,0,0,33,33
"43120",2018,0,0,35,35
"43120",2019,0,0,7,7
"43120",2020,0,0,71,71
"43121",2016,0,0,33,33
"43121",2018,0,0,35,35
"43121",2019,0,0,7,7
"43121",2020,0,0,71,71
"43122",2015,0,0,8,8
"43122",2016,0,0,43,43
"43122",2018,0,0,70,70
"43122",2019,0,0,44,44
"43122",2020,0,0,71,71
"43123",2016,0,0,33,33
"43123",2018,0,0,35,35
"43123",2019,0,0,7,7
"43123",2020,0,0,71,71
"43124",2015,0,0,8,8
"43124",2016,0,0,43,43
"43124",2018,0,0,70,70
"43124",2019,0,0,44,44
"43124",2020,0,0,71,71
"43125",2016,0,0,33,33
"43125",2018,0,0,35,35
"43125",2019,0,0,7,7
"43125",2020,0,0,71,71
"43126",2015,0,0,163,163
"43126",2016,0,0,33,33
"43126",2018,0,0,35,35
"43126",2019,0,0,44,44
"43126",2020,0,0,71,71
"43127",2015,0,0,22,22
"43127",2016,0,0,33,33
"43127",2018,0,0,35,35
"43127",2019,0,0,82,82
"43127",2020,0,0,71,71
"43128",2016,0,0,33,33
"43128",2018,0,0,35,35
"43128",2019,0,0,7,7
"43128",2020,0,0,71,71
"43129",2015,0,0,171,171
"43129",2016,0,0,33,33
"43129",2018,0,0,43,43
"43129",2019,0,0,20,20
"43129",2020,0,0,71,71
"43130",2015,0,0,171,171
"43130",2016,0,0,33,33
"43130",2018,0,0,35,35
"43130",2019,0,0,20,20
"43130",2020,0,0,71,71
"43131",2016,0,0,33,33
"43131",2018,0,0,35,35
"43131",2019,0,0,7,7
"43131",2020,0,0,71,71
"43132",2016,0,0,33,33
"43132",2018,0,0,35,35
"43132",2019,0,0,7,7
"43132",2020,0,0,71,71
"43133",2016,0,0,33,33
"43133",2018,0,0,35,35
"43133",2019,0,0,7,7
"43133",2020,0,0,71,71
"43134",2015,0,0,163,163
"43134",2016,0,0,33,33
"43134",2018,0,0,35,35
"43134",2019,0,0,44,44
"43134",2020,0,0,71,71
"43135",2016,0,0,33,33
"43135",2018,0,0,43,43
"43135",2019,0,0,7,7
"43135",2020,0,0,71,71
"43136",2015,0,0,22,22
"43136",2016,0,0,43,43
"43136",2018,0,0,43,43
"43136",2019,0,0,82,82
"43136",2020,0,0,113,113
"43137",2015,0,0,22,22
"43137",2016,0,0,33,33
"43137",2018,0,0,35,35
"43137",2019,0,0,44,44
"43137",2020,0,0,71,71
"43138",2016,0,0,33,33
"43138",2018,0,0,35,35
"43138",2019,0,0,7,7
"43138",2020,0,0,71,71
"43139",2016,0,0,33,33
"43139",2018,0,0,35,35
"43139",2019,0,0,7,7
"43139",2020,0,0,71,71
"43140",2016,0,0,33,33
"43140",2018,0,0,35,35
"43140",2019,0,0,7,7
"43140",2020,0,0,71,71
"43141",2015,0,0,171,171
"43141",2016,0,0,33,33
"43141",2018,0,0,35,35
"43141",2019,0,0,20,20
"43141",2020,0,0,71,71
"43142",2015,0,0,171,171
"43142",2016,0,0,33,33
"43142",2018,0,0,35,35
"43142",2019,0,0,20,20
"43142",2020,0,0,71,71
"43143",2016,0,0,33,33
"43143",2018,0,0,35,35
"43143",2019,0,0,7,7
"43143",2020,0,0,71,71
"43144",2016,0,0,33,33
"43144",2018,0,0,43,43
"43144",2019,0,0,7,7
"43144",2020,0,0,71,71
"43145",2015,0,0,22,22
"43145",2016,0,0,43,43
"43145",2018,0,0,43,43
"43145",2019,0,0,82,82
"43145",2020,0,0,113,113
"43147",2016,0,0,33,33
"43147",2018,0,0,35,35
"43147",2019,0,0,7,7
"43147",2020,0,0,71,71
"43148",2016,0,0,33,33
"43148",2018,0,0,35,35
"43148",2019,0,0,7,7
"43148",2020,0,0,71,71
"43149",2015,0,0,22,22
"43149",2016,0,0,33,33
"43149",2018,0,0,43,43
"43149",2019,0,0,32,32
"43149",2020,0,0,71,71
"43150",2015,0,0,163,163
"43150",2016,0,0,33,33
"43150",2018,0,0,35,35
"43150",2019,0,0,44,44
"43150",2020,0,0,71,71
"43151",2015,0,0,22,22
"43151",2016,0,0,33,33
"43151",2018,0,0,106,106
"43151",2019,0,0,32,32
"43151",2020,0,0,71,71
"43152",2015,0,0,8,8
"43152",2016,0,0,33,33
"43152",2018,0,0,35,35
"43152",2019,0,0,44,44
"43152",2020,0,0,71,71
"43153",2015,0,0,171,171
"43153",2016,0,0,33,33
"43153",2018,0,0,35,35
"43153",2019,0,0,82,82
"43153",2020,0,0,71,71
"43154",2016,0,0,33,33
"43154",2018,0,0,43,43
"43154",2019,0,0,7,7
"43154",2020,0,0,71,71
"43155",2015,0,0,22,22
"43155",2016,0,0,33,33
"43155",2018,0,0,43,43
"43155",2019,0,0,32,32
"43155",2020,0,0,71,71
"43156",2016,0,0,33,33
"43156",2018,0,0,43,43
"43156",2019,0,0,7,7
"43156",2020,0,0,71,71
"43157",2016,0,0,33,33
"43157",2018,0,0,43,43
"43157",2019,0,0,7,7
"43157",2020,0,0,71,71
"43158",2015,0,0,163,163
"43158",2016,0,0,33,33
"43158",2018,0,0,35,35
"43158",2019,0,0,44,44
"43158",2020,0,0,71,71
"43159",2015,0,0,171,171
"43159",2016,0,0,33,33
"43159",2018,0,0,35,35
"43159",2019,0,0,20,20
"43159",2020,0,0,71,71
"43160",2015,0,0,22,22
"43160",2016,0,0,43,43
"43160",2018,0,0,43,43
"43160",2019,0,0,82,82
"43160",2020,0,0,113,113
"43162",2015,0,0,22,22
"43162",2016,0,0,33,33
"43162",2018,0,0,35,35
"43162",2019,0,0,44,44
"43162",2020,0,0,71,71
"43163",2015,0,0,171,171
"43163",2016,0,0,33,33
"43163",2018,0,0,35,35
"43163",2019,0,0,44,44
"43163",2020,0,0,71,71
"43164",2015,0,0,22,22
"43164",2016,0,0,33,33
"43164",2018,0,0,43,43
"43164",2019,0,0,82,82
"43164",2020,0,0,71,71
"43165",2015,0,0,163,163
"43165",2016,0,0,33,33
"43165",2018,0,0,35,35
"43165",2019,0,0,44,44
"43165",2020,0,0,71,71
"43166",2015,0,0,171,171
"43166",2016,0,0,33,33
"43166",2018,0,0,43,43
"43166",2019,0,0,82,82
"43166",2020,0,0,71,71
"43167",2015,0,0,22,22
"43167",2016,0,0,33,33
"43167",2018,0,0,106,106
"43167",2019,0,0,32,32
"43167",2020,0,0,71,71
"43168",2016,0,0,33,33
"43168",2018,0,0,43,43
"43168",2019,0,0,7,7
"43168",2020,0,0,71,71
"43169",2015,0,0,22,22
"43169",2016,0,0,33,33
"43169",2018,0,0,106,106
"43169",2019,0,0,32,32
"43169",2020,0,0,71,71
"43170",2016,0,0,33,33
"43170",2018,0,0,35,35
"43170",2019,0,0,7,7
"43170",2020,0,0,71,71
"43171",2015,0,0,8,8
"43171",2016,0,0,33,33
"43171",2018,0,0,43,43
"43171",2019,0,0,32,32
"43171",2020,0,0,71,71
"43172",2015,0,0,171,171
"43172",2016,0,0,33,33
"43172",2018,0,0,35,35
"43172",2019,0,0,20,20
"43172",2020,0,0,71,71
"43173",2015,0,0,22,22
"43173",2016,0,0,43,43
"43173",2018,0,0,43,43
"43173",2019,0,0,82,82
"43173",2020,0,0,113,113
"43174",2016,0,0,33,33
"43174",2018,0,0,43,43
"43174",2019,0,0,7,7
"43174",2020,0,0,71,71
"43175",2015,0,0,22,22
"43175",2016,0,0,33,33
"43175",2018,0,0,106,106
"43175",2019,0,0,32,32
"43175",2020,0,0,71,71
"43177",2015,0,0,171,171
"43177",2016,0,0,33,33
"43177",2018,0,0,35,35
"43177",2019,0,0,44,44
"43177",2020,0,0,71,71
"43178",2016,0,0,33,33
"43178",2018,0,0,35,35
"43178",2019,0,0,7,7
"43178",2020,0,0,71,71
"43180",2016,0,0,33,33
"43180",2018,0,0,43,43
"43180",2019,0,0,7,7
"43180",2020,0,0,71,71
"43181",2015,0,0,163,163
"43181",2016,0,0,33,33
"43181",2018,0,0,35,35
"43181",2019,0,0,44,44
"43181",2020,0,0,71,71
"43182",2016,0,0,33,33
"43182",2018,0,0,35,35
"43182",2019,0,0,7,7
"43182",2020,0,0,71,71
"43183",2016,0,0,33,33
"43183",2018,0,0,35,35
"43183",2019,0,0,7,7
"43183",2020,0,0,71,71
"43184",2015,0,0,171,171
"43184",2016,0,0,33,33
"43184",2018,0,0,35,35
"43184",2019,0,0,82,82
"43184",2020,0,0,71,71
"43185",2016,0,0,33,33
"43185",2018,0,0,35,35
"43185",2019,0,0,7,7
"43185",2020,0,0,71,71
"43186",2016,0,0,33,33
"43186",2018,0,0,35,35
"43186",2019,0,0,7,7
"43186",2020,0,0,71,71
"43187",2015,0,0,8,8
"43187",2016,0,0,33,33
"43187",2018,0,0,43,43
"43187",2019,0,0,44,44
"43187",2020,0,0,71,71
"43188",2016,0,0,33,33
"43188",2018,0,0,35,35
"43188",2019,0,0,7,7
"43188",2020,0,0,71,71
"43189",2015,0,0,171,171
"43189",2016,0,0,33,33
"43189",2018,0,0,43,43
"43189",2019,0,0,82,82
"43189",2020,0,0,71,71
"43190",2016,0,0,33,33
"43190",2018,0,0,35,35
"43190",2019,0,0,7,7
"43190",2020,0,0,71,71
"43191",2016,0,0,33,33
"43191",2018,0,0,35,35
"43191",2019,0,0,7,7
"43191",2020,0,0,71,71
"43192",2015,0,0,22,22
"43192",2016,0,0,43,43
"43192",2018,0,0,43,43
"43192",2019,0,0,82,82
"43192",2020,0,0,113,113
"43193",2016,0,0,33,33
"43193",2018,0,0,35,35
"43193",2019,0,0,7,7
"43193",2020,0,0,71,71
"43194",2015,0,0,163,163
"43194",2016,0,0,33,33
"43194",2018,0,0,35,35
"43194",2019,0,0,44,44
"43194",2020,0,0,71,71
"43195",2015,0,0,22,22
"43195",2016,0,0,33,33
"43195",2018,0,0,106,106
"43195",2019,0,0,32,32
"43195",2020,0,0,71,71
"43196",2015,0,0,171,171
"43196",2016,0,0,33,33
"43196",2018,0,0,35,35
"43196",2019,0,0,20,20
"43196",2020,0,0,71,71
"43197",2015,0,0,8,8
"43197",2016,0,0,33,33
"43197",2018,0,0,43,43
"43197",2019,0,0,32,32
"43197",2020,0,0,71,71
"43198",2016,0,0,33,33
"43198",2018,0,0,43,43
"43198",2019,0,0,7,7
"43198",2020,0,0,71,71
"43199",2015,0,0,171,171
"43199",2016,0,0,33,33
"43199",2018,0,0,35,35
"43199",2019,0,0,20,20
"43199",2020,0,0,71,71
"43200",2016,0,0,33,33
"43200",2018,0,0,35,35
"43200",2019,0,0,7,7
"43200",2020,0,0,71,71
"43201",2015,0,0,171,171
"43201",2016,0,0,33,33
"43201",2018,0,0,43,43
"43201",2019,0,0,82,82
"43201",2020,0,0,71,71
"43202",2015,0,0,22,22
"43202",2016,0,0,33,33
"43202",2018,0,0,43,43
"43202",2019,0,0,32,32
"43202",2020,0,0,71,71
"43203",2015,0,0,163,163
"43203",2016,0,0,33,33
"43203",2018,0,0,35,35
"43203",2019,0,0,44,44
"43203",2020,0,0,71,71
"43204",2015,0,0,171,171
"43204",2016,0,0,33,33
"43204",2018,0,0,35,35
"43204",2019,0,0,20,20
"43204",2020,0,0,71,71
"43205",2015,0,0,171,171
"43205",2016,0,0,33,33
"43205",2018,0,0,35,35
"43205",2019,0,0,82,82
"43205",2020,0,0,71,71
"43206",2016,0,0,33,33
"43206",2018,0,0,35,35
"43206",2019,0,0,7,7
"43206",2020,0,0,71,71
"43207",2016,0,0,33,33
"43207",2018,0,0,35,35
"43207",2019,0,0,7,7
"43207",2020,0,0,71,71
"43208",2016,0,0,33,33
"43208",2018,0,0,35,35
"43208",2019,0,0,7,7
"43208",2020,0,0,71,71
"43210",2016,0,0,33,33
"43210",2018,0,0,43,43
"43210",2019,0,0,7,7
"43210",2020,0,0,71,71
"43211",2015,0,0,22,22
"43211",2016,0,0,33,33
"43211",2018,0,0,35,35
"43211",2019,0,0,44,44
"43211",2020,0,0,71,71
"43212",2015,0,0,171,171
"43212",2016,0,0,33,33
"43212",2018,0,0,43,43
"43212",2019,0,0,82,82
"43212",2020,0,0,71,71
"43213",2015,0,0,171,171
"43213",2016,0,0,33,33
"43213",2018,0,0,35,35
"43213",2019,0,0,44,44
"43213",2020,0,0,71,71
"43214",2016,0,0,33,33
"43214",2018,0,0,35,35
"43214",2019,0,0,7,7
"43214",2020,0,0,71,71
"43215",2016,0,0,33,33
"43215",2018,0,0,43,43
"43215",2019,0,0,7,7
"43215",2020,0,0,71,71
"43216",2015,0,0,8,8
"43216",2016,0,0,33,33
"43216",2018,0,0,43,43
"43216",2019,0,0,44,44
"43216",2020,0,0,71,71
"43217",2015,0,0,8,8
"43217",2016,0,0,33,33
"43217",2018,0,0,43,43
"43217",2019,0,0,44,44
"43217",2020,0,0,71,71
"43218",2016,0,0,33,33
"43218",2018,0,0,35,35
"43218",2019,0,0,7,7
"43218",2020,0,0,71,71
"43219",2016,0,0,33,33
"43219",2018,0,0,35,35
"43219",2019,0,0,7,7
"43219",2020,0,0,71,71
"43220",2015,0,0,22,22
"43220",2016,0,0,43,43
"43220",2018,0,0,43,43
"43220",2019,0,0,82,82
"43220",2020,0,0,113,113
"43221",2016,0,0,33,33
"43221",2018,0,0,43,43
"43221",2019,0,0,7,7
"43221",2020,0,0,71,71
"43222",2016,0,0,33,33
"43222",2018,0,0,35,35
"43222",2019,0,0,7,7
"43222",2020,0,0,71,71
"43223",2015,0,0,171,171
"43223",2016,0,0,33,33
"43223",2018,0,0,35,35
"43223",2019,0,0,44,44
"43223",2020,0,0,71,71
"43224",2015,0,0,171,171
"43224",2016,0,0,33,33
"43224",2018,0,0,35,35
"43224",2019,0,0,44,44
"43224",2020,0,0,71,71
"43225",2015,0,0,22,22
"43225",2016,0,0,43,43
"43225",2018,0,0,43,43
"43225",2019,0,0,82,82
"43225",2020,0,0,113,113
"43226",2016,0,0,33,33
"43226",2018,0,0,35,35
"43226",2019,0,0,7,7
"43226",2020,0,0,71,71
"43227",2015,0,0,171,171
"43227",2016,0,0,33,33
"43227",2018,0,0,35,35
"43227",2019,0,0,44,44
"43227",2020,0,0,71,71
"43228",2015,0,0,171,171
"43228",2016,0,0,33,33
"43228",2018,0,0,35,35
"43228",2019,0,0,20,20
"43228",2020,0,0,71,71
"43229",2015,0,0,8,8
"43229",2016,0,0,43,43
"43229",2018,0,0,70,70
"43229",2019,0,0,44,44
"43229",2020,0,0,71,71
"43230",2015,0,0,8,8
"43230",2016,0,0,33,33
"43230",2018,0,0,35,35
"43230",2019,0,0,44,44
"43230",2020,0,0,71,71
"43231",2016,0,0,33,33
"43231",2018,0,0,43,43
"43231",2019,0,0,7,7
"43231",2020,0,0,71,71
"43232",2016,0,0,33,33
"43232",2018,0,0,35,35
"43232",2019,0,0,7,7
"43232",2020,0,0,71,71
"43233",2016,0,0,33,33
"43233",2018,0,0,43,43
"43233",2019,0,0,7,7
"43233",2020,0,0,71,71
"43234",2015,0,0,22,22
"43234",2016,0,0,33,33
"43234",2018,0,0,43,43
"43234",2019,0,0,32,32
"43234",2020,0,0,71,71
"43236",2015,0,0,171,171
"43236",2016,0,0,33,33
"43236",2018,0,0,35,35
"43236",2019,0,0,44,44
"43236",2020,0,0,71,71
"43237",2016,0,0,33,33
"43237",2018,0,0,35,35
"43237",2019,0,0,7,7
"43237",2020,0,0,71,71
"43238",2016,0,0,33,33
"43238",2018,0,0,43,43
"43238",2019,0,0,7,7
"43238",2020,0,0,71,71
"43239",2015,0,0,8,8
"43239",2016,0,0,33,33
"43239",2018,0,0,43,43
"43239",2019,0,0,32,32
"43239",2020,0,0,71,71
"43240",2015,0,0,171,171
"43240",2016,0,0,33,33
"43240",2018,0,0,43,43
"43240",2019,0,0,82,82
"43240",2020,0,0,71,71
"43241",2016,0,0,33,33
"43241",2018,0,0,43,43
"43241",2019,0,0,7,7
"43241",2020,0,0,71,71
"43242",2015,0,0,22,22
"43242",2016,0,0,33,33
"43242",2018,0,0,106,106
"43242",2019,0,0,32,32
"43242",2020,0,0,71,71
"43244",2015,0,0,171,171
"43244",2016,0,0,33,33
"43244",2018,0,0,35,35
"43244",2019,0,0,20,20
"43244",2020,0,0,71,71
"43245",2015,0,0,22,22
"43245",2016,0,0,43,43
"43245",2018,0,0,43,43
"43245",2019,0,0,82,82
"43245",2020,0,0,113,113
"43246",2015,0,0,171,171
"43246",2016,0,0,33,33
"43246",2018,0,0,35,35
"43246",2019,0,0,82,82
"43246",2020,0,0,71,71
"43247",2016,0,0,33,33
"43247",2018,0,0,35,35
"43247",2019,0,0,7,7
"43247",2020,0,0,71,71
"43249",2015,0,0,171,171
"43249",2016,0,0,33,33
"43249",2018,0,0,35,35
"43249",2019,0,0,82,82
"43249",2020,0,0,71,71
"43250",2016,0,0,33,33
"43250",2018,0,0,35,35
"43250",2019,0,0,7,7
"43250",2020,0,0,71,71
"43251",2016,0,0,33,33
"43251",2018,0,0,43,43
"43251",2019,0,0,7,7
"43251",2020,0,0,71,71
"43252",2016,0,0,33,33
"43252",2018,0,0,35,35
"43252",2019,0,0,7,7
"43252",2020,0,0,71,71
"43253",2015,0,0,171,171
"43253",2016,0,0,33,33
"43253",2018,0,0,43,43
"43253",2019,0,0,20,20
"43253",2020,0,0,71,71
"43254",2015,0,0,8,8
"43254",2016,0,0,33,33
"43254",2018,0,0,70,70
"43254",2019,0,0,32,32
"43254",2020,0,0,71,71
"43256",2015,0,0,22,22
"43256",2016,0,0,33,33
"43256",2018,0,0,43,43
"43256",2019,0,0,32,32
"43256",2020,0,0,71,71
"43257",2016,0,0,33,33
"43257",2018,0,0,43,43
"43257",2019,0,0,7,7
"43257",2020,0,0,71,71
"43258",2016,0,0,33,33
"43258",2018,0,0,35,35
"43258",2019,0,0,7,7
"43258",2020,0,0,71,71
"43259",2015,0,0,8,8
"43259",2016,0,0,33,33
"43259",2018,0,0,70,70
"43259",2019,0,0,32,32
"43259",2020,0,0,71,71
"43260",2015,0,0,8,8
"43260",2016,0,0,43,43
"43260",2018,0,0,43,43
"43260",2019,0,0,44,44
"43260",2020,0,0,71,71
"43261",2016,0,0,33,33
"43261",2018,0,0,35,35
"43261",2019,0,0,7,7
"43261",2020,0,0,71,71
"43262",2016,0,0,33,33
"43262",2018,0,0,35,35
"43262",2019,0,0,7,7
"43262",2020,0,0,71,71
"43263",2016,0,0,33,33
"43263",2018,0,0,43,43
"43263",2019,0,0,7,7
"43263",2020,0,0,71,71
"43264",2015,0,0,22,22
"43264",2016,0,0,33,33
"43264",2018,0,0,106,106
"43264",2019,0,0,32,32
"43264",2020,0,0,71,71
"43265",2015,0,0,171,171
"43265",2016,0,0,33,33
"43265",2018,0,0,35,35
"43265",2019,0,0,44,44
"43265",2020,0,0,71,71
"43267",2015,0,0,8,8
"43267",2016,0,0,33,33
"43267",2018,0,0,35,35
"43267",2019,0,0,44,44
"43267",2020,0,0,71,71
"43268",2015,0,0,171,171
"43268",2016,0,0,33,33
"43268",2018,0,0,35,35
"43268",2019,0,0,20,20
"43268",2020,0,0,71,71
"44001",2020,0,0,54,54
"44002",2020,0,0,37,37
"44003",2020,0,0,72,72
"44005",2020,0,0,37,37
"44006",2020,0,0,72,72
"44007",2020,0,0,54,54
"44009",2020,0,0,67,67
"44010",2020,0,0,72,72
"44012",2020,0,0,37,37
"44013",2020,0,0,72,72
"44014",2020,0,0,37,37
"44015",2020,0,0,54,54
"44016",2020,0,0,72,72
"44018",2020,0,0,37,37
"44019",2019,0,0,21,21
"44019",2020,0,0,121,121
"44020",2020,0,0,37,37
"44021",2020,0,143,37,180
"44022",2019,0,0,21,21
"44022",2020,0,0,67,67
"44023",2020,0,0,54,54
"44024",2020,0,0,37,37
"44025",2020,0,0,72,72
"44026",2020,0,0,108,108
"44027",2020,0,143,115,258
"44028",2020,0,0,72,72
"44029",2020,0,0,72,72
"44030",2020,0,0,72,72
"44031",2020,0,0,54,54
"44032",2020,0,0,67,67
"44033",2020,0,0,72,72
"44035",2020,0,0,115,115
"44036",2020,0,0,54,54
"44037",2020,0,0,37,37
"44038",2020,0,0,37,37
"44039",2019,0,0,21,21
"44039",2020,0,0,121,121
"44041",2020,0,143,37,180
"44043",2019,0,0,21,21
"44043",2020,0,0,67,67
"44044",2020,0,0,54,54
"44045",2020,0,0,108,108
"44046",2020,0,0,37,37
"44047",2020,0,0,72,72
"44048",2020,0,0,72,72
"44049",2020,0,0,72,72
"44050",2020,0,0,72,72
"44051",2020,0,0,54,54
"44052",2020,0,0,72,72
"44053",2020,0,0,72,72
"44054",2020,0,0,54,54
"44055",2020,0,0,72,72
"44056",2020,0,0,54,54
"44057",2020,0,0,54,54
"44058",2020,0,0,54,54
"44061",2020,0,0,37,37
"44062",2020,0,0,54,54
"44063",2019,0,0,21,21
"44063",2020,0,0,67,67
"44064",2019,0,0,21,21
"44064",2020,0,0,67,67
"44065",2020,0,0,54,54
"44066",2020,0,0,54,54
"44067",2020,0,0,54,54
"44068",2020,0,0,54,54
"44069",2020,0,0,72,72
"44070",2020,0,0,67,67
"44071",2020,0,0,67,67
"44072",2020,0,0,72,72
"44073",2020,0,143,54,197
"44074",2019,0,0,21,21
"44074",2020,0,0,121,121
"44075",2020,0,0,54,54
"44076",2020,0,0,54,54
"44077",2020,0,0,54,54
"44078",2020,0,0,54,54
"44079",2020,0,0,72,72
"44080",2020,0,0,72,72
"44081",2020,0,0,37,37
"44082",2020,0,0,72,72
"44083",2020,0,0,37,37
"44084",2020,0,0,72,72
"44085",2020,0,0,54,54
"44086",2020,0,0,54,54
"44087",2020,0,143,37,180
"44088",2019,0,0,21,21
"44088",2020,0,0,67,67
"44089",2020,0,0,54,54
"44090",2020,0,0,37,37
"44091",2020,0,0,54,54
"44092",2020,0,0,54,54
"44094",2020,0,0,72,72
"44095",2020,0,0,54,54
"44096",2020,0,0,72,72
"44097",2020,0,0,72,72
"44098",2020,0,0,54,54
"44099",2020,0,0,54,54
"44100",2019,0,0,21,21
"44100",2020,0,0,67,67
"44101",2019,0,0,21,21
"44101",2020,0,0,121,121
"44102",2020,0,0,37,37
"44103",2020,0,0,72,72
"44104",2020,0,0,72,72
"44105",2020,0,0,54,54
"44106",2020,0,0,37,37
"44107",2020,0,0,72,72
"44108",2019,0,0,21,21
"44108",2020,0,0,67,67
"44109",2020,0,0,67,67
"44110",2020,0,143,54,197
"44111",2020,0,0,54,54
"44112",2020,0,0,54,54
"44113",2020,0,0,54,54
"44114",2020,0,0,72,72
"44115",2020,0,0,72,72
"44116",2020,0,0,72,72
"44117",2020,0,0,67,67
"44118",2020,0,0,72,72
"44119",2020,0,0,37,37
"44120",2019,0,0,21,21
"44120",2020,0,0,121,121
"44121",2020,0,0,54,54
"44122",2020,0,0,115,115
"44123",2020,0,0,54,54
"44124",2020,0,0,54,54
"44125",2020,0,0,72,72
"44126",2020,0,0,37,37
"44127",2020,0,0,37,37
"44128",2020,0,0,54,54
"44129",2020,0,0,72,72
"44130",2020,0,0,37,37
"44131",2020,0,0,37,37
"44132",2020,0,0,72,72
"44133",2020,0,0,37,37
"44134",2020,0,0,72,72
"44135",2020,0,0,72,72
"44136",2020,0,0,37,37
"44137",2020,0,0,72,72
"44138",2020,0,0,54,54
"44139",2020,0,0,54,54
"44140",2020,0,0,67,67
"44141",2020,0,0,67,67
"44142",2020,0,0,37,37
"44143",2020,0,0,37,37
"44144",2020,0,0,54,54
"44145",2019,0,0,21,21
"44145",2020,0,0,121,121
"44146",2020,0,0,54,54
"44148",2020,0,0,54,54
"44149",2020,0,0,54,54
"44150",2020,0,0,37,37
"44151",2020,0,0,72,72
"44152",2020,0,0,72,72
"44153",2020,0,0,54,54
"44154",2020,0,0,37,37
"44155",2020,0,0,37,37
"44156",2020,0,0,37,37
"44157",2020,0,0,37,37
"44158",2020,0,0,72,72
"44159",2019,0,0,21,21
"44159",2020,0,0,67,67
"44161",2020,0,0,54,54
"44162",2020,0,0,72,72
"44163",2020,0,0,72,72
"44164",2020,0,0,37,37
"44165",2019,0,0,21,21
"44165",2020,0,0,67,67
"44166",2019,0,0,21,21
"44166",2020,0,0,121,121
"44168",2020,0,0,72,72
"44169",2020,0,0,72,72
"44170",2020,0,0,54,54
"44171",2020,0,0,37,37
"44172",2019,0,0,21,21
"44172",2020,0,0,121,121
"44173",2019,0,0,21,21
"44173",2020,0,0,67,67
"44174",2020,0,0,37,37
"44175",2020,0,0,72,72
"44176",2020,0,0,72,72
"44178",2020,0,0,37,37
"44179",2020,0,0,108,108
"44180",2020,0,0,54,54
"44182",2020,0,0,37,37
"44183",2020,0,0,72,72
"44184",2020,0,0,72,72
"44185",2020,0,0,54,54
"44186",2019,0,0,21,21
"44186",2020,0,0,121,121
"44187",2020,0,0,37,37
"44188",2020,0,143,37,180
"44189",2020,0,0,72,72
"44190",2020,0,0,67,67
"44192",2020,0,0,37,37
"44193",2020,0,0,54,54
"44194",2020,0,0,72,72
"44195",2020,0,0,54,54
"44196",2020,0,0,54,54
"44197",2020,0,0,54,54
"44198",2020,0,0,37,37
"44199",2020,0,0,54,54
"44200",2020,0,0,54,54
"44201",2020,0,0,115,115
"44202",2020,0,0,72,72
"44203",2020,0,0,54,54
"44204",2019,0,0,21,21
"44204",2020,0,0,121,121
"44205",2020,0,0,72,72
"44206",2020,0,0,37,37
"44207",2020,0,0,115,115
"44208",2020,0,0,54,54
"44209",2020,0,0,54,54
"44210",2020,0,0,72,72
"44211",2020,0,0,72,72
"44212",2020,0,0,67,67
"44213",2020,0,0,72,72
"44214",2020,0,0,54,54
"44215",2020,0,0,37,37
"44216",2020,0,0,37,37
"44217",2020,0,0,54,54
"44218",2020,0,0,54,54
"44220",2019,0,0,21,21
"44220",2020,0,0,121,121
"44221",2020,0,0,54,54
"44222",2020,0,0,72,72
"44223",2020,0,0,37,37
"44224",2020,0,0,54,54
"45019",2019,0,0,80,80
"45020",2019,0,0,80,80
"45020",2020,0,0,53,53
"45024",2019,0,0,80,80
"45024",2020,0,0,53,53
"45034",2019,0,0,80,80
"45043",2019,0,0,80,80
"45043",2020,0,0,53,53
"45044",2019,0,0,80,80
"45046",2019,0,0,80,80
"45055",2019,0,0,80,80
"45059",2019,0,0,80,80
"45063",2019,0,0,45,45
"45067",2019,0,0,80,80
"45067",2020,0,0,53,53
"45069",2019,0,0,80,80
"45072",2019,0,0,80,80
"45072",2020,0,0,53,53
"45075",2019,0,0,80,80
"45075",2020,0,0,53,53
"45081",2019,0,0,80,80
"45082",2019,0,0,80,80
"45082",2020,0,0,53,53
"45089",2019,0,0,80,80
"45089",2020,0,0,53,53
"45095",2019,0,0,80,80
"45096",2019,0,0,10,10
"45099",2019,0,0,80,80
"45100",2019,0,0,80,80
"45100",2020,0,0,53,53
"45101",2019,0,0,10,10
"45109",2019,0,0,80,80
"45111",2019,0,0,80,80
"45116",2019,0,0,80,80
"45116",2020,0,0,53,53
"45126",2019,0,0,80,80
"45126",2020,0,0,53,53
"45134",2019,0,0,80,80
"45142",2019,0,0,80,80
"45147",2019,0,0,80,80
"45147",2020,0,0,53,53
"45152",2019,0,0,80,80
"45154",2019,0,0,80,80
"45167",2019,0,0,80,80
"45168",2019,0,0,80,80
"45169",2019,0,0,80,80
"45169",2020,0,0,53,53
"45188",2019,0,0,80,80
"45194",2019,0,0,80,80
"45194",2020,0,0,53,53
"45197",2019,0,0,80,80
"45202",2019,0,0,80,80
"45202",2020,0,0,53,53
"45203",2019,0,0,80,80
"45203",2020,0,0,53,53
"45218",2019,0,0,10,10
"45227",2019,0,0,10,10
"45228",2019,0,0,10,10
"45235",2019,0,0,80,80
"45261",2019,0,0,80,80
"45264",2019,0,0,80,80
"45269",2019,0,0,80,80
"45269",2020,0,0,53,53
"45273",2019,0,0,80,80
"45273",2020,0,0,53,53
"45280",2019,0,0,45,45
"45284",2019,0,0,80,80
"45284",2020,0,0,53,53
"45285",2019,0,0,80,80
"45285",2020,0,0,53,53
"45296",2019,0,0,80,80
"45299",2019,0,0,80,80
"45302",2019,0,0,80,80
"45302",2020,0,0,53,53
"45305",2019,0,0,80,80
"45308",2019,0,0,80,80
"45308",2020,0,0,53,53
"45314",2019,0,0,80,80
"45317",2019,0,0,80,80
"45317",2020,0,0,53,53
"45327",2019,0,0,80,80
"45333",2019,0,0,80,80
"45337",2019,0,0,80,80
"45344",2019,0,0,80,80
"45344",2020,0,0,53,53
"45346",2019,0,0,80,80
"45346",2020,0,0,53,53
"45347",2019,0,0,80,80
"46001",2015,0,0,30,30
"46001",2016,0,0,55,55
"46001",2017,0,0,52,52
"46001",2018,0,0,30,30
"46001",2020,0,0,16,16
"46002",2015,0,0,30,30
"46002",2016,0,0,55,55
"46002",2017,0,0,38,38
"46002",2018,0,0,30,30
"46002",2020,0,0,16,16
"46003",2015,0,0,30,30
"46003",2016,0,0,55,55
"46003",2017,0,0,38,38
"46003",2018,0,0,30,30
"46003",2020,0,0,16,16
"46004",2015,0,0,30,30
"46004",2016,0,0,55,55
"46004",2017,0,0,38,38
"46004",2018,0,0,30,30
"46004",2020,0,0,16,16
"46005",2015,0,0,30,30
"46005",2016,0,0,55,55
"46005",2017,0,0,52,52
"46005",2018,0,0,30,30
"46005",2020,0,0,16,16
"46006",2015,0,0,30,30
"46006",2016,0,0,55,55
"46006",2017,0,0,31,31
"46006",2018,0,0,30,30
"46006",2020,0,0,16,16
"46007",2015,0,0,30,30
"46007",2016,0,0,55,55
"46007",2017,0,0,52,52
"46007",2018,0,0,30,30
"46007",2020,0,0,16,16
"46008",2015,0,0,30,30
"46008",2016,0,0,55,55
"46008",2017,0,0,31,31
"46008",2018,0,0,30,30
"46008",2020,0,0,16,16
"46009",2015,0,0,30,30
"46009",2016,0,0,55,55
"46009",2017,0,0,31,31
"46009",2018,0,0,30,30
"46009",2020,0,0,58,58
"46010",2015,0,0,30,30
"46010",2016,0,0,55,55
"46010",2017,0,0,52,52
"46010",2018,0,0,30,30
"46010",2020,0,0,16,16
"46011",2015,0,0,30,30
"46011",2016,0,0,55,55
"46011",2017,0,0,31,31
"46011",2018,0,0,30,30
"46011",2020,0,0,30,30
"46012",2015,0,0,30,30
"46012",2016,0,0,55,55
"46012",2017,0,0,38,38
"46012",2018,0,0,30,30
"46012",2020,0,0,16,16
"46013",2015,0,0,30,30
"46013",2016,0,0,55,55
"46013",2017,0,0,52,52
"46013",2018,0,0,30,30
"46013",2020,0,0,16,16
"46015",2015,0,0,30,30
"46015",2016,0,0,55,55
"46015",2017,0,0,31,31
"46015",2018,0,0,30,30
"46015",2020,0,0,16,16
"46016",2015,0,0,30,30
"46016",2016,0,0,55,55
"46016",2017,0,0,31,31
"46016",2018,0,0,30,30
"46016",2020,0,0,97,97
"46017",2015,0,0,30,30
"46017",2016,0,0,55,55
"46017",2017,0,0,38,38
"46017",2018,0,0,30,30
"46017",2020,0,0,16,16
"46018",2015,0,0,30,30
"46018",2016,0,0,55,55
"46018",2017,0,0,38,38
"46018",2018,0,0,30,30
"46018",2020,0,0,16,16
"46020",2015,0,0,30,30
"46020",2016,0,0,55,55
"46020",2017,0,0,52,52
"46020",2018,0,0,30,30
"46020",2020,0,0,16,16
"46021",2015,0,0,30,30
"46021",2016,0,0,55,55
"46021",2017,0,0,52,52
"46021",2018,0,0,30,30
"46021",2020,0,0,16,16
"46022",2015,0,0,30,30
"46022",2016,0,0,55,55
"46022",2017,0,0,52,52
"46022",2018,0,0,30,30
"46022",2020,0,0,16,16
"46023",2015,0,0,30,30
"46023",2016,0,0,55,55
"46023",2017,0,0,31,31
"46023",2018,0,0,30,30
"46023",2020,0,0,16,16
"46024",2015,0,0,30,30
"46024",2016,0,0,55,55
"46024",2017,0,0,31,31
"46024",2018,0,0,30,30
"46024",2020,0,0,16,16
"46026",2015,0,0,30,30
"46026",2016,0,0,55,55
"46026",2017,0,0,31,31
"46026",2018,0,0,30,30
"46026",2020,0,0,16,16
"46027",2015,0,0,30,30
"46027",2016,0,0,55,55
"46027",2017,0,0,52,52
"46027",2018,0,0,30,30
"46027",2020,0,0,16,16
"46028",2015,0,0,30,30
"46028",2016,0,0,55,55
"46028",2017,0,0,31,31
"46028",2018,0,0,30,30
"46028",2020,0,0,16,16
"46029",2015,0,0,30,30
"46029",2016,0,0,55,55
"46029",2017,0,0,31,31
"46029",2018,0,0,30,30
"46029",2020,0,0,69,69
"46030",2015,0,0,30,30
"46030",2016,0,0,55,55
"46030",2017,0,0,38,38
"46030",2018,0,0,30,30
"46030",2020,0,0,16,16
"46031",2015,0,0,30,30
"46031",2016,0,0,55,55
"46031",2017,0,0,31,31
"46031",2018,0,0,30,30
"46031",2020,0,0,58,58
"46032",2015,0,0,30,30
"46032",2016,0,0,55,55
"46032",2017,0,0,38,38
"46032",2018,0,0,30,30
"46032",2020,0,0,16,16
"46033",2015,0,0,30,30
"46033",2016,0,0,55,55
"46033",2017,0,0,31,31
"46033",2018,0,0,30,30
"46033",2020,0,0,16,16
"46034",2015,0,0,30,30
"46034",2016,0,0,55,55
"46034",2017,0,0,38,38
"46034",2018,0,0,30,30
"46034",2020,0,0,16,16
"46035",2015,0,0,30,30
"46035",2016,0,0,55,55
"46035",2017,0,0,31,31
"46035",2018,0,0,30,30
"46035",2020,0,0,58,58
"46036",2015,0,0,30,30
"46036",2016,0,0,55,55
"46036",2017,0,0,38,38
"46036",2018,0,0,30,30
"46036",2020,0,0,16,16
"46037",2015,0,0,30,30
"46037",2016,0,0,55,55
"46037",2017,0,0,52,52
"46037",2018,0,0,30,30
"46037",2020,0,0,16,16
"46038",2015,0,0,30,30
"46038",2016,0,0,55,55
"46038",2017,0,0,31,31
"46038",2018,0,0,30,30
"46038",2020,0,0,16,16
"46039",2015,0,0,30,30
"46039",2016,0,0,55,55
"46039",2017,0,0,31,31
"46039",2018,0,0,30,30
"46039",2020,0,0,58,58
"46040",2015,0,0,30,30
"46040",2016,0,0,55,55
"46040",2017,0,0,52,52
"46040",2018,0,0,30,30
"46040",2020,0,0,16,16
"46041",2015,0,0,30,30
"46041",2016,0,0,55,55
"46041",2017,0,0,52,52
"46041",2018,0,0,30,30
"46041",2020,0,0,16,16
"46042",2015,0,0,30,30
"46042",2016,0,0,55,55
"46042",2017,0,0,52,52
"46042",2018,0,0,30,30
"46042",2020,0,0,16,16
"46043",2015,0,0,30,30
"46043",2016,0,0,55,55
"46043",2017,0,0,31,31
"46043",2018,0,0,30,30
"46043",2020,0,0,69,69
"46044",2015,0,0,30,30
"46044",2016,0,0,55,55
"46044",2017,0,0,52,52
"46044",2018,0,0,30,30
"46044",2020,0,0,16,16
"46045",2015,0,0,30,30
"46045",2016,0,0,55,55
"46045",2017,0,0,52,52
"46045",2018,0,0,30,30
"46045",2020,0,0,16,16
"46046",2015,0,0,30,30
"46046",2016,0,0,55,55
"46046",2017,0,0,52,52
"46046",2018,0,0,30,30
"46046",2020,0,0,16,16
"46047",2015,0,0,30,30
"46047",2016,0,0,55,55
"46047",2017,0,0,38,38
"46047",2018,0,0,30,30
"46047",2020,0,0,16,16
"46049",2015,0,0,30,30
"46049",2016,0,0,55,55
"46049",2017,0,0,52,52
"46049",2018,0,0,30,30
"46049",2020,0,0,16,16
"46050",2015,0,0,30,30
"46050",2016,0,0,55,55
"46050",2017,0,0,52,52
"46050",2018,0,0,30,30
"46050",2020,0,0,16,16
"46051",2015,0,0,30,30
"46051",2016,0,0,55,55
"46051",2017,0,0,31,31
"46051",2018,0,0,30,30
"46051",2020,0,0,16,16
"46052",2015,0,0,30,30
"46052",2016,0,0,55,55
"46052",2017,0,0,31,31
"46052",2018,0,0,30,30
"46052",2020,0,0,16,16
"46053",2015,0,0,30,30
"46053",2016,0,0,55,55
"46053",2017,0,0,31,31
"46053",2018,0,0,30,30
"46053",2020,0,0,16,16
"46054",2015,0,0,30,30
"46054",2016,0,0,55,55
"46054",2017,0,0,31,31
"46054",2018,0,0,30,30
"46054",2020,0,0,16,16
"46055",2015,0,0,30,30
"46055",2016,0,0,55,55
"46055",2017,0,0,52,52
"46055",2018,0,0,30,30
"46055",2020,0,0,16,16
"46056",2015,0,0,30,30
"46056",2016,0,0,55,55
"46056",2017,0,0,52,52
"46056",2018,0,0,30,30
"46056",2020,0,0,16,16
"46057",2015,0,0,30,30
"46057",2016,0,0,55,55
"46057",2017,0,0,31,31
"46057",2018,0,0,30,30
"46057",2020,0,0,16,16
"46058",2015,0,0,30,30
"46058",2016,0,0,55,55
"46058",2017,0,0,31,31
"46058",2018,0,0,30,30
"46059",2015,0,0,30,30
"46059",2016,0,0,55,55
"46059",2017,0,0,38,38
"46059",2018,0,0,30,30
"46059",2020,0,0,16,16
"46060",2015,0,0,30,30
"46060",2016,0,0,55,55
"46060",2017,0,0,31,31
"46060",2018,0,0,30,30
"46060",2020,0,0,16,16
"46061",2015,0,0,30,30
"46061",2016,0,0,55,55
"46061",2017,0,0,31,31
"46061",2018,0,0,30,30
"46061",2020,0,0,16,16
"46062",2015,0,0,30,30
"46062",2016,0,0,55,55
"46062",2017,0,0,52,52
"46062",2018,0,0,30,30
"46062",2020,0,0,16,16
"46063",2015,0,0,30,30
"46063",2016,0,0,55,55
"46063",2017,0,0,31,31
"46063",2018,0,0,30,30
"46063",2020,0,0,16,16
"46064",2015,0,0,30,30
"46064",2016,0,0,55,55
"46064",2017,0,0,31,31
"46064",2018,0,0,30,30
"46064",2020,0,0,16,16
"46065",2015,0,0,30,30
"46065",2016,0,0,55,55
"46065",2017,0,0,31,31
"46065",2018,0,0,30,30
"46065",2020,0,0,16,16
"46066",2015,0,0,30,30
"46066",2016,0,0,55,55
"46066",2017,0,0,31,31
"46066",2018,0,0,30,30
"46066",2020,0,0,16,16
"46068",2015,0,0,30,30
"46068",2016,0,0,55,55
"46068",2017,0,0,52,52
"46068",2018,0,0,30,30
"46068",2020,0,0,16,16
"46069",2015,0,0,30,30
"46069",2016,0,0,55,55
"46069",2017,0,0,31,31
"46069",2018,0,0,37,37
"46069",2020,0,0,16,16
"46070",2015,0,0,30,30
"46070",2016,0,0,55,55
"46070",2017,0,0,31,31
"46070",2018,0,0,30,30
"46070",2020,0,0,16,16
"46072",2015,0,0,30,30
"46072",2016,0,0,55,55
"46072",2017,0,0,31,31
"46072",2018,0,0,30,30
"46072",2020,0,0,16,16
"46073",2015,0,0,30,30
"46073",2016,0,0,55,55
"46073",2017,0,0,52,52
"46073",2018,0,0,30,30
"46073",2020,0,0,16,16
"46074",2015,0,0,30,30
"46074",2016,0,0,55,55
"46074",2017,0,0,31,31
"46074",2018,0,0,30,30
"46074",2020,0,0,16,16
"46075",2015,0,0,30,30
"46075",2016,0,0,55,55
"46075",2017,0,0,31,31
"46075",2018,0,0,30,30
"46075",2020,0,0,58,58
"46076",2015,0,0,30,30
"46076",2016,0,0,55,55
"46076",2017,0,0,31,31
"46076",2018,0,0,30,30
"46076",2020,0,0,16,16
"46078",2015,0,0,30,30
"46078",2016,0,0,55,55
"46078",2017,0,0,38,38
"46078",2018,0,0,30,30
"46078",2020,0,0,16,16
"46079",2015,0,0,30,30
"46079",2016,0,0,55,55
"46079",2017,0,0,31,31
"46079",2018,0,0,37,37
"46079",2020,0,0,23,23
"46080",2015,0,0,30,30
"46080",2016,0,0,55,55
"46080",2017,0,0,52,52
"46080",2018,0,0,30,30
"46080",2020,0,0,16,16
"46081",2015,0,0,30,30
"46081",2016,0,0,55,55
"46081",2017,0,0,52,52
"46081",2018,0,0,30,30
"46081",2020,0,0,16,16
"46082",2015,0,0,30,30
"46082",2016,0,0,55,55
"46082",2017,0,0,52,52
"46082",2018,0,0,30,30
"46082",2020,0,0,16,16
"46083",2015,0,0,30,30
"46083",2016,0,0,55,55
"46083",2017,0,0,31,31
"46083",2018,0,0,30,30
"46083",2020,0,0,16,16
"46084",2015,0,0,30,30
"46084",2016,0,0,55,55
"46084",2017,0,0,31,31
"46084",2018,0,0,30,30
"46085",2015,0,0,30,30
"46085",2016,0,0,55,55
"46085",2017,0,0,52,52
"46085",2018,0,0,30,30
"46085",2020,0,0,16,16
"46086",2015,0,0,30,30
"46086",2016,0,0,55,55
"46086",2017,0,0,31,31
"46086",2018,0,0,30,30
"46086",2020,0,0,16,16
"46087",2015,0,0,30,30
"46087",2016,0,0,55,55
"46087",2017,0,0,31,31
"46087",2018,0,0,30,30
"46087",2020,0,0,16,16
"46088",2015,0,0,30,30
"46088",2016,0,0,55,55
"46088",2017,0,0,52,52
"46088",2018,0,0,30,30
"46088",2020,0,0,16,16
"46089",2015,0,0,30,30
"46089",2016,0,0,55,55
"46089",2017,0,0,31,31
"46089",2018,0,0,30,30
"46089",2020,0,0,16,16
"46090",2015,0,0,30,30
"46090",2016,0,0,55,55
"46090",2017,0,0,38,38
"46090",2018,0,0,30,30
"46090",2020,0,0,16,16
"46091",2015,0,0,30,30
"46091",2016,0,0,55,55
"46091",2017,0,0,52,52
"46091",2018,0,0,30,30
"46091",2020,0,0,16,16
"46092",2015,0,0,30,30
"46092",2016,0,0,55,55
"46092",2017,0,0,52,52
"46092",2018,0,0,30,30
"46092",2020,0,0,16,16
"46093",2015,0,0,30,30
"46093",2016,0,0,55,55
"46093",2017,0,0,31,31
"46093",2018,0,0,30,30
"46093",2020,0,0,58,58
"46094",2015,0,0,30,30
"46094",2016,0,0,55,55
"46094",2017,0,0,31,31
"46094",2018,0,0,30,30
"46094",2020,0,0,58,58
"46095",2015,0,0,30,30
"46095",2016,0,0,55,55
"46095",2017,0,0,52,52
"46095",2018,0,0,30,30
"46095",2020,0,0,16,16
"46096",2015,0,0,30,30
"46096",2016,0,0,55,55
"46096",2017,0,0,38,38
"46096",2018,0,0,30,30
"46096",2020,0,0,16,16
"46097",2015,0,0,30,30
"46097",2016,0,0,55,55
"46097",2017,0,0,31,31
"46097",2018,0,0,30,30
"46097",2020,0,0,16,16
"46098",2015,0,0,30,30
"46098",2016,0,0,55,55
"46098",2017,0,0,31,31
"46098",2018,0,0,30,30
"46098",2020,0,0,16,16
"46100",2015,0,0,30,30
"46100",2016,0,0,55,55
"46100",2017,0,0,52,52
"46100",2018,0,0,30,30
"46100",2020,0,0,16,16
"46101",2015,0,0,30,30
"46101",2016,0,0,55,55
"46101",2017,0,0,52,52
"46101",2018,0,0,30,30
"46101",2020,0,0,16,16
"46102",2015,0,0,30,30
"46102",2016,0,0,55,55
"46102",2017,0,0,52,52
"46102",2018,0,0,30,30
"46102",2020,0,0,16,16
"46103",2015,0,0,30,30
"46103",2016,0,0,55,55
"46103",2017,0,0,31,31
"46103",2018,0,0,30,30
"46103",2020,0,0,16,16
"46104",2015,0,0,30,30
"46104",2016,0,0,55,55
"46104",2017,0,0,38,38
"46104",2018,0,0,30,30
"46104",2020,0,0,16,16
"46105",2015,0,0,30,30
"46105",2016,0,0,55,55
"46105",2017,0,0,52,52
"46105",2018,0,0,30,30
"46105",2020,0,0,16,16
"46106",2015,0,0,30,30
"46106",2016,0,0,55,55
"46106",2017,0,0,31,31
"46106",2018,0,0,30,30
"46106",2020,0,0,16,16
"46107",2015,0,0,30,30
"46107",2016,0,0,55,55
"46107",2017,0,0,52,52
"46107",2018,0,0,30,30
"46107",2020,0,0,16,16
"46108",2015,0,0,30,30
"46108",2016,0,0,55,55
"46108",2017,0,0,31,31
"46108",2018,0,0,30,30
"46108",2020,0,0,16,16
"46109",2015,0,0,30,30
"46109",2016,0,0,55,55
"46109",2017,0,0,31,31
"46109",2018,0,0,30,30
"46109",2020,0,0,16,16
"46111",2015,0,0,30,30
"46111",2016,0,0,55,55
"46111",2017,0,0,31,31
"46111",2018,0,0,30,30
"46111",2020,0,0,16,16
"46112",2015,0,0,30,30
"46112",2016,0,0,55,55
"46112",2017,0,0,38,38
"46112",2018,0,0,30,30
"46112",2020,0,0,16,16
"46113",2015,0,0,30,30
"46113",2016,0,0,55,55
"46113",2017,0,0,31,31
"46113",2018,0,0,30,30
"46113",2020,0,0,16,16
"46114",2015,0,0,30,30
"46114",2016,0,0,55,55
"46114",2017,0,0,31,31
"46114",2018,0,0,30,30
"46114",2020,0,0,16,16
"46115",2015,0,0,30,30
"46115",2016,0,0,55,55
"46115",2017,0,0,31,31
"46115",2018,0,0,30,30
"46115",2020,0,0,16,16
"46116",2015,0,0,30,30
"46116",2016,0,0,55,55
"46116",2017,0,0,52,52
"46116",2018,0,0,30,30
"46116",2020,0,0,16,16
"46117",2015,0,0,30,30
"46117",2016,0,0,55,55
"46117",2017,0,0,31,31
"46117",2018,0,0,30,30
"46117",2020,0,0,16,16
"46118",2015,0,0,30,30
"46118",2016,0,0,55,55
"46118",2017,0,0,31,31
"46118",2018,0,0,30,30
"46118",2020,0,0,97,97
"46119",2015,0,0,30,30
"46119",2016,0,0,55,55
"46119",2017,0,0,38,38
"46119",2018,0,0,30,30
"46119",2020,0,0,16,16
"46120",2015,0,0,30,30
"46120",2016,0,0,55,55
"46120",2017,0,0,31,31
"46120",2018,0,0,30,30
"46120",2020,0,0,16,16
"46121",2015,0,0,30,30
"46121",2016,0,0,55,55
"46121",2017,0,0,31,31
"46121",2018,0,0,30,30
"46121",2020,0,0,16,16
"46122",2015,0,0,30,30
"46122",2016,0,0,55,55
"46122",2017,0,0,31,31
"46122",2018,0,0,30,30
"46122",2020,0,0,30,30
"46123",2015,0,0,30,30
"46123",2016,0,0,55,55
"46123",2017,0,0,31,31
"46123",2018,0,0,30,30
"46123",2020,0,0,69,69
"46124",2015,0,0,30,30
"46124",2016,0,0,55,55
"46124",2017,0,0,31,31
"46124",2018,0,0,30,30
"46124",2020,0,0,16,16
"46125",2015,0,0,30,30
"46125",2016,0,0,55,55
"46125",2017,0,0,31,31
"46125",2018,0,0,30,30
"46125",2020,0,0,16,16
"46126",2015,0,0,30,30
"46126",2016,0,0,55,55
"46126",2017,0,0,31,31
"46126",2018,0,0,30,30
"46126",2020,0,0,16,16
"46127",2015,0,0,30,30
"46127",2016,0,0,55,55
"46127",2017,0,0,31,31
"46127",2018,0,0,30,30
"46127",2020,0,0,16,16
"46128",2015,0,0,30,30
"46128",2016,0,0,55,55
"46128",2017,0,0,38,38
"46128",2018,0,0,30,30
"46128",2020,0,0,16,16
"46129",2015,0,0,30,30
"46129",2016,0,0,55,55
"46129",2017,0,0,52,52
"46129",2018,0,0,30,30
"46129",2020,0,0,16,16
"46130",2015,0,0,30,30
"46130",2016,0,0,55,55
"46130",2017,0,0,52,52
"46130",2018,0,0,30,30
"46130",2020,0,0,16,16
"46131",2015,0,0,30,30
"46131",2016,0,0,55,55
"46131",2017,0,0,31,31
"46131",2018,0,0,30,30
"46131",2020,0,0,58,58
"46132",2015,0,0,30,30
"46132",2016,0,0,55,55
"46132",2017,0,0,38,38
"46132",2018,0,0,30,30
"46132",2020,0,0,16,16
"46133",2015,0,0,30,30
"46133",2016,0,0,55,55
"46133",2017,0,0,38,38
"46133",2018,0,0,30,30
"46133",2020,0,0,16,16
"46134",2015,0,0,30,30
"46134",2016,0,0,55,55
"46134",2017,0,0,52,52
"46134",2018,0,0,30,30
"46134",2020,0,0,16,16
"46135",2015,0,0,30,30
"46135",2016,0,0,55,55
"46135",2017,0,0,31,31
"46135",2018,0,0,30,30
"46135",2020,0,0,16,16
"46136",2015,0,0,30,30
"46136",2016,0,0,55,55
"46136",2017,0,0,52,52
"46136",2018,0,0,30,30
"46136",2020,0,0,16,16
"46137",2015,0,0,30,30
"46137",2016,0,0,55,55
"46137",2017,0,0,31,31
"46137",2018,0,0,30,30
"46137",2020,0,0,16,16
"46138",2015,0,0,30,30
"46138",2016,0,0,55,55
"46138",2017,0,0,31,31
"46138",2018,0,0,30,30
"46138",2020,0,0,16,16
"46139",2015,0,0,30,30
"46139",2016,0,0,55,55
"46139",2017,0,0,31,31
"46139",2018,0,0,30,30
"46139",2020,0,0,16,16
"46140",2015,0,0,30,30
"46140",2016,0,0,55,55
"46140",2017,0,0,52,52
"46140",2018,0,0,30,30
"46140",2020,0,0,16,16
"46142",2015,0,0,30,30
"46142",2016,0,0,55,55
"46142",2017,0,0,52,52
"46142",2018,0,0,30,30
"46142",2020,0,0,16,16
"46143",2015,0,0,30,30
"46143",2016,0,0,55,55
"46143",2017,0,0,38,38
"46143",2018,0,0,30,30
"46143",2020,0,0,16,16
"46144",2015,0,0,30,30
"46144",2016,0,0,55,55
"46144",2017,0,0,38,38
"46144",2018,0,0,30,30
"46144",2020,0,0,16,16
"46145",2015,0,0,30,30
"46145",2016,0,0,55,55
"46145",2017,0,0,31,31
"46145",2018,0,0,30,30
"46145",2020,0,0,97,97
"46146",2015,0,0,30,30
"46146",2016,0,0,55,55
"46146",2017,0,0,31,31
"46146",2018,0,0,30,30
"46146",2020,0,0,30,30
"46147",2015,0,0,30,30
"46147",2016,0,0,55,55
"46147",2017,0,0,52,52
"46147",2018,0,0,30,30
"46147",2020,0,0,16,16
"46148",2015,0,0,30,30
"46148",2016,0,0,55,55
"46148",2017,0,0,31,31
"46148",2018,0,0,30,30
"46148",2020,0,0,16,16
"46149",2015,0,0,30,30
"46149",2016,0,0,55,55
"46149",2017,0,0,52,52
"46149",2018,0,0,30,30
"46149",2020,0,0,16,16
"46151",2015,0,0,30,30
"46151",2016,0,0,55,55
"46151",2017,0,0,31,31
"46151",2018,0,0,30,30
"46151",2020,0,0,16,16
"46152",2015,0,0,30,30
"46152",2016,0,0,55,55
"46152",2017,0,0,31,31
"46152",2018,0,0,30,30
"46152",2020,0,0,16,16
"46153",2015,0,0,30,30
"46153",2016,0,0,55,55
"46153",2017,0,0,31,31
"46153",2018,0,0,30,30
"46153",2020,0,0,16,16
"46154",2015,0,0,30,30
"46154",2016,0,0,55,55
"46154",2017,0,0,52,52
"46154",2018,0,0,30,30
"46154",2020,0,0,16,16
"46155",2015,0,0,30,30
"46155",2016,0,0,55,55
"46155",2017,0,0,52,52
"46155",2018,0,0,30,30
"46155",2020,0,0,16,16
"46156",2015,0,0,30,30
"46156",2016,0,0,55,55
"46156",2017,0,0,52,52
"46156",2018,0,0,30,30
"46156",2020,0,0,16,16
"46157",2015,0,0,30,30
"46157",2016,0,0,55,55
"46157",2017,0,0,52,52
"46157",2018,0,0,30,30
"46157",2020,0,0,16,16
"46159",2015,0,0,30,30
"46159",2016,0,0,55,55
"46159",2017,0,0,31,31
"46159",2018,0,0,30,30
"46159",2020,0,0,16,16
"46160",2015,0,0,30,30
"46160",2016,0,0,55,55
"46160",2017,0,0,31,31
"46160",2018,0,0,30,30
"46160",2020,0,0,16,16
"46161",2015,0,0,30,30
"46161",2016,0,0,55,55
"46161",2017,0,0,31,31
"46161",2018,0,0,30,30
"46161",2020,0,0,16,16
"46162",2015,0,0,30,30
"46162",2016,0,0,55,55
"46162",2017,0,0,31,31
"46162",2018,0,0,37,37
"46162",2020,0,0,23,23
"46163",2015,0,0,30,30
"46163",2016,0,0,55,55
"46163",2017,0,0,31,31
"46163",2018,0,0,30,30
"46163",2020,0,0,69,69
"46164",2015,0,0,30,30
"46164",2016,0,0,55,55
"46164",2017,0,0,31,31
"46164",2018,0,0,30,30
"46164",2020,0,0,16,16
"46165",2015,0,0,30,30
"46165",2016,0,0,55,55
"46165",2017,0,0,38,38
"46165",2018,0,0,30,30
"46165",2020,0,0,16,16
"46167",2015,0,0,30,30
"46167",2016,0,0,55,55
"46167",2017,0,0,31,31
"46167",2018,0,0,37,37
"46167",2020,0,0,23,23
"46168",2015,0,0,30,30
"46168",2016,0,0,55,55
"46168",2017,0,0,52,52
"46168",2018,0,0,30,30
"46168",2020,0,0,16,16
"46169",2015,0,0,30,30
"46169",2016,0,0,55,55
"46169",2017,0,0,31,31
"46169",2018,0,0,30,30
"46169",2020,0,0,16,16
"46170",2015,0,0,30,30
"46170",2016,0,0,55,55
"46170",2017,0,0,38,38
"46170",2018,0,0,30,30
"46170",2020,0,0,16,16
"46171",2015,0,0,101,101
"46171",2016,0,0,55,55
"46171",2017,0,0,31,31
"46171",2018,0,0,30,30
"46171",2020,0,0,16,16
"46172",2015,0,0,30,30
"46172",2016,0,0,55,55
"46172",2017,0,0,31,31
"46172",2018,0,0,30,30
"46172",2020,0,0,16,16
"46173",2015,0,0,30,30
"46173",2016,0,0,55,55
"46173",2017,0,0,52,52
"46173",2018,0,0,30,30
"46173",2020,0,0,16,16
"46174",2015,0,0,30,30
"46174",2016,0,0,55,55
"46174",2017,0,0,31,31
"46174",2018,0,0,30,30
"46174",2020,0,0,16,16
"46175",2015,0,0,30,30
"46175",2016,0,0,55,55
"46175",2017,0,0,31,31
"46175",2018,0,0,30,30
"46175",2020,0,0,16,16
"46176",2015,0,0,30,30
"46176",2016,0,0,55,55
"46176",2017,0,0,31,31
"46176",2018,0,0,30,30
"46176",2020,0,0,58,58
"46177",2015,0,0,30,30
"46177",2016,0,0,55,55
"46177",2017,0,0,38,38
"46177",2018,0,0,30,30
"46177",2020,0,0,16,16
"46178",2015,0,0,30,30
"46178",2016,0,0,55,55
"46178",2017,0,0,31,31
"46178",2018,0,0,30,30
"46178",2020,0,0,16,16
"46179",2015,0,0,30,30
"46179",2016,0,0,55,55
"46179",2017,0,0,52,52
"46179",2018,0,0,30,30
"46179",2020,0,0,16,16
"46180",2015,0,0,30,30
"46180",2016,0,0,55,55
"46180",2017,0,0,52,52
"46180",2018,0,0,30,30
"46180",2020,0,0,16,16
"46181",2015,0,0,30,30
"46181",2016,0,0,55,55
"46181",2017,0,0,38,38
"46181",2018,0,0,30,30
"46181",2020,0,0,16,16
"46182",2015,0,0,30,30
"46182",2016,0,0,55,55
"46182",2017,0,0,52,52
"46182",2018,0,0,30,30
"46182",2020,0,0,16,16
"46183",2015,0,0,30,30
"46183",2016,0,0,55,55
"46183",2017,0,0,52,52
"46183",2018,0,0,30,30
"46183",2020,0,0,16,16
"46184",2015,0,0,30,30
"46184",2016,0,0,55,55
"46184",2017,0,0,31,31
"46184",2018,0,0,30,30
"46184",2020,0,0,16,16
"46185",2015,0,0,30,30
"46185",2016,0,0,55,55
"46185",2017,0,0,31,31
"46185",2018,0,0,30,30
"46185",2020,0,0,16,16
"46186",2015,0,0,30,30
"46186",2016,0,0,55,55
"46186",2017,0,0,31,31
"46186",2018,0,0,30,30
"46186",2020,0,0,16,16
"46187",2015,0,0,30,30
"46187",2016,0,0,55,55
"46187",2017,0,0,52,52
"46187",2018,0,0,30,30
"46187",2020,0,0,16,16
"46188",2015,0,0,30,30
"46188",2016,0,0,55,55
"46188",2017,0,0,38,38
"46188",2018,0,0,30,30
"46188",2020,0,0,16,16
"46189",2015,0,0,30,30
"46189",2016,0,0,55,55
"46189",2017,0,0,38,38
"46189",2018,0,0,30,30
"46189",2020,0,0,16,16
"46190",2015,0,0,30,30
"46190",2016,0,0,55,55
"46190",2017,0,0,38,38
"46190",2018,0,0,30,30
"46190",2020,0,0,16,16
"46191",2015,0,0,30,30
"46191",2016,0,0,55,55
"46191",2017,0,0,52,52
"46191",2018,0,0,30,30
"46191",2020,0,0,16,16
"46192",2015,0,0,30,30
"46192",2016,0,0,55,55
"46192",2017,0,0,31,31
"46192",2018,0,0,30,30
"46193",2015,0,0,30,30
"46193",2016,0,0,55,55
"46193",2017,0,0,38,38
"46193",2018,0,0,30,30
"46193",2020,0,0,16,16
"46194",2015,0,0,30,30
"46194",2016,0,0,55,55
"46194",2017,0,0,31,31
"46194",2018,0,0,30,30
"46194",2020,0,0,16,16
"46195",2015,0,0,30,30
"46195",2016,0,0,55,55
"46195",2017,0,0,31,31
"46195",2018,0,0,30,30
"46195",2020,0,0,30,30
"46196",2015,0,0,30,30
"46196",2016,0,0,55,55
"46196",2017,0,0,31,31
"46196",2018,0,0,30,30
"46196",2020,0,0,16,16
"46197",2015,0,0,30,30
"46197",2016,0,0,55,55
"46197",2017,0,0,31,31
"46197",2018,0,0,30,30
"46197",2020,0,0,16,16
"46198",2015,0,0,30,30
"46198",2016,0,0,55,55
"46198",2017,0,0,52,52
"46198",2018,0,0,30,30
"46198",2020,0,0,16,16
"46199",2015,0,0,30,30
"46199",2016,0,0,55,55
"46199",2017,0,0,31,31
"46199",2018,0,0,30,30
"46199",2020,0,0,16,16
"46200",2015,0,0,30,30
"46200",2016,0,0,55,55
"46200",2017,0,0,31,31
"46200",2018,0,0,30,30
"46200",2020,0,0,16,16
"46201",2015,0,0,30,30
"46201",2016,0,0,55,55
"46201",2017,0,0,31,31
"46201",2018,0,0,30,30
"46201",2020,0,0,16,16
"46202",2015,0,0,30,30
"46202",2016,0,0,55,55
"46202",2017,0,0,31,31
"46202",2018,0,0,30,30
"46202",2020,0,0,16,16
"46203",2015,0,0,30,30
"46203",2016,0,0,55,55
"46203",2017,0,0,31,31
"46203",2018,0,0,30,30
"46203",2020,0,0,16,16
"46204",2015,0,0,30,30
"46204",2016,0,0,55,55
"46204",2017,0,0,38,38
"46204",2018,0,0,30,30
"46204",2020,0,0,16,16
"46205",2015,0,0,30,30
"46205",2016,0,0,55,55
"46205",2017,0,0,31,31
"46205",2018,0,0,30,30
"46205",2020,0,0,16,16
"46206",2015,0,0,30,30
"46206",2016,0,0,55,55
"46206",2017,0,0,31,31
"46206",2018,0,0,37,37
"46206",2020,0,0,16,16
"46207",2015,0,0,30,30
"46207",2016,0,0,55,55
"46207",2017,0,0,52,52
"46207",2018,0,0,30,30
"46207",2020,0,0,16,16
"46208",2015,0,0,30,30
"46208",2016,0,0,55,55
"46208",2017,0,0,31,31
"46208",2018,0,0,30,30
"46209",2015,0,0,30,30
"46209",2016,0,0,55,55
"46209",2017,0,0,31,31
"46209",2018,0,0,30,30
"46209",2020,0,0,16,16
"46210",2015,0,0,30,30
"46210",2016,0,0,55,55
"46210",2017,0,0,31,31
"46210",2018,0,0,37,37
"46210",2020,0,0,23,23
"46211",2015,0,0,30,30
"46211",2016,0,0,55,55
"46211",2017,0,0,38,38
"46211",2018,0,0,30,30
"46211",2020,0,0,16,16
"46212",2015,0,0,30,30
"46212",2016,0,0,55,55
"46212",2017,0,0,31,31
"46212",2018,0,0,37,37
"46212",2020,0,0,23,23
"46213",2015,0,0,30,30
"46213",2016,0,0,55,55
"46213",2017,0,0,38,38
"46213",2018,0,0,30,30
"46213",2020,0,0,16,16
"46214",2015,0,0,30,30
"46214",2016,0,0,55,55
"46214",2017,0,0,52,52
"46214",2018,0,0,30,30
"46214",2020,0,0,16,16
"46215",2015,0,0,30,30
"46215",2016,0,0,55,55
"46215",2017,0,0,31,31
"46215",2018,0,0,30,30
"46215",2020,0,0,16,16
"46216",2015,0,0,30,30
"46216",2016,0,0,55,55
"46216",2017,0,0,31,31
"46216",2018,0,0,30,30
"46216",2020,0,0,16,16
"46217",2015,0,0,30,30
"46217",2016,0,0,55,55
"46217",2017,0,0,31,31
"46217",2018,0,0,30,30
"46217",2020,0,0,16,16
"46218",2015,0,0,30,30
"46218",2016,0,0,55,55
"46218",2017,0,0,52,52
"46218",2018,0,0,30,30
"46218",2020,0,0,16,16
"46219",2015,0,0,30,30
"46219",2016,0,0,55,55
"46219",2017,0,0,31,31
"46219",2018,0,0,30,30
"46219",2020,0,0,16,16
"46220",2015,0,0,30,30
"46220",2016,0,0,55,55
"46220",2017,0,0,31,31
"46220",2018,0,0,30,30
"46220",2020,0,0,97,97
"46221",2015,0,0,30,30
"46221",2016,0,0,55,55
"46221",2017,0,0,31,31
"46221",2018,0,0,30,30
"46221",2020,0,0,19,19
"46222",2015,0,0,30,30
"46222",2016,0,0,55,55
"46222",2017,0,0,31,31
"46222",2018,0,0,30,30
"46222",2020,0,0,16,16
"46223",2015,0,0,101,101
"46223",2016,0,0,55,55
"46223",2017,0,0,31,31
"46223",2018,0,0,30,30
"46223",2020,0,0,16,16
"46224",2015,0,0,30,30
"46224",2016,0,0,55,55
"46224",2017,0,0,52,52
"46224",2018,0,0,30,30
"46224",2020,0,0,16,16
"46225",2015,0,0,30,30
"46225",2016,0,0,55,55
"46225",2017,0,0,52,52
"46225",2018,0,0,30,30
"46225",2020,0,0,16,16
"46226",2015,0,0,30,30
"46226",2016,0,0,55,55
"46226",2017,0,0,31,31
"46226",2018,0,0,30,30
"46226",2020,0,0,16,16
"46227",2015,0,0,30,30
"46227",2016,0,0,55,55
"46227",2017,0,0,52,52
"46227",2018,0,0,30,30
"46227",2020,0,0,16,16
"46228",2015,0,0,30,30
"46228",2016,0,0,55,55
"46228",2017,0,0,31,31
"46228",2018,0,0,30,30
"46228",2020,0,0,16,16
"46229",2015,0,0,30,30
"46229",2016,0,0,55,55
"46229",2017,0,0,31,31
"46229",2018,0,0,30,30
"46230",2015,0,0,30,30
"46230",2016,0,0,55,55
"46230",2017,0,0,52,52
"46230",2018,0,0,30,30
"46230",2020,0,0,16,16
"46231",2015,0,0,30,30
"46231",2016,0,0,55,55
"46231",2017,0,0,31,31
"46231",2018,0,0,30,30
"46231",2020,0,0,16,16
"46232",2015,0,0,30,30
"46232",2016,0,0,55,55
"46232",2017,0,0,31,31
"46232",2018,0,0,30,30
"46232",2020,0,0,16,16
"46233",2015,0,0,30,30
"46233",2016,0,0,55,55
"46233",2017,0,0,31,31
"46233",2018,0,0,30,30
"46233",2020,0,0,58,58
"46234",2015,0,0,30,30
"46234",2016,0,0,55,55
"46234",2017,0,0,31,31
"46234",2018,0,0,30,30
"46234",2020,0,0,16,16
"46235",2015,0,0,30,30
"46235",2016,0,0,55,55
"46235",2017,0,0,38,38
"46235",2018,0,0,30,30
"46235",2020,0,0,16,16
"46236",2015,0,0,30,30
"46236",2016,0,0,55,55
"46236",2017,0,0,31,31
"46236",2018,0,0,30,30
"46236",2020,0,0,16,16
"46237",2015,0,0,30,30
"46237",2016,0,0,55,55
"46237",2017,0,0,31,31
"46237",2018,0,0,30,30
"46237",2020,0,0,16,16
"46238",2015,0,0,30,30
"46238",2016,0,0,55,55
"46238",2017,0,0,38,38
"46238",2018,0,0,30,30
"46238",2020,0,0,16,16
"46239",2015,0,0,30,30
"46239",2016,0,0,55,55
"46239",2017,0,0,31,31
"46239",2018,0,0,30,30
"46239",2020,0,0,16,16
"46240",2015,0,0,30,30
"46240",2016,0,0,55,55
"46240",2017,0,0,38,38
"46240",2018,0,0,30,30
"46240",2020,0,0,16,16
"46241",2015,0,0,30,30
"46241",2016,0,0,55,55
"46241",2017,0,0,31,31
"46241",2018,0,0,30,30
"46241",2020,0,0,16,16
"46242",2015,0,0,30,30
"46242",2016,0,0,55,55
"46242",2017,0,0,38,38
"46242",2018,0,0,30,30
"46242",2020,0,0,16,16
"46243",2015,0,0,30,30
"46243",2016,0,0,55,55
"46243",2017,0,0,38,38
"46243",2018,0,0,30,30
"46243",2020,0,0,16,16
"46244",2015,0,0,30,30
"46244",2016,0,0,55,55
"46244",2017,0,0,31,31
"46244",2018,0,0,30,30
"46244",2020,0,0,16,16
"46245",2015,0,0,30,30
"46245",2016,0,0,55,55
"46245",2017,0,0,31,31
"46245",2018,0,0,37,37
"46245",2020,0,0,23,23
"46246",2015,0,0,30,30
"46246",2016,0,0,55,55
"46246",2017,0,0,38,38
"46246",2018,0,0,30,30
"46246",2020,0,0,16,16
"46247",2015,0,0,30,30
"46247",2016,0,0,55,55
"46247",2017,0,0,52,52
"46247",2018,0,0,30,30
"46247",2020,0,0,16,16
"46249",2015,0,0,30,30
"46249",2016,0,0,55,55
"46249",2017,0,0,38,38
"46249",2018,0,0,30,30
"46249",2020,0,0,16,16
"46250",2015,0,0,30,30
"46250",2016,0,0,55,55
"46250",2017,0,0,31,31
"46250",2018,0,0,30,30
"46250",2020,0,0,37,37
"46251",2015,0,0,30,30
"46251",2016,0,0,55,55
"46251",2017,0,0,31,31
"46251",2018,0,0,30,30
"46251",2020,0,0,30,30
"46252",2015,0,0,30,30
"46252",2016,0,0,55,55
"46252",2017,0,0,31,31
"46252",2018,0,0,37,37
"46252",2020,0,0,23,23
"46253",2015,0,0,30,30
"46253",2016,0,0,55,55
"46253",2017,0,0,31,31
"46253",2018,0,0,30,30
"46253",2020,0,0,16,16
"46254",2015,0,0,30,30
"46254",2016,0,0,55,55
"46254",2017,0,0,52,52
"46254",2018,0,0,30,30
"46254",2020,0,0,16,16
"46255",2015,0,0,30,30
"46255",2016,0,0,55,55
"46255",2017,0,0,31,31
"46255",2018,0,0,30,30
"46255",2020,0,0,16,16
"46256",2015,0,0,30,30
"46256",2016,0,0,55,55
"46256",2017,0,0,52,52
"46256",2018,0,0,30,30
"46256",2020,0,0,16,16
"46257",2015,0,0,30,30
"46257",2016,0,0,55,55
"46257",2017,0,0,31,31
"46257",2018,0,0,30,30
"46257",2020,0,0,16,16
"46258",2015,0,0,30,30
"46258",2016,0,0,55,55
"46258",2017,0,0,31,31
"46258",2018,0,0,30,30
"46258",2020,0,0,16,16
"46259",2015,0,0,30,30
"46259",2016,0,0,55,55
"46259",2017,0,0,31,31
"46259",2018,0,0,30,30
"46259",2020,0,0,16,16
"46260",2015,0,0,30,30
"46260",2016,0,0,55,55
"46260",2017,0,0,31,31
"46260",2018,0,0,30,30
"46260",2020,0,0,16,16
"46262",2015,0,0,30,30
"46262",2016,0,0,55,55
"46262",2017,0,0,31,31
"46262",2018,0,0,37,37
"46262",2020,0,0,16,16
"46263",2015,0,0,30,30
"46263",2016,0,0,55,55
"46263",2017,0,0,31,31
"46263",2018,0,0,30,30
"46263",2020,0,0,16,16
"46264",2015,0,0,30,30
"46264",2016,0,0,55,55
"46264",2017,0,0,38,38
"46264",2018,0,0,30,30
"46264",2020,0,0,16,16
"46265",2015,0,0,30,30
"46265",2016,0,0,55,55
"46265",2017,0,0,31,31
"46265",2018,0,0,30,30
"46265",2020,0,0,16,16
"46266",2015,0,0,30,30
"46266",2016,0,0,55,55
"46266",2017,0,0,52,52
"46266",2018,0,0,30,30
"46266",2020,0,0,16,16
"46267",2015,0,0,30,30
"46267",2016,0,0,55,55
"46267",2017,0,0,31,31
"46267",2018,0,0,30,30
"46267",2020,0,0,16,16
"46268",2015,0,0,30,30
"46268",2016,0,0,55,55
"46268",2017,0,0,52,52
"46268",2018,0,0,30,30
"46268",2020,0,0,16,16
"46269",2015,0,0,30,30
"46269",2016,0,0,55,55
"46269",2017,0,0,31,31
"46269",2018,0,0,30,30
"46269",2020,0,0,16,16
"46270",2015,0,0,30,30
"46270",2016,0,0,55,55
"46270",2017,0,0,52,52
"46270",2018,0,0,30,30
"46270",2020,0,0,16,16
"46271",2015,0,0,30,30
"46271",2016,0,0,55,55
"46271",2017,0,0,31,31
"46271",2018,0,0,30,30
"46271",2020,0,0,30,30
"46272",2015,0,0,30,30
"46272",2016,0,0,55,55
"46272",2017,0,0,52,52
"46272",2018,0,0,30,30
"46272",2020,0,0,16,16
"46273",2015,0,0,30,30
"46273",2016,0,0,55,55
"46273",2017,0,0,31,31
"46273",2018,0,0,30,30
"46273",2020,0,0,16,16
"46276",2015,0,0,30,30
"46276",2016,0,0,55,55
"46276",2017,0,0,52,52
"46276",2018,0,0,30,30
"46276",2020,0,0,16,16
"46277",2015,0,0,30,30
"46277",2016,0,0,55,55
"46277",2017,0,0,31,31
"46277",2018,0,0,30,30
"46277",2020,0,0,37,37
"46279",2015,0,0,30,30
"46279",2016,0,0,55,55
"46279",2017,0,0,38,38
"46279",2018,0,0,30,30
"46279",2020,0,0,16,16
"46280",2015,0,0,101,101
"46280",2016,0,0,55,55
"46280",2017,0,0,31,31
"46280",2018,0,0,30,30
"46280",2020,0,0,16,16
"46281",2015,0,0,30,30
"46281",2016,0,0,55,55
"46281",2017,0,0,31,31
"46281",2018,0,0,30,30
"46281",2020,0,0,30,30
"46282",2015,0,0,30,30
"46282",2016,0,0,55,55
"46282",2017,0,0,31,31
"46282",2018,0,0,30,30
"46282",2020,0,0,16,16
"46283",2015,0,0,30,30
"46283",2016,0,0,55,55
"46283",2017,0,0,31,31
"46283",2018,0,0,30,30
"46283",2020,0,0,16,16
"46284",2015,0,0,30,30
"46284",2016,0,0,55,55
"46284",2017,0,0,31,31
"46284",2018,0,0,30,30
"46284",2020,0,0,16,16
"46286",2015,0,0,30,30
"46286",2016,0,0,55,55
"46286",2017,0,0,31,31
"46286",2018,0,0,30,30
"46286",2020,0,0,30,30
"46288",2015,0,0,30,30
"46288",2016,0,0,55,55
"46288",2017,0,0,31,31
"46288",2018,0,0,30,30
"46288",2020,0,0,16,16
"46289",2015,0,0,30,30
"46289",2016,0,0,55,55
"46289",2017,0,0,52,52
"46289",2018,0,0,30,30
"46289",2020,0,0,16,16
"46290",2015,0,0,30,30
"46290",2016,0,0,55,55
"46290",2017,0,0,31,31
"46290",2018,0,0,30,30
"46290",2020,0,0,16,16
"46292",2015,0,0,30,30
"46292",2016,0,0,55,55
"46292",2017,0,0,38,38
"46292",2018,0,0,30,30
"46292",2020,0,0,16,16
"46293",2015,0,0,30,30
"46293",2016,0,0,55,55
"46293",2017,0,0,31,31
"46293",2018,0,0,30,30
"46294",2015,0,0,30,30
"46294",2016,0,0,55,55
"46294",2017,0,0,31,31
"46294",2018,0,0,30,30
"46294",2020,0,0,58,58
"46295",2015,0,0,30,30
"46295",2016,0,0,55,55
"46295",2017,0,0,38,38
"46295",2018,0,0,30,30
"46295",2020,0,0,16,16
"46296",2015,0,0,30,30
"46296",2016,0,0,55,55
"46296",2017,0,0,52,52
"46296",2018,0,0,30,30
"46296",2020,0,0,16,16
"46297",2015,0,0,30,30
"46297",2016,0,0,55,55
"46297",2017,0,0,31,31
"46297",2018,0,0,30,30
"46297",2020,0,0,16,16
"46299",2015,0,0,30,30
"46299",2016,0,0,55,55
"46299",2017,0,0,52,52
"46299",2018,0,0,30,30
"46299",2020,0,0,16,16
"46301",2015,0,0,30,30
"46301",2016,0,0,55,55
"46301",2017,0,0,31,31
"46301",2018,0,0,30,30
"46301",2020,0,0,16,16
"46302",2015,0,0,30,30
"46302",2016,0,0,55,55
"46302",2017,0,0,31,31
"46302",2018,0,0,30,30
"46302",2020,0,0,30,30
"46303",2015,0,0,30,30
"46303",2016,0,0,55,55
"46303",2017,0,0,31,31
"46303",2018,0,0,37,37
"46303",2020,0,0,23,23
"46304",2015,0,0,30,30
"46304",2016,0,0,55,55
"46304",2017,0,0,31,31
"46304",2018,0,0,30,30
"46304",2020,0,0,16,16
"46305",2015,0,0,30,30
"46305",2016,0,0,55,55
"46305",2017,0,0,52,52
"46305",2018,0,0,30,30
"46305",2020,0,0,16,16
"46306",2015,0,0,30,30
"46306",2016,0,0,55,55
"46306",2017,0,0,38,38
"46306",2018,0,0,30,30
"46306",2020,0,0,16,16
"46307",2015,0,0,30,30
"46307",2016,0,0,55,55
"46307",2017,0,0,31,31
"46307",2018,0,0,30,30
"46307",2020,0,0,16,16
"46308",2015,0,0,30,30
"46308",2016,0,0,55,55
"46308",2017,0,0,31,31
"46308",2018,0,0,30,30
"46308",2020,0,0,16,16
"46309",2015,0,0,30,30
"46309",2016,0,0,55,55
"46309",2017,0,0,31,31
"46309",2018,0,0,30,30
"46309",2020,0,0,97,97
"46310",2015,0,0,30,30
"46310",2016,0,0,55,55
"46310",2017,0,0,31,31
"46310",2018,0,0,37,37
"46310",2020,0,0,23,23
"46311",2015,0,0,30,30
"46311",2016,0,0,55,55
"46311",2017,0,0,31,31
"46311",2018,0,0,30,30
"46311",2020,0,0,16,16
"46312",2015,0,0,30,30
"46312",2016,0,0,55,55
"46312",2017,0,0,31,31
"46312",2018,0,0,30,30
"46312",2020,0,0,16,16
"46313",2015,0,0,30,30
"46313",2016,0,0,55,55
"46313",2017,0,0,31,31
"46313",2018,0,0,30,30
"46313",2020,0,0,16,16
"46314",2015,0,0,30,30
"46314",2016,0,0,55,55
"46314",2017,0,0,31,31
"46314",2018,0,0,30,30
"46314",2020,0,0,30,30
"46315",2015,0,0,30,30
"46315",2016,0,0,55,55
"46315",2017,0,0,31,31
"46315",2018,0,0,30,30
"46315",2020,0,0,16,16
"46316",2015,0,0,30,30
"46316",2016,0,0,55,55
"46316",2017,0,0,31,31
"46316",2018,0,0,30,30
"46316",2020,0,0,16,16
"46317",2015,0,0,30,30
"46317",2016,0,0,55,55
"46317",2017,0,0,38,38
"46317",2018,0,0,30,30
"46317",2020,0,0,16,16
"46318",2015,0,0,30,30
"46318",2016,0,0,55,55
"46318",2017,0,0,38,38
"46318",2018,0,0,30,30
"46318",2020,0,0,16,16
"46319",2015,0,0,30,30
"46319",2016,0,0,55,55
"46319",2017,0,0,38,38
"46319",2018,0,0,30,30
"46319",2020,0,0,16,16
"46320",2015,0,0,30,30
"46320",2016,0,0,55,55
"46320",2017,0,0,52,52
"46320",2018,0,0,30,30
"46320",2020,0,0,16,16
"46321",2015,0,0,30,30
"46321",2016,0,0,55,55
"46321",2017,0,0,52,52
"46321",2018,0,0,30,30
"46321",2020,0,0,16,16
"46322",2015,0,0,30,30
"46322",2016,0,0,55,55
"46322",2017,0,0,52,52
"46322",2018,0,0,30,30
"46322",2020,0,0,16,16
"46323",2015,0,0,30,30
"46323",2016,0,0,55,55
"46323",2017,0,0,31,31
"46323",2018,0,0,30,30
"46323",2020,0,0,16,16
"46324",2015,0,0,30,30
"46324",2016,0,0,55,55
"46324",2017,0,0,31,31
"46324",2018,0,0,30,30
"46324",2020,0,0,16,16
"46328",2015,0,0,30,30
"46328",2016,0,0,55,55
"46328",2017,0,0,52,52
"46328",2018,0,0,30,30
"46328",2020,0,0,16,16
"46329",2015,0,0,30,30
"46329",2016,0,0,55,55
"46329",2017,0,0,52,52
"46329",2018,0,0,30,30
"46329",2020,0,0,16,16
"46330",2015,0,0,30,30
"46330",2016,0,0,55,55
"46330",2017,0,0,31,31
"46330",2018,0,0,30,30
"46330",2020,0,0,16,16
"46332",2015,0,0,30,30
"46332",2016,0,0,55,55
"46332",2017,0,0,31,31
"46332",2018,0,0,30,30
"46332",2020,0,0,16,16
"46333",2015,0,0,30,30
"46333",2016,0,0,55,55
"46333",2017,0,0,52,52
"46333",2018,0,0,30,30
"46333",2020,0,0,16,16
"46334",2015,0,0,30,30
"46334",2016,0,0,55,55
"46334",2017,0,0,31,31
"46334",2018,0,0,30,30
"46334",2020,0,0,16,16
"46335",2015,0,0,30,30
"46335",2016,0,0,55,55
"46335",2017,0,0,31,31
"46335",2018,0,0,30,30
"46335",2020,0,0,16,16
"46336",2015,0,0,30,30
"46336",2016,0,0,55,55
"46336",2017,0,0,52,52
"46336",2018,0,0,30,30
"46336",2020,0,0,16,16
"46337",2015,0,0,30,30
"46337",2016,0,0,55,55
"46337",2017,0,0,31,31
"46337",2018,0,0,30,30
"46337",2020,0,0,39,39
"46338",2015,0,0,30,30
"46338",2016,0,0,55,55
"46338",2017,0,0,31,31
"46338",2018,0,0,30,30
"46338",2020,0,0,16,16
"46339",2015,0,0,30,30
"46339",2016,0,0,55,55
"46339",2017,0,0,38,38
"46339",2018,0,0,30,30
"46339",2020,0,0,16,16
"46340",2015,0,0,30,30
"46340",2016,0,0,55,55
"46340",2017,0,0,52,52
"46340",2018,0,0,30,30
"46340",2020,0,0,16,16
"48001",2014,0,0,39,39
"48001",2015,0,0,111,111
"48001",2016,0,0,89,89
"48001",2017,0,0,67,67
"48001",2018,0,0,74,74
"48001",2019,0,0,42,42
"48001",2020,0,0,12,12
"48002",2014,0,0,39,39
"48002",2015,0,0,111,111
"48002",2016,0,0,89,89
"48002",2017,0,0,67,67
"48002",2018,0,0,74,74
"48002",2019,0,0,42,42
"48002",2020,0,0,12,12
"48003",2013,0,0,54,54
"48003",2014,0,0,105,105
"48003",2015,0,0,111,111
"48003",2016,0,0,51,51
"48003",2017,0,0,22,22
"48003",2018,0,0,35,35
"48003",2019,0,0,29,29
"48003",2020,0,0,87,87
"48004",2013,0,0,54,54
"48004",2014,0,0,105,105
"48004",2015,0,0,111,111
"48004",2016,0,0,51,51
"48004",2017,0,0,22,22
"48004",2018,0,0,18,18
"48004",2019,0,0,29,29
"48004",2020,0,0,87,87
"48005",2014,0,0,39,39
"48005",2015,0,0,111,111
"48005",2016,0,0,89,89
"48005",2017,0,0,67,67
"48005",2018,0,0,60,60
"48005",2019,0,0,42,42
"48005",2020,0,0,12,12
"48007",2014,0,0,39,39
"48007",2015,0,0,111,111
"48007",2016,0,0,89,89
"48007",2017,0,0,67,67
"48007",2018,0,0,74,74
"48007",2019,0,0,42,42
"48007",2020,0,0,12,12
"48008",2014,0,0,39,39
"48008",2015,0,0,111,111
"48008",2016,0,0,65,65
"48008",2017,0,0,22,22
"48008",2018,0,0,43,43
"48008",2019,0,0,29,29
"48008",2020,0,0,12,12
"48009",2014,0,0,39,39
"48009",2015,0,0,111,111
"48009",2016,0,0,89,89
"48009",2017,0,0,67,67
"48009",2018,0,0,60,60
"48009",2019,0,0,42,42
"48009",2020,0,0,12,12
"48010",2013,0,0,54,54
"48010",2014,0,0,39,39
"48010",2015,0,0,125,125
"48010",2016,0,0,65,65
"48010",2017,0,0,14,14
"48010",2018,0,0,43,43
"48010",2019,0,0,29,29
"48010",2020,0,0,87,87
"48012",2014,0,0,39,39
"48012",2015,0,0,111,111
"48012",2016,0,0,89,89
"48012",2017,0,0,67,67
"48012",2018,0,0,74,74
"48012",2019,0,0,42,42
"48012",2020,0,0,12,12
"48013",2013,0,0,54,54
"48013",2014,0,0,39,39
"48013",2015,0,0,125,125
"48013",2016,0,0,65,65
"48013",2017,0,0,14,14
"48013",2018,0,0,60,60
"48013",2019,0,0,30,30
"48013",2020,0,0,87,87
"48015",2013,0,0,54,54
"48015",2014,0,0,105,105
"48015",2015,0,0,111,111
"48015",2016,0,0,51,51
"48015",2017,0,0,22,22
"48015",2018,0,0,18,18
"48015",2019,0,0,29,29
"48015",2020,0,0,87,87
"48016",2013,0,0,54,54
"48016",2014,0,0,39,39
"48016",2015,0,0,125,125
"48016",2016,0,0,65,65
"48016",2017,0,0,14,14
"48016",2018,0,0,60,60
"48016",2019,0,0,16,16
"48016",2020,0,0,87,87
"48017",2013,0,0,54,54
"48017",2014,0,0,39,39
"48017",2015,0,0,125,125
"48017",2016,0,0,65,65
"48017",2017,0,0,14,14
"48017",2018,0,0,60,60
"48017",2019,0,0,30,30
"48017",2020,0,0,87,87
"48018",2014,0,0,39,39
"48018",2015,0,0,111,111
"48018",2016,0,0,65,65
"48018",2017,0,0,22,22
"48018",2018,0,0,43,43
"48018",2019,0,0,30,30
"48018",2020,0,0,12,12
"48019",2013,0,0,54,54
"48019",2014,0,0,105,105
"48019",2015,0,0,104,104
"48019",2016,0,0,65,65
"48019",2017,0,0,22,22
"48019",2018,0,0,43,43
"48019",2019,0,0,16,16
"48019",2020,0,0,87,87
"48020",2013,0,0,54,54
"48020",2014,0,0,105,105
"48020",2015,0,0,104,104
"48020",2016,0,0,65,65
"48020",2017,0,0,22,22
"48020",2018,0,0,43,43
"48020",2019,0,0,16,16
"48020",2020,0,0,87,87
"48021",2013,0,0,54,54
"48021",2014,0,0,105,105
"48021",2015,0,0,111,111
"48021",2016,0,0,51,51
"48021",2017,0,0,22,22
"48021",2018,0,0,18,18
"48021",2019,0,0,29,29
"48021",2020,0,0,87,87
"48025",2014,0,0,39,39
"48025",2015,0,0,111,111
"48025",2016,0,0,89,89
"48025",2017,0,0,67,67
"48025",2018,0,0,74,74
"48025",2019,0,0,42,42
"48025",2020,0,0,12,12
"48026",2014,0,0,39,39
"48026",2015,0,0,111,111
"48026",2016,0,0,89,89
"48026",2017,0,0,67,67
"48026",2018,0,0,74,74
"48026",2019,0,0,42,42
"48026",2020,0,0,12,12
"48027",2013,0,0,54,54
"48027",2014,0,0,105,105
"48027",2015,0,0,111,111
"48027",2016,0,0,51,51
"48027",2017,0,0,22,22
"48027",2018,0,0,35,35
"48027",2019,0,0,29,29
"48027",2020,0,0,87,87
"48028",2013,0,0,54,54
"48028",2014,0,0,39,39
"48028",2015,0,0,125,125
"48028",2016,0,0,65,65
"48028",2017,0,0,14,14
"48028",2018,0,0,60,60
"48028",2019,0,0,16,16
"48028",2020,0,0,87,87
"48029",2014,0,0,39,39
"48029",2015,0,0,111,111
"48029",2016,0,0,65,65
"48029",2017,0,0,22,22
"48029",2018,0,0,43,43
"48029",2019,0,0,29,29
"48029",2020,0,0,12,12
"48030",2013,0,0,54,54
"48030",2014,0,0,39,39
"48030",2015,0,0,125,125
"48030",2016,0,0,65,65
"48030",2017,0,0,14,14
"48030",2018,0,0,60,60
"48030",2019,0,0,30,30
"48030",2020,0,0,87,87
"48031",2014,0,0,39,39
"48031",2015,0,0,111,111
"48031",2016,0,0,89,89
"48031",2017,0,0,67,67
"48031",2018,0,0,74,74
"48031",2019,0,0,42,42
"48031",2020,0,0,12,12
"48032",2014,0,0,39,39
"48032",2015,0,0,111,111
"48032",2016,0,0,89,89
"48032",2017,0,0,67,67
"48032",2018,0,0,60,60
"48032",2019,0,0,42,42
"48032",2020,0,0,12,12
"48034",2014,0,0,39,39
"48034",2015,0,0,111,111
"48034",2016,0,0,65,65
"48034",2017,0,0,22,22
"48034",2018,0,0,43,43
"48034",2019,0,0,16,16
"48034",2020,0,0,12,12
"48036",2013,0,0,54,54
"48036",2014,0,0,105,105
"48036",2015,0,0,104,104
"48036",2016,0,0,65,65
"48036",2017,0,0,22,22
"48036",2018,0,0,43,43
"48036",2019,0,0,16,16
"48036",2020,0,0,87,87
"48037",2013,0,0,54,54
"48037",2014,0,0,39,39
"48037",2015,0,0,125,125
"48037",2016,0,0,65,65
"48037",2017,0,0,14,14
"48037",2018,0,0,60,60
"48037",2019,0,0,30,30
"48037",2020,0,0,87,87
"48038",2013,0,0,54,54
"48038",2014,0,0,39,39
"48038",2015,0,0,125,125
"48038",2016,0,0,65,65
"48038",2017,0,0,14,14
"48038",2018,0,0,43,43
"48038",2019,0,0,29,29
"48038",2020,0,0,87,87
"48039",2014,0,0,39,39
"48039",2015,0,0,111,111
"48039",2016,0,0,65,65
"48039",2017,0,0,22,22
"48039",2018,0,0,43,43
"48039",2019,0,0,16,16
"48039",2020,0,0,12,12
"48041",2013,0,0,54,54
"48041",2014,0,0,39,39
"48041",2015,0,0,125,125
"48041",2016,0,0,65,65
"48041",2017,0,0,14,14
"48041",2018,0,0,43,43
"48041",2019,0,0,29,29
"48041",2020,0,0,87,87
"48042",2014,0,0,39,39
"48042",2015,0,0,111,111
"48042",2016,0,0,65,65
"48042",2017,0,0,22,22
"48042",2018,0,0,43,43
"48042",2019,0,0,30,30
"48042",2020,0,0,12,12
"48043",2013,0,0,54,54
"48043",2014,0,0,39,39
"48043",2015,0,0,125,125
"48043",2016,0,0,65,65
"48043",2017,0,0,14,14
"48043",2018,0,0,60,60
"48043",2019,0,0,29,29
"48043",2020,0,0,87,87
"48044",2014,0,0,39,39
"48044",2015,0,0,111,111
"48044",2016,0,0,89,89
"48044",2017,0,0,67,67
"48044",2018,0,0,74,74
"48044",2019,0,0,42,42
"48044",2020,0,0,12,12
"48045",2013,0,0,54,54
"48045",2014,0,0,105,105
"48045",2015,0,0,111,111
"48045",2016,0,0,51,51
"48045",2017,0,0,22,22
"48045",2018,0,0,18,18
"48045",2019,0,0,29,29
"48045",2020,0,0,87,87
"48046",2014,0,0,39,39
"48046",2015,0,0,111,111
"48046",2016,0,0,89,89
"48046",2017,0,0,67,67
"48046",2018,0,0,74,74
"48046",2019,0,0,42,42
"48046",2020,0,0,12,12
"48048",2013,0,0,54,54
"48048",2014,0,0,105,105
"48048",2015,0,0,111,111
"48048",2016,0,0,51,51
"48048",2017,0,0,22,22
"48048",2018,0,0,18,18
"48048",2019,0,0,29,29
"48048",2020,0,0,87,87
"48050",2014,0,0,39,39
"48050",2015,0,0,125,125
"48050",2016,0,0,65,65
"48050",2017,0,0,59,59
"48050",2018,0,0,60,60
"48050",2019,0,0,16,16
"48050",2020,0,0,87,87
"48051",2013,0,0,54,54
"48051",2014,0,0,105,105
"48051",2015,0,0,104,104
"48051",2016,0,0,89,89
"48051",2017,0,0,22,22
"48051",2018,0,0,43,43
"48051",2019,0,0,16,16
"48051",2020,0,0,87,87
"48053",2013,0,0,54,54
"48053",2014,0,0,105,105
"48053",2015,0,0,111,111
"48053",2016,0,0,51,51
"48053",2017,0,0,22,22
"48053",2018,0,0,35,35
"48053",2019,0,0,29,29
"48053",2020,0,0,87,87
"48054",2013,0,0,54,54
"48054",2014,0,0,105,105
"48054",2015,0,0,111,111
"48054",2016,0,0,51,51
"48054",2017,0,0,22,22
"48054",2018,0,0,18,18
"48054",2019,0,0,29,29
"48054",2020,0,0,87,87
"48055",2013,0,0,54,54
"48055",2014,0,0,39,39
"48055",2015,0,0,125,125
"48055",2016,0,0,65,65
"48055",2017,0,0,14,14
"48055",2018,0,0,60,60
"48055",2019,0,0,30,30
"48055",2020,0,0,87,87
"48056",2014,0,0,39,39
"48056",2015,0,0,111,111
"48056",2016,0,0,65,65
"48056",2017,0,0,22,22
"48056",2018,0,0,43,43
"48056",2019,0,0,30,30
"48056",2020,0,0,12,12
"48058",2014,0,0,39,39
"48058",2015,0,0,111,111
"48058",2016,0,0,89,89
"48058",2017,0,0,67,67
"48058",2018,0,0,74,74
"48058",2019,0,0,42,42
"48058",2020,0,0,12,12
"48059",2014,0,0,39,39
"48059",2015,0,0,111,111
"48059",2016,0,0,89,89
"48059",2017,0,0,67,67
"48059",2018,0,0,74,74
"48059",2019,0,0,42,42
"48059",2020,0,0,12,12
"48061",2014,0,0,39,39
"48061",2015,0,0,125,125
"48061",2016,0,0,65,65
"48061",2017,0,0,59,59
"48061",2018,0,0,60,60
"48061",2019,0,0,16,16
"48061",2020,0,0,87,87
"48063",2014,0,0,39,39
"48063",2015,0,0,111,111
"48063",2016,0,0,89,89
"48063",2017,0,0,67,67
"48063",2018,0,0,74,74
"48063",2019,0,0,42,42
"48063",2020,0,0,12,12
"48064",2014,0,0,39,39
"48064",2015,0,0,111,111
"48064",2016,0,0,89,89
"48064",2017,0,0,67,67
"48064",2018,0,0,74,74
"48064",2019,0,0,42,42
"48064",2020,0,0,12,12
"48065",2014,0,0,39,39
"48065",2015,0,0,125,125
"48065",2016,0,0,65,65
"48065",2017,0,0,59,59
"48065",2018,0,0,60,60
"48065",2019,0,0,16,16
"48065",2020,0,0,87,87
"48067",2013,0,0,54,54
"48067",2014,0,0,105,105
"48067",2015,0,0,104,104
"48067",2016,0,0,89,89
"48067",2017,0,0,22,22
"48067",2018,0,0,43,43
"48067",2019,0,0,16,16
"48067",2020,0,0,87,87
"48068",2014,0,0,39,39
"48068",2015,0,0,111,111
"48068",2016,0,0,65,65
"48068",2017,0,0,22,22
"48068",2018,0,0,43,43
"48068",2019,0,0,30,30
"48068",2020,0,0,12,12
"48069",2014,0,0,39,39
"48069",2015,0,0,125,125
"48069",2016,0,0,65,65
"48069",2017,0,0,59,59
"48069",2018,0,0,60,60
"48069",2019,0,0,16,16
"48069",2020,0,0,87,87
"48070",2013,0,0,54,54
"48070",2014,0,0,39,39
"48070",2015,0,0,125,125
"48070",2016,0,0,65,65
"48070",2017,0,0,14,14
"48070",2018,0,0,43,43
"48070",2019,0,0,29,29
"48070",2020,0,0,87,87
"48071",2014,0,0,39,39
"48071",2015,0,0,111,111
"48071",2016,0,0,89,89
"48071",2017,0,0,67,67
"48071",2018,0,0,74,74
"48071",2019,0,0,42,42
"48071",2020,0,0,12,12
"48072",2014,0,0,39,39
"48072",2015,0,0,111,111
"48072",2016,0,0,65,65
"48072",2017,0,0,22,22
"48072",2018,0,0,43,43
"48072",2019,0,0,30,30
"48072",2020,0,0,12,12
"48073",2013,0,0,54,54
"48073",2014,0,0,39,39
"48073",2015,0,0,125,125
"48073",2016,0,0,65,65
"48073",2017,0,0,14,14
"48073",2018,0,0,60,60
"48073",2019,0,0,30,30
"48073",2020,0,0,87,87
"48074",2014,0,0,39,39
"48074",2015,0,0,125,125
"48074",2016,0,0,65,65
"48074",2017,0,0,59,59
"48074",2018,0,0,60,60
"48074",2019,0,0,16,16
"48074",2020,0,0,87,87
"48075",2014,0,0,39,39
"48075",2015,0,0,125,125
"48075",2016,0,0,65,65
"48075",2017,0,0,14,14
"48075",2018,0,0,60,60
"48075",2019,0,0,16,16
"48075",2020,0,0,87,87
"48077",2014,0,0,39,39
"48077",2015,0,0,111,111
"48077",2016,0,0,65,65
"48077",2017,0,0,22,22
"48077",2018,0,0,43,43
"48077",2019,0,0,29,29
"48077",2020,0,0,12,12
"48079",2014,0,0,39,39
"48079",2015,0,0,111,111
"48079",2016,0,0,89,89
"48079",2017,0,0,67,67
"48079",2018,0,0,74,74
"48079",2019,0,0,42,42
"48079",2020,0,0,12,12
"48080",2013,0,0,54,54
"48080",2014,0,0,39,39
"48080",2015,0,0,125,125
"48080",2016,0,0,65,65
"48080",2017,0,0,14,14
"48080",2018,0,0,43,43
"48080",2019,0,0,29,29
"48080",2020,0,0,87,87
"48081",2013,0,0,54,54
"48081",2014,0,0,39,39
"48081",2015,0,0,125,125
"48081",2016,0,0,65,65
"48081",2017,0,0,14,14
"48081",2018,0,0,60,60
"48081",2019,0,0,30,30
"48081",2020,0,0,87,87
"48082",2013,0,0,54,54
"48082",2014,0,0,39,39
"48082",2015,0,0,125,125
"48082",2016,0,0,65,65
"48082",2017,0,0,14,14
"48082",2018,0,0,60,60
"48082",2019,0,0,29,29
"48082",2020,0,0,87,87
"48083",2014,0,0,39,39
"48083",2015,0,0,111,111
"48083",2016,0,0,89,89
"48083",2017,0,0,67,67
"48083",2018,0,0,60,60
"48083",2019,0,0,42,42
"48083",2020,0,0,12,12
"48085",2013,0,0,54,54
"48085",2014,0,0,39,39
"48085",2015,0,0,125,125
"48085",2016,0,0,65,65
"48085",2017,0,0,14,14
"48085",2018,0,0,60,60
"48085",2019,0,0,16,16
"48085",2020,0,0,87,87
"48086",2013,0,0,54,54
"48086",2014,0,0,105,105
"48086",2015,0,0,111,111
"48086",2016,0,0,51,51
"48086",2017,0,0,22,22
"48086",2018,0,0,18,18
"48086",2019,0,0,29,29
"48086",2020,0,0,87,87
"48087",2014,0,0,39,39
"48087",2015,0,0,111,111
"48087",2016,0,0,89,89
"48087",2017,0,0,67,67
"48087",2018,0,0,60,60
"48087",2019,0,0,42,42
"48087",2020,0,0,12,12
"48088",2013,0,0,54,54
"48088",2014,0,0,39,39
"48088",2015,0,0,125,125
"48088",2016,0,0,65,65
"48088",2017,0,0,14,14
"48088",2018,0,0,60,60
"48088",2019,0,0,16,16
"48088",2020,0,0,87,87
"48089",2014,0,0,39,39
"48089",2015,0,0,111,111
"48089",2016,0,0,65,65
"48089",2017,0,0,22,22
"48089",2018,0,0,43,43
"48089",2019,0,0,29,29
"48089",2020,0,0,12,12
"48090",2014,0,0,39,39
"48090",2015,0,0,111,111
"48090",2016,0,0,89,89
"48090",2017,0,0,67,67
"48090",2018,0,0,74,74
"48090",2019,0,0,42,42
"48090",2020,0,0,12,12
"48091",2014,0,0,39,39
"48091",2015,0,0,111,111
"48091",2016,0,0,65,65
"48091",2017,0,0,22,22
"48091",2018,0,0,43,43
"48091",2019,0,0,30,30
"48091",2020,0,0,12,12
"48092",2014,0,0,21,21
"48092",2015,0,0,104,104
"48092",2016,0,0,51,51
"48092",2017,0,0,53,53
"48092",2018,0,0,45,45
"48092",2019,0,0,16,16
"48092",2020,0,0,12,12
"48094",2013,0,0,54,54
"48094",2014,0,0,39,39
"48094",2015,0,0,125,125
"48094",2016,0,0,65,65
"48094",2017,0,0,14,14
"48094",2018,0,0,60,60
"48094",2019,0,0,16,16
"48094",2020,0,0,87,87
"48095",2014,0,0,39,39
"48095",2015,0,0,111,111
"48095",2016,0,0,65,65
"48095",2017,0,0,22,22
"48095",2018,0,0,43,43
"48095",2019,0,0,30,30
"48095",2020,0,0,12,12
"48096",2014,0,0,39,39
"48096",2015,0,0,125,125
"48096",2016,0,0,65,65
"48096",2017,0,0,59,59
"48096",2018,0,0,60,60
"48096",2019,0,0,16,16
"48096",2020,0,0,87,87
"48097",2013,0,0,54,54
"48097",2014,0,0,105,105
"48097",2015,0,0,104,104
"48097",2016,0,0,89,89
"48097",2017,0,0,22,22
"48097",2018,0,0,43,43
"48097",2019,0,0,16,16
"48097",2020,0,0,87,87
"48098",2013,0,0,54,54
"48098",2014,0,0,105,105
"48098",2015,0,0,104,104
"48098",2016,0,0,65,65
"48098",2017,0,0,22,22
"48098",2018,0,0,43,43
"48098",2019,0,0,16,16
"48098",2020,0,0,87,87
"48099",2014,0,0,21,21
"48099",2015,0,0,104,104
"48099",2016,0,0,51,51
"48099",2017,0,0,8,8
"48099",2018,0,0,28,28
"48099",2019,0,0,16,16
"48099",2020,0,0,12,12
"48100",2013,0,0,54,54
"48100",2014,0,0,105,105
"48100",2015,0,0,111,111
"48100",2016,0,0,51,51
"48100",2017,0,0,22,22
"48100",2018,0,0,35,35
"48100",2019,0,0,29,29
"48100",2020,0,0,87,87
"48103",2014,0,0,39,39
"48103",2015,0,0,111,111
"48103",2016,0,0,89,89
"48103",2017,0,0,67,67
"48103",2018,0,0,60,60
"48103",2019,0,0,42,42
"48103",2020,0,0,12,12
"48104",2014,0,0,39,39
"48104",2015,0,0,111,111
"48104",2016,0,0,65,65
"48104",2017,0,0,22,22
"48104",2018,0,0,43,43
"48104",2019,0,0,30,30
"48104",2020,0,0,12,12
"48105",2013,0,0,54,54
"48105",2014,0,0,39,39
"48105",2015,0,0,125,125
"48105",2016,0,0,65,65
"48105",2017,0,0,14,14
"48105",2018,0,0,43,43
"48105",2019,0,0,29,29
"48105",2020,0,0,87,87
"48106",2014,0,0,39,39
"48106",2015,0,0,111,111
"48106",2016,0,0,89,89
"48106",2017,0,0,67,67
"48106",2018,0,0,74,74
"48106",2019,0,0,42,42
"48106",2020,0,0,12,12
"48107",2014,0,0,39,39
"48107",2015,0,0,111,111
"48107",2016,0,0,65,65
"48107",2017,0,0,22,22
"48107",2018,0,0,43,43
"48107",2019,0,0,30,30
"48107",2020,0,0,12,12
"48108",2014,0,0,39,39
"48108",2015,0,0,111,111
"48108",2016,0,0,65,65
"48108",2017,0,0,22,22
"48108",2018,0,0,43,43
"48108",2019,0,0,29,29
"48108",2020,0,0,12,12
"48110",2014,0,0,39,39
"48110",2015,0,0,111,111
"48110",2016,0,0,65,65
"48110",2017,0,0,22,22
"48110",2018,0,0,43,43
"48110",2019,0,0,29,29
"48110",2020,0,0,12,12
"48111",2013,0,0,54,54
"48111",2014,0,0,39,39
"48111",2015,0,0,125,125
"48111",2016,0,0,65,65
"48111",2017,0,0,14,14
"48111",2018,0,0,60,60
"48111",2019,0,0,29,29
"48111",2020,0,0,87,87
"48112",2013,0,0,54,54
"48112",2014,0,0,39,39
"48112",2015,0,0,125,125
"48112",2016,0,0,65,65
"48112",2017,0,0,14,14
"48112",2018,0,0,43,43
"48112",2019,0,0,29,29
"48112",2020,0,0,87,87
"48115",2013,0,0,54,54
"48115",2014,0,0,105,105
"48115",2015,0,0,104,104
"48115",2016,0,0,65,65
"48115",2017,0,0,22,22
"48115",2018,0,0,43,43
"48115",2019,0,0,16,16
"48115",2020,0,0,87,87
"48116",2013,0,0,54,54
"48116",2014,0,0,105,105
"48116",2015,0,0,104,104
"48116",2016,0,0,51,51
"48116",2017,0,0,22,22
"48116",2018,0,0,35,35
"48116",2019,0,0,16,16
"48116",2020,0,0,87,87
"48117",2013,0,0,54,54
"48117",2014,0,0,105,105
"48117",2015,0,0,111,111
"48117",2016,0,0,51,51
"48117",2017,0,0,22,22
"48117",2018,0,0,18,18
"48117",2019,0,0,29,29
"48117",2020,0,0,87,87
"48119",2013,0,0,54,54
"48119",2014,0,0,105,105
"48119",2015,0,0,111,111
"48119",2016,0,0,51,51
"48119",2017,0,0,22,22
"48119",2018,0,0,18,18
"48119",2019,0,0,29,29
"48119",2020,0,0,87,87
"48121",2014,0,0,39,39
"48121",2015,0,0,111,111
"48121",2016,0,0,89,89
"48121",2017,0,0,67,67
"48121",2018,0,0,74,74
"48121",2019,0,0,42,42
"48121",2020,0,0,12,12
"48123",2014,0,0,39,39
"48123",2015,0,0,111,111
"48123",2016,0,0,89,89
"48123",2017,0,0,67,67
"48123",2018,0,0,74,74
"48123",2019,0,0,42,42
"48123",2020,0,0,12,12
"48124",2014,0,0,21,21
"48124",2015,0,0,104,104
"48124",2016,0,0,51,51
"48124",2017,0,0,53,53
"48124",2018,0,0,45,45
"48124",2019,0,0,16,16
"48124",2020,0,0,12,12
"48126",2014,0,0,21,21
"48126",2015,0,0,104,104
"48126",2016,0,0,51,51
"48126",2017,0,0,53,53
"48126",2018,0,0,45,45
"48126",2019,0,0,16,16
"48126",2020,0,0,12,12
"48127",2014,0,0,21,21
"48127",2015,0,0,104,104
"48127",2016,0,0,51,51
"48127",2017,0,0,8,8
"48127",2018,0,0,28,28
"48127",2019,0,0,29,29
"48127",2020,0,0,12,12
"48128",2014,0,0,39,39
"48128",2015,0,0,111,111
"48128",2016,0,0,89,89
"48128",2017,0,0,67,67
"48128",2018,0,0,74,74
"48128",2019,0,0,42,42
"48128",2020,0,0,12,12
"48129",2013,0,0,54,54
"48129",2014,0,0,39,39
"48129",2015,0,0,125,125
"48129",2016,0,0,65,65
"48129",2017,0,0,14,14
"48129",2018,0,0,43,43
"48129",2019,0,0,29,29
"48129",2020,0,0,87,87
"48130",2014,0,0,39,39
"48130",2015,0,0,125,125
"48130",2016,0,0,65,65
"48130",2017,0,0,59,59
"48130",2018,0,0,60,60
"48130",2019,0,0,16,16
"48130",2020,0,0,87,87
"48131",2014,0,0,39,39
"48131",2015,0,0,125,125
"48131",2016,0,0,65,65
"48131",2017,0,0,59,59
"48131",2018,0,0,60,60
"48131",2019,0,0,16,16
"48131",2020,0,0,87,87
"48132",2014,0,0,39,39
"48132",2015,0,0,111,111
"48132",2016,0,0,89,89
"48132",2017,0,0,67,67
"48132",2018,0,0,74,74
"48132",2019,0,0,42,42
"48132",2020,0,0,12,12
"48135",2013,0,0,54,54
"48135",2014,0,0,105,105
"48135",2015,0,0,111,111
"48135",2016,0,0,51,51
"48135",2017,0,0,22,22
"48135",2018,0,0,18,18
"48135",2019,0,0,29,29
"48135",2020,0,0,87,87
"48136",2013,0,0,54,54
"48136",2014,0,0,105,105
"48136",2015,0,0,104,104
"48136",2016,0,0,65,65
"48136",2017,0,0,22,22
"48136",2018,0,0,43,43
"48136",2019,0,0,16,16
"48136",2020,0,0,87,87
"48137",2013,0,0,54,54
"48137",2014,0,0,39,39
"48137",2015,0,0,125,125
"48137",2016,0,0,65,65
"48137",2017,0,0,14,14
"48137",2018,0,0,60,60
"48137",2019,0,0,16,16
"48137",2020,0,0,87,87
"48138",2014,0,0,21,21
"48138",2015,0,0,104,104
"48138",2016,0,0,51,51
"48138",2017,0,0,8,8
"48138",2018,0,0,28,28
"48138",2019,0,0,16,16
"48138",2020,0,0,12,12
"48139",2013,0,0,54,54
"48139",2014,0,0,39,39
"48139",2015,0,0,125,125
"48139",2016,0,0,65,65
"48139",2017,0,0,14,14
"48139",2018,0,0,43,43
"48139",2019,0,0,29,29
"48139",2020,0,0,87,87
"48140",2014,0,0,39,39
"48140",2015,0,0,111,111
"48140",2016,0,0,89,89
"48140",2017,0,0,67,67
"48140",2018,0,0,74,74
"48140",2019,0,0,42,42
"48140",2020,0,0,12,12
"48141",2014,0,0,39,39
"48141",2015,0,0,125,125
"48141",2016,0,0,65,65
"48141",2017,0,0,59,59
"48141",2018,0,0,60,60
"48141",2019,0,0,16,16
"48141",2020,0,0,87,87
"48144",2013,0,0,54,54
"48144",2014,0,0,105,105
"48144",2015,0,0,104,104
"48144",2016,0,0,89,89
"48144",2017,0,0,22,22
"48144",2018,0,0,43,43
"48144",2019,0,0,16,16
"48144",2020,0,0,87,87
"48145",2014,0,0,39,39
"48145",2015,0,0,111,111
"48145",2016,0,0,65,65
"48145",2017,0,0,22,22
"48145",2018,0,0,43,43
"48145",2019,0,0,29,29
"48145",2020,0,0,12,12
"48146",2013,0,0,54,54
"48146",2014,0,0,39,39
"48146",2015,0,0,125,125
"48146",2016,0,0,65,65
"48146",2017,0,0,14,14
"48146",2018,0,0,60,60
"48146",2019,0,0,16,16
"48146",2020,0,0,87,87
"48147",2013,0,0,54,54
"48147",2014,0,0,39,39
"48147",2015,0,0,125,125
"48147",2016,0,0,65,65
"48147",2017,0,0,14,14
"48147",2018,0,0,60,60
"48147",2019,0,0,16,16
"48147",2020,0,0,87,87
"48148",2013,0,0,54,54
"48148",2014,0,0,105,105
"48148",2015,0,0,104,104
"48148",2016,0,0,89,89
"48148",2017,0,0,22,22
"48148",2018,0,0,43,43
"48148",2019,0,0,16,16
"48148",2020,0,0,87,87
"48149",2014,0,0,39,39
"48149",2015,0,0,111,111
"48149",2016,0,0,65,65
"48149",2017,0,0,22,22
"48149",2018,0,0,43,43
"48149",2019,0,0,29,29
"48149",2020,0,0,12,12
"48150",2013,0,0,54,54
"48150",2014,0,0,39,39
"48150",2015,0,0,125,125
"48150",2016,0,0,65,65
"48150",2017,0,0,14,14
"48150",2018,0,0,43,43
"48150",2019,0,0,29,29
"48150",2020,0,0,87,87
"48151",2013,0,0,54,54
"48151",2014,0,0,105,105
"48151",2015,0,0,111,111
"48151",2016,0,0,51,51
"48151",2017,0,0,22,22
"48151",2018,0,0,18,18
"48151",2019,0,0,29,29
"48151",2020,0,0,87,87
"48152",2013,0,0,54,54
"48152",2014,0,0,105,105
"48152",2015,0,0,104,104
"48152",2016,0,0,65,65
"48152",2017,0,0,22,22
"48152",2018,0,0,43,43
"48152",2019,0,0,16,16
"48152",2020,0,0,87,87
"48153",2014,0,0,21,21
"48153",2015,0,0,104,104
"48153",2016,0,0,51,51
"48153",2017,0,0,53,53
"48153",2018,0,0,45,45
"48153",2019,0,0,16,16
"48153",2020,0,0,12,12
"48155",2013,0,0,54,54
"48155",2014,0,0,105,105
"48155",2015,0,0,104,104
"48155",2016,0,0,65,65
"48155",2017,0,0,22,22
"48155",2018,0,0,43,43
"48155",2019,0,0,16,16
"48155",2020,0,0,87,87
"48156",2014,0,0,39,39
"48156",2015,0,0,111,111
"48156",2016,0,0,65,65
"48156",2017,0,0,22,22
"48156",2018,0,0,43,43
"48156",2019,0,0,30,30
"48156",2020,0,0,12,12
"48157",2013,0,0,54,54
"48157",2014,0,0,39,39
"48157",2015,0,0,125,125
"48157",2016,0,0,65,65
"48157",2017,0,0,14,14
"48157",2018,0,0,60,60
"48157",2019,0,0,30,30
"48157",2020,0,0,87,87
"48158",2013,0,0,54,54
"48158",2014,0,0,105,105
"48158",2015,0,0,104,104
"48158",2016,0,0,89,89
"48158",2017,0,0,22,22
"48158",2018,0,0,43,43
"48158",2019,0,0,16,16
"48158",2020,0,0,87,87
"48160",2013,0,0,54,54
"48160",2014,0,0,39,39
"48160",2015,0,0,125,125
"48160",2016,0,0,65,65
"48160",2017,0,0,14,14
"48160",2018,0,0,43,43
"48160",2019,0,0,29,29
"48160",2020,0,0,87,87
"48161",2014,0,0,39,39
"48161",2015,0,0,111,111
"48161",2016,0,0,89,89
"48161",2017,0,0,67,67
"48161",2018,0,0,74,74
"48161",2019,0,0,42,42
"48161",2020,0,0,12,12
"48163",2013,0,0,54,54
"48163",2014,0,0,105,105
"48163",2015,0,0,104,104
"48163",2016,0,0,89,89
"48163",2017,0,0,22,22
"48163",2018,0,0,43,43
"48163",2019,0,0,16,16
"48163",2020,0,0,87,87
"48165",2014,0,0,39,39
"48165",2015,0,0,111,111
"48165",2016,0,0,65,65
"48165",2017,0,0,22,22
"48165",2018,0,0,43,43
"48165",2019,0,0,30,30
"48165",2020,0,0,12,12
"48166",2014,0,0,39,39
"48166",2015,0,0,125,125
"48166",2016,0,0,65,65
"48166",2017,0,0,59,59
"48166",2018,0,0,60,60
"48166",2019,0,0,16,16
"48166",2020,0,0,87,87
"48167",2014,0,0,39,39
"48167",2015,0,0,111,111
"48167",2016,0,0,89,89
"48167",2017,0,0,67,67
"48167",2018,0,0,74,74
"48167",2019,0,0,42,42
"48167",2020,0,0,12,12
"48168",2014,0,0,21,21
"48168",2015,0,0,104,104
"48168",2016,0,0,51,51
"48168",2017,0,0,53,53
"48168",2018,0,0,45,45
"48168",2019,0,0,16,16
"48168",2020,0,0,12,12
"48169",2014,0,0,39,39
"48169",2015,0,0,111,111
"48169",2016,0,0,89,89
"48169",2017,0,0,67,67
"48169",2018,0,0,74,74
"48169",2019,0,0,42,42
"48169",2020,0,0,12,12
"48170",2013,0,0,54,54
"48170",2014,0,0,105,105
"48170",2015,0,0,104,104
"48170",2016,0,0,89,89
"48170",2017,0,0,22,22
"48170",2018,0,0,43,43
"48170",2019,0,0,16,16
"48170",2020,0,0,87,87
"48171",2013,0,0,54,54
"48171",2014,0,0,105,105
"48171",2015,0,0,104,104
"48171",2016,0,0,65,65
"48171",2017,0,0,22,22
"48171",2018,0,0,43,43
"48171",2019,0,0,16,16
"48171",2020,0,0,87,87
"48173",2013,0,0,54,54
"48173",2014,0,0,105,105
"48173",2015,0,0,104,104
"48173",2016,0,0,89,89
"48173",2017,0,0,22,22
"48173",2018,0,0,43,43
"48173",2019,0,0,16,16
"48173",2020,0,0,87,87
"48174",2014,0,0,39,39
"48174",2015,0,0,111,111
"48174",2016,0,0,65,65
"48174",2017,0,0,22,22
"48174",2018,0,0,43,43
"48174",2019,0,0,29,29
"48174",2020,0,0,12,12
"48175",2013,0,0,54,54
"48175",2014,0,0,39,39
"48175",2015,0,0,125,125
"48175",2016,0,0,65,65
"48175",2017,0,0,14,14
"48175",2018,0,0,60,60
"48175",2019,0,0,30,30
"48175",2020,0,0,87,87
"48176",2014,0,0,39,39
"48176",2015,0,0,125,125
"48176",2016,0,0,65,65
"48176",2017,0,0,59,59
"48176",2018,0,0,60,60
"48176",2019,0,0,16,16
"48176",2020,0,0,87,87
"48177",2014,0,0,39,39
"48177",2015,0,0,111,111
"48177",2016,0,0,89,89
"48177",2017,0,0,67,67
"48177",2018,0,0,74,74
"48177",2019,0,0,42,42
"48177",2020,0,0,12,12
"48178",2013,0,0,54,54
"48178",2014,0,0,105,105
"48178",2015,0,0,104,104
"48178",2016,0,0,65,65
"48178",2017,0,0,22,22
"48178",2018,0,0,43,43
"48178",2019,0,0,16,16
"48178",2020,0,0,87,87
"48179",2014,0,0,39,39
"48179",2015,0,0,111,111
"48179",2016,0,0,65,65
"48179",2017,0,0,22,22
"48179",2018,0,0,43,43
"48179",2019,0,0,29,29
"48179",2020,0,0,12,12
"48181",2013,0,0,54,54
"48181",2014,0,0,39,39
"48181",2015,0,0,125,125
"48181",2016,0,0,65,65
"48181",2017,0,0,14,14
"48181",2018,0,0,60,60
"48181",2019,0,0,30,30
"48181",2020,0,0,87,87
"48182",2014,0,0,39,39
"48182",2015,0,0,111,111
"48182",2016,0,0,65,65
"48182",2017,0,0,22,22
"48182",2018,0,0,43,43
"48182",2019,0,0,29,29
"48182",2020,0,0,12,12
"48185",2014,0,0,39,39
"48185",2015,0,0,111,111
"48185",2016,0,0,65,65
"48185",2017,0,0,22,22
"48185",2018,0,0,43,43
"48185",2019,0,0,30,30
"48185",2020,0,0,12,12
"48187",2014,0,0,39,39
"48187",2015,0,0,111,111
"48187",2016,0,0,65,65
"48187",2017,0,0,22,22
"48187",2018,0,0,43,43
"48187",2019,0,0,30,30
"48187",2020,0,0,12,12
"48188",2014,0,0,39,39
"48188",2015,0,0,111,111
"48188",2016,0,0,89,89
"48188",2017,0,0,67,67
"48188",2018,0,0,60,60
"48188",2019,0,0,42,42
"48188",2020,0,0,12,12
"48190",2014,0,0,39,39
"48190",2015,0,0,111,111
"48190",2016,0,0,89,89
"48190",2017,0,0,67,67
"48190",2018,0,0,74,74
"48190",2019,0,0,42,42
"48190",2020,0,0,12,12
"48191",2013,0,0,54,54
"48191",2014,0,0,39,39
"48191",2015,0,0,125,125
"48191",2016,0,0,65,65
"48191",2017,0,0,14,14
"48191",2018,0,0,60,60
"48191",2019,0,0,16,16
"48191",2020,0,0,87,87
"48192",2013,0,0,54,54
"48192",2014,0,0,39,39
"48192",2015,0,0,125,125
"48192",2016,0,0,65,65
"48192",2017,0,0,14,14
"48192",2018,0,0,60,60
"48192",2019,0,0,30,30
"48192",2020,0,0,87,87
"48193",2013,0,0,54,54
"48193",2014,0,0,105,105
"48193",2015,0,0,104,104
"48193",2016,0,0,65,65
"48193",2017,0,0,22,22
"48193",2018,0,0,43,43
"48193",2019,0,0,16,16
"48193",2020,0,0,87,87
"48194",2013,0,0,54,54
"48194",2014,0,0,105,105
"48194",2015,0,0,104,104
"48194",2016,0,0,51,51
"48194",2017,0,0,22,22
"48194",2018,0,0,18,18
"48194",2019,0,0,16,16
"48194",2020,0,0,87,87
"48198",2013,0,0,54,54
"48198",2014,0,0,105,105
"48198",2015,0,0,111,111
"48198",2016,0,0,51,51
"48198",2017,0,0,22,22
"48198",2018,0,0,18,18
"48198",2019,0,0,29,29
"48198",2020,0,0,87,87
"49002",2015,0,21,21,42
"49002",2017,0,28,148,176
"49002",2018,0,78,0,78
"49002",2019,0,55,61,116
"49002",2020,0,51,81,132
"49003",2013,0,0,15,15
"49003",2014,0,0,94,94
"49003",2015,0,42,7,49
"49003",2016,0,28,0,28
"49003",2017,0,54,8,62
"49003",2018,0,28,0,28
"49003",2019,0,22,0,22
"49003",2020,0,20,21,41
"49007",2014,0,107,81,188
"49007",2015,0,47,0,47
"49007",2016,0,42,14,56
"49007",2017,0,90,8,98
"49007",2018,0,49,0,49
"49007",2019,0,56,7,63
"49007",2020,0,29,53,82
"49008",2013,0,0,7,7
"49008",2014,0,81,116,197
"49008",2015,0,34,7,41
"49008",2016,0,28,21,49
"49008",2017,0,0,14,14
"49008",2018,0,21,7,28
"49008",2019,0,0,7,7
"49008",2020,0,20,46,66
"49009",2013,0,0,28,28
"49009",2015,0,28,48,76
"49009",2016,0,34,0,34
"49009",2017,0,173,0,173
"49009",2018,0,67,0,67
"49009",2019,0,88,0,88
"49009",2020,0,46,18,64
"49010",2013,0,0,21,21
"49010",2014,0,0,101,101
"49010",2015,0,0,21,21
"49010",2016,0,41,21,62
"49010",2017,0,0,14,14
"49010",2018,0,21,7,28
"49010",2019,0,68,7,75
"49010",2020,0,0,46,46
"49011",2013,0,0,28,28
"49011",2015,0,28,48,76
"49011",2016,0,34,0,34
"49011",2017,0,173,14,187
"49011",2018,0,67,28,95
"49011",2019,0,88,34,122
"49011",2020,0,46,28,74
"49012",2013,0,0,15,15
"49012",2014,0,0,94,94
"49012",2015,0,28,14,42
"49012",2016,0,28,0,28
"49012",2017,0,54,0,54
"49012",2018,0,35,0,35
"49012",2019,0,22,34,56
"49012",2020,0,20,21,41
"49015",2014,0,107,81,188
"49015",2015,0,47,0,47
"49015",2016,0,42,14,56
"49015",2017,0,90,8,98
"49015",2018,0,65,0,65
"49015",2019,0,56,7,63
"49015",2020,0,29,53,82
"49017",2015,0,0,40,40
"49017",2017,0,166,14,180
"49017",2018,0,116,28,144
"49017",2019,0,69,81,150
"49017",2020,0,82,115,197
"49018",2015,0,0,19,19
"49018",2016,0,0,63,63
"49018",2017,0,277,63,340
"49018",2018,0,86,14,100
"49018",2019,0,55,7,62
"49018",2020,0,80,11,91
"49020",2014,0,107,81,188
"49020",2015,0,47,0,47
"49020",2016,0,42,14,56
"49020",2017,0,90,8,98
"49020",2018,0,65,0,65
"49020",2019,0,26,10,36
"49020",2020,0,48,48,96
"49021",2015,0,21,13,34
"49021",2016,0,0,63,63
"49021",2017,0,277,133,410
"49021",2018,0,8,14,22
"49021",2019,0,12,7,19
"49021",2020,0,49,11,60
"49022",2013,0,0,15,15
"49022",2014,0,0,94,94
"49022",2015,0,28,14,42
"49022",2016,0,28,0,28
"49022",2017,0,54,8,62
"49022",2018,0,35,0,35
"49022",2019,0,22,34,56
"49022",2020,0,20,21,41
"49023",2013,0,0,7,7
"49023",2014,0,0,94,94
"49023",2015,0,28,14,42
"49023",2016,0,28,0,28
"49023",2017,0,54,14,68
"49023",2018,0,35,0,35
"49023",2019,0,22,34,56
"49023",2020,0,20,21,41
"49026",2013,0,0,15,15
"49026",2014,0,107,81,188
"49026",2015,0,47,7,54
"49026",2016,0,42,84,126
"49026",2017,0,90,86,176
"49026",2018,0,65,14,79
"49026",2019,0,26,7,33
"49026",2020,0,48,0,48
"49027",2013,0,0,7,7
"49027",2014,0,0,94,94
"49027",2015,0,0,27,27
"49027",2016,0,0,20,20
"49027",2017,0,75,50,125
"49027",2018,0,8,56,64
"49027",2019,0,19,27,46
"49027",2020,0,0,13,13
"49028",2014,0,107,0,107
"49028",2015,0,47,21,68
"49028",2016,0,42,0,42
"49028",2017,0,90,28,118
"49028",2018,0,65,22,87
"49028",2019,0,26,16,42
"49028",2020,0,0,63,63
"49029",2013,0,0,29,29
"49029",2014,0,0,94,94
"49029",2015,0,49,7,56
"49029",2016,0,34,21,55
"49029",2017,0,77,15,92
"49029",2018,0,36,21,57
"49029",2019,0,100,7,107
"49029",2020,0,62,11,73
"49030",2015,0,0,28,28
"49030",2017,0,277,148,425
"49030",2018,0,86,0,86
"49030",2019,0,55,133,188
"49030",2020,0,0,58,58
"49035",2014,0,107,0,107
"49035",2015,0,47,21,68
"49035",2016,0,42,0,42
"49035",2017,0,90,28,118
"49035",2018,0,65,22,87
"49035",2019,0,26,16,42
"49035",2020,0,48,63,111
"49036",2013,0,0,21,21
"49036",2014,0,0,101,101
"49036",2015,0,0,21,21
"49036",2016,0,41,21,62
"49036",2017,0,0,14,14
"49036",2018,0,21,7,28
"49036",2019,0,68,7,75
"49036",2020,0,0,46,46
"49038",2013,0,0,21,21
"49038",2014,0,0,101,101
"49038",2015,0,0,21,21
"49038",2016,0,41,21,62
"49038",2017,0,0,14,14
"49038",2018,0,21,7,28
"49038",2019,0,68,7,75
"49038",2020,0,0,46,46
"49041",2015,0,21,21,42
"49041",2017,0,28,28,56
"49041",2018,0,78,0,78
"49041",2019,0,55,13,68
"49041",2020,0,51,63,114
"49045",2015,0,0,28,28
"49045",2017,0,0,148,148
"49045",2018,0,78,0,78
"49045",2019,0,55,61,116
"49045",2020,0,0,81,81
"49048",2015,0,0,40,40
"49048",2016,0,0,21,21
"49048",2017,0,166,14,180
"49048",2018,0,116,28,144
"49048",2019,0,69,115,184
"49048",2020,0,82,115,197
"49050",2013,0,0,15,15
"49050",2014,0,0,94,94
"49050",2015,0,56,7,63
"49050",2016,0,28,0,28
"49050",2017,0,54,8,62
"49050",2018,0,28,0,28
"49050",2019,0,22,0,22
"49050",2020,0,20,21,41
"49053",2013,0,0,28,28
"49053",2015,0,28,48,76
"49053",2016,0,34,0,34
"49053",2017,0,173,14,187
"49053",2018,0,67,28,95
"49053",2019,0,88,34,122
"49053",2020,0,46,28,74
"49054",2013,0,0,15,15
"49054",2014,0,81,116,197
"49054",2015,0,34,19,53
"49054",2016,0,28,63,91
"49054",2017,0,68,13,81
"49054",2018,0,50,0,50
"49054",2019,0,15,41,56
"49054",2020,0,20,56,76
"49055",2013,0,0,28,28
"49055",2014,0,107,0,107
"49055",2015,0,47,8,55
"49055",2016,0,42,48,90
"49055",2017,0,90,7,97
"49055",2018,0,65,7,72
"49055",2019,0,56,70,126
"49055",2020,0,29,53,82
"49056",2013,0,0,21,21
"49056",2014,0,0,101,101
"49056",2015,0,0,21,21
"49056",2016,0,41,21,62
"49056",2017,0,0,14,14
"49056",2018,0,21,7,28
"49056",2019,0,68,7,75
"49056",2020,0,0,46,46
"49057",2013,0,0,15,15
"49057",2014,0,0,94,94
"49057",2015,0,28,14,42
"49057",2016,0,28,0,28
"49057",2017,0,54,0,54
"49057",2018,0,35,0,35
"49057",2019,0,22,34,56
"49057",2020,0,20,21,41
"49058",2013,0,0,50,50
"49058",2015,0,28,20,48
"49058",2016,0,34,7,41
"49058",2017,0,173,14,187
"49058",2018,0,67,0,67
"49058",2019,0,88,14,102
"49058",2020,0,46,50,96
"49060",2013,0,0,28,28
"49060",2015,0,28,48,76
"49060",2016,0,34,0,34
"49060",2017,0,173,0,173
"49060",2018,0,67,0,67
"49060",2019,0,88,0,88
"49060",2020,0,46,18,64
"49061",2013,0,0,7,7
"49061",2014,0,81,116,197
"49061",2015,0,34,7,41
"49061",2016,0,28,21,49
"49061",2017,0,0,14,14
"49061",2018,0,21,7,28
"49061",2019,0,0,7,7
"49061",2020,0,20,46,66
"49063",2013,0,0,15,15
"49063",2014,0,107,94,201
"49063",2015,0,47,14,61
"49063",2016,0,42,0,42
"49063",2017,0,90,0,90
"49063",2018,0,65,0,65
"49063",2019,0,14,34,48
"49063",2020,0,20,21,41
"49064",2013,0,0,21,21
"49064",2014,0,0,101,101
"49064",2015,0,42,21,63
"49064",2016,0,48,21,69
"49064",2017,0,0,14,14
"49064",2018,0,21,7,28
"49064",2019,0,34,7,41
"49064",2020,0,53,53,106
"49067",2013,0,0,28,28
"49067",2015,0,42,8,50
"49067",2016,0,48,48,96
"49067",2017,0,49,7,56
"49067",2018,0,58,7,65
"49067",2019,0,42,36,78
"49067",2020,0,53,53,106
"49068",2013,0,0,15,15
"49068",2014,0,107,81,188
"49068",2015,0,47,7,54
"49068",2016,0,42,84,126
"49068",2017,0,90,86,176
"49068",2018,0,65,14,79
"49068",2019,0,27,7,34
"49068",2020,0,60,0,60
"49069",2014,0,0,109,109
"49069",2015,0,0,14,14
"49069",2016,0,0,14,14
"49069",2017,0,81,28,109
"49069",2018,0,8,21,29
"49069",2019,0,74,14,88
"49069",2020,0,0,39,39
"49070",2013,0,0,7,7
"49070",2014,0,0,94,94
"49070",2015,0,42,7,49
"49070",2016,0,28,0,28
"49070",2017,0,54,14,68
"49070",2018,0,51,0,51
"49070",2019,0,22,0,22
"49070",2020,0,20,47,67
"49076",2015,0,0,40,40
"49076",2017,0,166,14,180
"49076",2018,0,116,28,144
"49076",2019,0,69,81,150
"49076",2020,0,82,115,197
"49080",2013,0,0,28,28
"49080",2015,0,42,8,50
"49080",2016,0,48,48,96
"49080",2017,0,49,7,56
"49080",2018,0,72,7,79
"49080",2019,0,42,70,112
"49080",2020,0,53,53,106
"49082",2013,0,0,15,15
"49082",2014,0,0,94,94
"49082",2015,0,28,14,42
"49082",2016,0,28,0,28
"49082",2017,0,54,0,54
"49082",2018,0,35,0,35
"49082",2019,0,22,34,56
"49082",2020,0,20,21,41
"49086",2013,0,0,15,15
"49086",2014,0,0,94,94
"49086",2015,0,42,7,49
"49086",2016,0,28,0,28
"49086",2017,0,54,8,62
"49086",2018,0,51,0,51
"49086",2019,0,22,0,22
"49086",2020,0,20,21,41
"49089",2013,0,0,7,7
"49089",2014,0,81,116,197
"49089",2015,0,34,7,41
"49089",2016,0,28,21,49
"49089",2017,0,0,14,14
"49089",2018,0,21,7,28
"49089",2019,0,0,7,7
"49089",2020,0,20,46,66
"49090",2016,0,0,21,21
"49090",2017,0,166,6,172
"49090",2018,0,116,0,116
"49090",2019,0,69,122,191
"49090",2020,0,82,115,197
"49092",2013,0,0,7,7
"49092",2014,0,0,94,94
"49092",2015,0,42,14,56
"49092",2016,0,28,0,28
"49092",2017,0,54,8,62
"49092",2018,0,35,0,35
"49092",2019,0,14,34,48
"49092",2020,0,20,21,41
"49099",2013,0,0,7,7
"49099",2014,0,0,94,94
"49099",2015,0,0,27,27
"49099",2016,0,0,27,27
"49099",2017,0,75,41,116
"49099",2018,0,8,56,64
"49099",2019,0,19,27,46
"49100",2013,0,0,28,28
"49100",2015,0,28,48,76
"49100",2016,0,34,0,34
"49100",2017,0,173,14,187
"49100",2018,0,67,28,95
"49100",2019,0,88,34,122
"49100",2020,0,46,28,74
"49102",2013,0,0,15,15
"49102",2014,0,0,94,94
"49102",2015,0,28,14,42
"49102",2016,0,28,0,28
"49102",2017,0,54,0,54
"49102",2018,0,35,0,35
"49102",2019,0,22,34,56
"49102",2020,0,20,21,41
"49107",2015,0,0,13,13
"49107",2016,0,0,63,63
"49107",2017,0,277,63,340
"49107",2018,0,8,14,22
"49107",2019,0,0,7,7
"49107",2020,0,0,11,11
"49109",2013,0,0,15,15
"49109",2014,0,0,94,94
"49109",2015,0,28,14,42
"49109",2016,0,28,0,28
"49109",2017,0,54,0,54
"49109",2018,0,35,0,35
"49109",2019,0,22,34,56
"49109",2020,0,20,21,41
"49110",2015,0,0,40,40
"49110",2017,0,277,34,311
"49110",2018,0,93,28,121
"49110",2019,0,69,0,69
"49110",2020,0,80,11,91
"49112",2013,0,0,28,28
"49112",2015,0,28,48,76
"49112",2016,0,34,0,34
"49112",2017,0,173,14,187
"49112",2018,0,67,28,95
"49112",2019,0,88,34,122
"49112",2020,0,46,28,74
"49113",2013,0,0,28,28
"49113",2015,0,28,48,76
"49113",2016,0,34,0,34
"49113",2017,0,173,14,187
"49113",2018,0,67,28,95
"49113",2019,0,88,34,122
"49113",2020,0,46,28,74
"49114",2015,0,0,28,28
"49114",2017,0,0,148,148
"49114",2018,0,78,0,78
"49114",2019,0,55,61,116
"49114",2020,0,0,81,81
"49120",2013,0,0,29,29
"49120",2014,0,107,94,201
"49120",2015,0,47,7,54
"49120",2016,0,42,21,63
"49120",2017,0,90,15,105
"49120",2018,0,65,21,86
"49120",2019,0,22,7,29
"49120",2020,0,20,11,31
"49121",2013,0,0,15,15
"49121",2014,0,0,94,94
"49121",2015,0,42,14,56
"49121",2016,0,28,0,28
"49121",2017,0,54,8,62
"49121",2018,0,28,0,28
"49121",2019,0,22,34,56
"49121",2020,0,20,21,41
"49123",2013,0,0,28,28
"49123",2015,0,28,48,76
"49123",2016,0,34,0,34
"49123",2017,0,173,14,187
"49123",2018,0,67,28,95
"49123",2019,0,88,34,122
"49123",2020,0,46,28,74
"49125",2013,0,0,15,15
"49125",2014,0,0,94,94
"49125",2015,0,42,7,49
"49125",2016,0,28,0,28
"49125",2017,0,54,8,62
"49125",2018,0,28,0,28
"49125",2019,0,22,0,22
"49125",2020,0,20,47,67
"49127",2015,0,0,40,40
"49127",2017,0,166,14,180
"49127",2018,0,116,28,144
"49127",2019,0,69,81,150
"49127",2020,0,82,115,197
"49129",2015,0,0,40,40
"49129",2016,0,0,21,21
"49129",2017,0,166,14,180
"49129",2018,0,116,28,144
"49129",2019,0,69,115,184
"49129",2020,0,82,115,197
"49130",2013,0,0,28,28
"49130",2015,0,42,8,50
"49130",2016,0,48,48,96
"49130",2017,0,49,7,56
"49130",2018,0,72,7,79
"49130",2019,0,42,70,112
"49130",2020,0,53,53,106
"49131",2013,0,0,28,28
"49131",2015,0,28,48,76
"49131",2016,0,34,0,34
"49131",2017,0,173,0,173
"49131",2018,0,67,0,67
"49131",2019,0,88,0,88
"49131",2020,0,46,18,64
"49132",2015,0,0,40,40
"49132",2016,0,0,21,21
"49132",2017,0,166,14,180
"49132",2018,0,116,28,144
"49132",2019,0,69,115,184
"49132",2020,0,82,115,197
"49135",2013,0,0,28,28
"49135",2015,0,42,8,50
"49135",2016,0,48,48,96
"49135",2017,0,49,7,56
"49135",2018,0,72,7,79
"49135",2019,0,42,70,112
"49135",2020,0,53,53,106
"49138",2015,0,0,13,13
"49138",2016,0,0,63,63
"49138",2017,0,277,63,340
"49138",2018,0,8,14,22
"49138",2019,0,0,7,7
"49138",2020,0,0,11,11
"49140",2013,0,0,28,28
"49140",2015,0,28,48,76
"49140",2016,0,34,0,34
"49140",2017,0,173,14,187
"49140",2018,0,67,28,95
"49140",2019,0,88,34,122
"49140",2020,0,46,41,87
"49155",2013,0,0,21,21
"49155",2014,0,0,101,101
"49155",2015,0,42,21,63
"49155",2016,0,48,21,69
"49155",2017,0,0,14,14
"49155",2018,0,21,7,28
"49155",2019,0,34,7,41
"49155",2020,0,53,53,106
"49160",2013,0,0,15,15
"49160",2014,0,107,81,188
"49160",2015,0,47,7,54
"49160",2016,0,42,21,63
"49160",2017,0,90,86,176
"49160",2018,0,65,14,79
"49160",2019,0,27,7,34
"49160",2020,0,60,0,60
"49161",2013,0,0,21,21
"49161",2014,0,0,101,101
"49161",2015,0,42,21,63
"49161",2016,0,48,21,69
"49161",2017,0,0,14,14
"49161",2018,0,21,7,28
"49161",2019,0,34,7,41
"49161",2020,0,53,53,106
"49163",2015,0,0,19,19
"49163",2016,0,0,63,63
"49163",2017,0,277,63,340
"49163",2018,0,93,14,107
"49163",2019,0,69,7,76
"49163",2020,0,80,11,91
"49167",2013,0,0,29,29
"49167",2014,0,0,94,94
"49167",2015,0,49,7,56
"49167",2016,0,34,21,55
"49167",2017,0,77,15,92
"49167",2018,0,36,21,57
"49167",2019,0,100,7,107
"49167",2020,0,62,11,73
"49170",2016,0,0,21,21
"49170",2017,0,166,6,172
"49170",2018,0,116,0,116
"49170",2019,0,69,122,191
"49170",2020,0,82,115,197
"49171",2015,0,0,21,21
"49171",2017,0,277,28,305
"49171",2018,0,86,0,86
"49171",2019,0,55,111,166
"49171",2020,0,0,58,58
"49174",2015,0,0,40,40
"49174",2017,0,166,14,180
"49174",2018,0,116,28,144
"49174",2019,0,69,81,150
"49174",2020,0,82,115,197
"49176",2013,0,0,21,21
"49176",2014,0,0,101,101
"49176",2015,0,42,21,63
"49176",2016,0,48,21,69
"49176",2017,0,0,14,14
"49176",2018,0,21,7,28
"49176",2019,0,34,7,41
"49176",2020,0,53,53,106
"49178",2013,0,0,7,7
"49178",2014,0,81,116,197
"49178",2015,0,34,7,41
"49178",2016,0,28,21,49
"49178",2017,0,0,14,14
"49178",2018,0,21,7,28
"49178",2019,0,0,7,7
"49178",2020,0,20,46,66
"49180",2015,0,21,28,49
"49180",2017,0,277,148,425
"49180",2018,0,86,0,86
"49180",2019,0,55,61,116
"49180",2020,0,49,81,130
"49182",2013,0,0,15,15
"49182",2014,0,0,94,94
"49182",2015,0,42,7,49
"49182",2016,0,28,0,28
"49182",2017,0,54,8,62
"49182",2018,0,28,0,28
"49182",2019,0,22,0,22
"49182",2020,0,20,21,41
"49183",2013,0,0,15,15
"49183",2014,0,107,81,188
"49183",2015,0,20,13,33
"49183",2016,0,35,84,119
"49183",2017,0,90,21,111
"49183",2018,0,65,0,65
"49183",2019,0,22,7,29
"49183",2020,0,20,0,20
"49188",2015,0,0,40,40
"49188",2017,0,277,34,311
"49188",2018,0,93,28,121
"49188",2019,0,69,0,69
"49188",2020,0,80,11,91
"49192",2013,0,0,21,21
"49192",2016,0,0,28,28
"49192",2017,0,75,48,123
"49192",2018,0,8,0,8
"49192",2019,0,19,122,141
"49192",2020,0,0,69,69
"49193",2013,0,0,7,7
"49193",2014,0,0,94,94
"49193",2015,0,0,27,27
"49193",2016,0,0,20,20
"49193",2017,0,75,50,125
"49193",2018,0,8,56,64
"49193",2019,0,19,27,46
"49193",2020,0,0,13,13
"49194",2015,0,21,13,34
"49194",2016,0,0,63,63
"49194",2017,0,277,63,340
"49194",2018,0,8,14,22
"49194",2019,0,12,7,19
"49194",2020,0,49,11,60
"49195",2013,0,0,7,7
"49195",2014,0,0,94,94
"49195",2015,0,0,27,27
"49195",2016,0,0,27,27
"49195",2017,0,75,48,123
"49195",2018,0,8,56,64
"49195",2019,0,19,27,46
"49195",2020,0,0,13,13
"49200",2014,0,107,81,188
"49200",2015,0,47,0,47
"49200",2016,0,42,14,56
"49200",2017,0,90,8,98
"49200",2018,0,65,0,65
"49200",2019,0,56,7,63
"49200",2020,0,29,0,29
"49201",2015,0,21,21,42
"49201",2017,0,55,28,83
"49201",2018,0,0,22,22
"49201",2019,0,93,13,106
"49201",2020,0,51,63,114
"49205",2016,0,0,21,21
"49205",2017,0,166,6,172
"49205",2018,0,116,0,116
"49205",2019,0,69,122,191
"49205",2020,0,82,115,197
"49209",2015,0,0,40,40
"49209",2017,0,166,14,180
"49209",2018,0,116,28,144
"49209",2019,0,69,81,150
"49209",2020,0,82,115,197
"49211",2013,0,0,15,15
"49211",2014,0,0,94,94
"49211",2015,0,28,14,42
"49211",2016,0,28,0,28
"49211",2017,0,54,0,54
"49211",2018,0,35,0,35
"49211",2019,0,22,34,56
"49211",2020,0,20,21,41
"49214",2014,0,107,81,188
"49214",2015,0,47,0,47
"49214",2016,0,42,14,56
"49214",2017,0,90,8,98
"49214",2018,0,65,0,65
"49214",2019,0,56,7,63
"49214",2020,0,29,53,82
"49215",2013,0,0,28,28
"49215",2015,0,28,48,76
"49215",2016,0,34,0,34
"49215",2017,0,173,0,173
"49215",2018,0,67,0,67
"49215",2019,0,88,0,88
"49215",2020,0,46,18,64
"49216",2015,0,0,40,40
"49216",2017,0,166,14,180
"49216",2018,0,116,28,144
"49216",2019,0,69,81,150
"49216",2020,0,82,115,197
"49217",2013,0,0,21,21
"49217",2014,0,0,101,101
"49217",2015,0,42,21,63
"49217",2016,0,48,21,69
"49217",2017,0,0,14,14
"49217",2018,0,21,7,28
"49217",2019,0,34,7,41
"49217",2020,0,53,53,106
"49218",2013,0,0,7,7
"49218",2014,0,0,109,109
"49218",2015,0,42,7,49
"49218",2016,0,28,0,28
"49218",2017,0,54,0,54
"49218",2018,0,35,0,35
"49218",2019,0,14,0,14
"49218",2020,0,20,0,20
"49219",2015,0,49,21,70
"49219",2016,0,34,0,34
"49219",2017,0,173,28,201
"49219",2018,0,67,22,89
"49219",2019,0,100,16,116
"49219",2020,0,62,63,125
"49220",2015,0,0,40,40
"49220",2016,0,0,21,21
"49220",2017,0,166,14,180
"49220",2018,0,116,28,144
"49220",2019,0,69,115,184
"49220",2020,0,82,115,197
"49221",2015,0,0,28,28
"49221",2017,0,277,148,425
"49221",2018,0,86,0,86
"49221",2019,0,55,125,180
"49221",2020,0,0,58,58
"49222",2013,0,0,29,29
"49222",2014,0,0,94,94
"49222",2015,0,42,7,49
"49222",2016,0,28,21,49
"49222",2017,0,54,15,69
"49222",2018,0,51,21,72
"49222",2019,0,22,7,29
"49222",2020,0,20,11,31
"49223",2013,0,0,29,29
"49223",2014,0,107,94,201
"49223",2015,0,47,7,54
"49223",2016,0,42,21,63
"49223",2017,0,90,15,105
"49223",2018,0,65,21,86
"49223",2019,0,114,7,121
"49223",2020,0,62,11,73
"49224",2015,0,21,28,49
"49224",2017,0,277,148,425
"49224",2018,0,86,0,86
"49224",2019,0,55,61,116
"49224",2020,0,49,81,130
"49228",2015,0,0,19,19
"49228",2016,0,0,63,63
"49228",2017,0,277,133,410
"49228",2018,0,86,14,100
"49228",2019,0,55,7,62
"49228",2020,0,80,11,91
"49231",2013,0,0,7,7
"49231",2014,0,0,94,94
"49231",2015,0,0,27,27
"49231",2016,0,0,27,27
"49231",2017,0,75,48,123
"49231",2018,0,8,56,64
"49231",2019,0,19,27,46
"49231",2020,0,0,13,13
"49235",2013,0,0,28,28
"49235",2015,0,49,48,97
"49235",2016,0,34,0,34
"49235",2017,0,173,14,187
"49235",2018,0,67,28,95
"49235",2019,0,100,34,134
"49235",2020,0,62,41,103
"49236",2013,0,0,15,15
"49236",2014,0,0,94,94
"49236",2015,0,28,14,42
"49236",2016,0,28,0,28
"49236",2017,0,54,0,54
"49236",2018,0,35,0,35
"49236",2019,0,22,34,56
"49236",2020,0,20,21,41
"49237",2015,0,0,22,22
"49237",2017,0,277,148,425
"49237",2018,0,86,0,86
"49237",2019,0,55,133,188
"49237",2020,0,0,58,58
"49240",2013,0,0,15,15
"49240",2014,0,0,94,94
"49240",2015,0,42,7,49
"49240",2016,0,28,0,28
"49240",2017,0,54,8,62
"49240",2018,0,51,0,51
"49240",2019,0,22,0,22
"49240",2020,0,20,47,67
"49241",2015,0,0,40,40
"49241",2016,0,0,21,21
"49241",2017,0,277,34,311
"49241",2018,0,93,28,121
"49241",2019,0,69,0,69
"49241",2020,0,80,11,91
"49244",2013,0,0,7,7
"49244",2014,0,0,109,109
"49244",2015,0,42,7,49
"49244",2016,0,28,0,28
"49244",2017,0,54,0,54
"49244",2018,0,35,0,35
"49244",2019,0,14,0,14
"49244",2020,0,20,0,20
"49246",2013,0,0,29,29
"49246",2014,0,0,94,94
"49246",2015,0,49,7,56
"49246",2016,0,34,21,55
"49246",2017,0,174,28,202
"49246",2018,0,36,22,58
"49246",2019,0,100,13,113
"49246",2020,0,60,63,123
"49247",2014,0,107,0,107
"49247",2015,0,47,21,68
"49247",2016,0,42,0,42
"49247",2017,0,90,28,118
"49247",2018,0,65,22,87
"49247",2019,0,27,0,27
"49247",2020,0,60,0,60
"49248",2013,0,0,21,21
"49248",2014,0,0,101,101
"49248",2015,0,0,21,21
"49248",2016,0,41,21,62
"49248",2017,0,0,14,14
"49248",2018,0,21,7,28
"49248",2019,0,68,7,75
"49248",2020,0,0,46,46
"49253",2013,0,0,50,50
"49253",2015,0,28,20,48
"49253",2016,0,34,7,41
"49253",2017,0,173,8,181
"49253",2018,0,67,0,67
"49253",2019,0,88,14,102
"49253",2020,0,46,50,96
"49257",2015,0,0,40,40
"49257",2017,0,166,14,180
"49257",2018,0,116,28,144
"49257",2019,0,69,81,150
"49257",2020,0,82,115,197
"49259",2013,0,0,15,15
"49259",2014,0,107,94,201
"49259",2015,0,47,14,61
"49259",2016,0,42,0,42
"49259",2017,0,90,0,90
"49259",2018,0,65,0,65
"49259",2019,0,14,34,48
"49259",2020,0,20,21,41
"49260",2013,0,0,21,21
"49260",2016,0,0,42,42
"49260",2017,0,75,41,116
"49260",2018,0,8,22,30
"49260",2019,0,19,39,58
"49260",2020,0,0,7,7
"49261",2013,0,0,29,29
"49261",2014,0,0,94,94
"49261",2015,0,49,7,56
"49261",2016,0,34,21,55
"49261",2017,0,98,15,113
"49261",2018,0,36,21,57
"49261",2019,0,100,7,107
"49261",2020,0,60,18,78
"49262",2013,0,0,28,28
"49262",2015,0,28,48,76
"49262",2016,0,34,0,34
"49262",2017,0,173,14,187
"49262",2018,0,67,28,95
"49262",2019,0,88,34,122
"49262",2020,0,46,28,74
"49266",2013,0,0,15,15
"49266",2014,0,107,81,188
"49266",2015,0,47,7,54
"49266",2016,0,42,84,126
"49266",2017,0,90,86,176
"49266",2018,0,65,14,79
"49266",2019,0,26,7,33
"49266",2020,0,48,0,48
"49267",2014,0,107,0,107
"49267",2015,0,47,21,68
"49267",2016,0,42,21,63
"49267",2017,0,90,34,124
"49267",2018,0,49,22,71
"49267",2019,0,91,47,138
"49267",2020,0,48,95,143
"49269",2013,0,0,21,21
"49269",2016,0,0,42,42
"49269",2017,0,75,41,116
"49269",2018,0,8,22,30
"49269",2019,0,19,39,58
"49269",2020,0,0,7,7
"49271",2014,0,107,81,188
"49271",2015,0,47,0,47
"49271",2016,0,42,14,56
"49271",2017,0,69,8,77
"49271",2018,0,65,0,65
"49271",2019,0,56,7,63
"49271",2020,0,29,0,29
"49272",2015,0,21,21,42
"49272",2017,0,28,28,56
"49272",2018,0,0,22,22
"49272",2019,0,12,13,25
"49272",2020,0,51,63,114
"49278",2014,0,107,0,107
"49278",2015,0,47,21,68
"49278",2016,0,42,0,42
"49278",2017,0,90,28,118
"49278",2018,0,49,22,71
"49278",2019,0,26,13,39
"49278",2020,0,42,63,105
"49283",2014,0,107,0,107
"49283",2015,0,47,21,68
"49283",2016,0,42,0,42
"49283",2017,0,90,28,118
"49283",2018,0,65,22,87
"49283",2019,0,27,0,27
"49283",2020,0,60,0,60
"49284",2013,0,0,15,15
"49284",2014,0,107,81,188
"49284",2015,0,47,7,54
"49284",2016,0,42,84,126
"49284",2017,0,90,86,176
"49284",2018,0,65,14,79
"49284",2019,0,27,7,34
"49284",2020,0,60,0,60
"49288",2013,0,0,29,29
"49288",2014,0,107,94,201
"49288",2015,0,47,7,54
"49288",2016,0,42,21,63
"49288",2017,0,90,28,118
"49288",2018,0,65,22,87
"49288",2019,0,114,16,130
"49288",2020,0,48,63,111
"49291",2013,0,0,28,28
"49291",2015,0,28,48,76
"49291",2016,0,34,0,34
"49291",2017,0,173,0,173
"49291",2018,0,67,0,67
"49291",2019,0,88,0,88
"49291",2020,0,46,18,64
"49292",2013,0,0,15,15
"49292",2014,0,0,94,94
"49292",2015,0,28,14,42
"49292",2016,0,28,0,28
"49292",2017,0,54,8,62
"49292",2018,0,35,0,35
"49292",2019,0,22,34,56
"49292",2020,0,20,21,41
"49294",2014,0,107,81,188
"49294",2015,0,47,0,47
"49294",2016,0,42,14,56
"49294",2017,0,90,8,98
"49294",2018,0,65,0,65
"49294",2019,0,26,7,33
"49294",2020,0,48,0,48
"49298",2014,0,107,81,188
"49298",2015,0,47,0,47
"49298",2016,0,42,14,56
"49298",2017,0,90,8,98
"49298",2018,0,65,0,65
"49298",2019,0,26,7,33
"49298",2020,0,48,0,48
"49299",2013,0,0,7,7
"49299",2014,0,0,94,94
"49299",2015,0,0,27,27
"49299",2016,0,0,20,20
"49299",2017,0,75,50,125
"49299",2018,0,8,56,64
"49299",2019,0,19,27,46
"49299",2020,0,0,13,13
"49301",2013,0,0,7,7
"49301",2014,0,0,94,94
"49301",2015,0,0,27,27
"49301",2016,0,0,27,27
"49301",2017,0,75,41,116
"49301",2018,0,8,56,64
"49301",2019,0,19,48,67
"49302",2013,0,0,15,15
"49302",2014,0,0,94,94
"49302",2015,0,42,7,49
"49302",2016,0,28,0,28
"49302",2017,0,54,8,62
"49302",2018,0,51,0,51
"49302",2019,0,22,0,22
"49302",2020,0,20,47,67
"49306",2013,0,0,15,15
"49306",2014,0,107,81,188
"49306",2015,0,47,7,54
"49306",2016,0,42,84,126
"49306",2017,0,90,86,176
"49306",2018,0,65,14,79
"49306",2019,0,26,7,33
"49306",2020,0,48,0,48
"49307",2015,0,21,40,61
"49307",2017,0,174,34,208
"49307",2018,0,85,50,135
"49307",2019,0,111,0,111
"49307",2020,0,60,11,71
"49308",2013,0,0,29,29
"49308",2014,0,0,94,94
"49308",2015,0,28,7,35
"49308",2016,0,34,21,55
"49308",2017,0,173,15,188
"49308",2018,0,67,21,88
"49308",2019,0,88,7,95
"49308",2020,0,46,11,57
"49310",2013,0,0,15,15
"49310",2014,0,0,94,94
"49310",2015,0,42,7,49
"49310",2016,0,28,0,28
"49310",2017,0,54,8,62
"49310",2018,0,51,0,51
"49310",2019,0,22,0,22
"49310",2020,0,20,47,67
"49311",2015,0,0,22,22
"49311",2017,0,277,148,425
"49311",2018,0,86,0,86
"49311",2019,0,55,133,188
"49311",2020,0,0,58,58
"49323",2015,0,0,40,40
"49323",2016,0,0,21,21
"49323",2017,0,166,14,180
"49323",2018,0,116,28,144
"49323",2019,0,69,115,184
"49323",2020,0,82,115,197
"49326",2015,0,0,40,40
"49326",2017,0,277,34,311
"49326",2018,0,93,28,121
"49326",2019,0,69,0,69
"49326",2020,0,80,11,91
"49328",2013,0,0,28,28
"49328",2015,0,49,48,97
"49328",2016,0,34,0,34
"49328",2017,0,77,14,91
"49328",2018,0,36,28,64
"49328",2019,0,100,34,134
"49328",2020,0,62,41,103
"49329",2014,0,107,0,107
"49329",2015,0,47,21,68
"49329",2016,0,42,0,42
"49329",2017,0,90,28,118
"49329",2018,0,65,22,87
"49329",2019,0,26,0,26
"49329",2020,0,48,0,48
"49330",2013,0,0,28,28
"49330",2015,0,42,8,50
"49330",2016,0,48,48,96
"49330",2017,0,49,7,56
"49330",2018,0,72,7,79
"49330",2019,0,42,70,112
"49330",2020,0,53,53,106
"49331",2013,0,0,21,21
"49331",2014,0,0,101,101
"49331",2015,0,42,21,63
"49331",2016,0,48,21,69
"49331",2017,0,0,14,14
"49331",2018,0,21,7,28
"49331",2019,0,34,7,41
"49331",2020,0,53,53,106
"49332",2013,0,0,7,7
"49332",2014,0,0,94,94
"49332",2015,0,0,27,27
"49332",2016,0,0,27,27
"49332",2017,0,75,48,123
"49332",2018,0,8,56,64
"49332",2019,0,19,27,46
"49332",2020,0,0,13,13
"49333",2015,0,0,40,40
"49333",2017,0,166,14,180
"49333",2018,0,116,28,144
"49333",2019,0,69,81,150
"49333",2020,0,82,115,197
"49334",2015,0,0,13,13
"49334",2016,0,0,63,63
"49334",2017,0,277,63,340
"49334",2018,0,8,14,22
"49334",2019,0,0,7,7
"49334",2020,0,0,11,11
"49336",2013,0,0,15,15
"49336",2014,0,0,94,94
"49336",2015,0,42,7,49
"49336",2016,0,28,0,28
"49336",2017,0,54,8,62
"49336",2018,0,51,0,51
"49336",2019,0,22,0,22
"49336",2020,0,20,47,67
"49338",2013,0,0,29,29
"49338",2014,0,0,94,94
"49338",2015,0,42,7,49
"49338",2016,0,28,21,49
"49338",2017,0,54,15,69
"49338",2018,0,51,21,72
"49338",2019,0,22,7,29
"49338",2020,0,20,11,31
"49339",2013,0,0,28,28
"49339",2015,0,42,8,50
"49339",2016,0,48,48,96
"49339",2017,0,49,7,56
"49339",2018,0,72,7,79
"49339",2019,0,42,70,112
"49339",2020,0,53,53,106
"49341",2013,0,0,28,28
"49341",2015,0,49,48,97
"49341",2016,0,34,0,34
"49341",2017,0,173,14,187
"49341",2018,0,67,28,95
"49341",2019,0,100,34,134
"49341",2020,0,62,41,103
"49343",2013,0,0,21,21
"49343",2016,0,0,42,42
"49343",2017,0,75,41,116
"49343",2018,0,8,22,30
"49343",2019,0,19,39,58
"49343",2020,0,0,7,7
"49344",2013,0,0,28,28
"49344",2015,0,42,8,50
"49344",2016,0,48,48,96
"49344",2017,0,49,7,56
"49344",2018,0,58,7,65
"49344",2019,0,42,36,78
"49344",2020,0,53,53,106
"49345",2013,0,0,15,15
"49345",2014,0,0,94,94
"49345",2015,0,42,7,49
"49345",2016,0,28,0,28
"49345",2017,0,54,8,62
"49345",2018,0,51,0,51
"49345",2019,0,22,0,22
"49345",2020,0,20,21,41
"49347",2015,0,0,40,40
"49347",2016,0,0,21,21
"49347",2017,0,166,14,180
"49347",2018,0,116,28,144
"49347",2019,0,69,115,184
"49347",2020,0,82,115,197
"49352",2013,0,0,21,21
"49352",2016,0,0,28,28
"49352",2017,0,75,48,123
"49352",2018,0,8,0,8
"49352",2019,0,19,122,141
"49352",2020,0,0,69,69
"49353",2015,0,21,21,42
"49353",2017,0,277,28,305
"49353",2018,0,8,0,8
"49353",2019,0,12,13,25
"49353",2020,0,49,63,112
"49355",2013,0,0,7,7
"49355",2014,0,0,94,94
"49355",2015,0,28,27,55
"49355",2016,0,28,20,48
"49355",2017,0,54,50,104
"49355",2018,0,35,56,91
"49355",2019,0,22,14,36
"49355",2020,0,20,21,41
"49358",2013,0,0,28,28
"49358",2015,0,49,48,97
"49358",2016,0,34,0,34
"49358",2017,0,173,14,187
"49358",2018,0,67,28,95
"49358",2019,0,100,34,134
"49358",2020,0,62,41,103
"49359",2013,0,0,28,28
"49359",2015,0,28,48,76
"49359",2016,0,34,0,34
"49359",2017,0,173,14,187
"49359",2018,0,67,28,95
"49359",2019,0,88,34,122
"49359",2020,0,46,28,74
"49361",2015,0,49,21,70
"49361",2016,0,34,0,34
"49361",2017,0,173,28,201
"49361",2018,0,67,22,89
"49361",2019,0,100,13,113
"49361",2020,0,62,63,125
"49362",2013,0,0,28,28
"49362",2015,0,28,48,76
"49362",2016,0,34,0,34
"49362",2017,0,173,14,187
"49362",2018,0,67,28,95
"49362",2019,0,88,34,122
"49362",2020,0,46,28,74
"49364",2013,0,0,15,15
"49364",2014,0,0,94,94
"49364",2015,0,42,14,56
"49364",2016,0,28,0,28
"49364",2017,0,54,8,62
"49364",2018,0,51,0,51
"49364",2019,0,22,0,22
"49364",2020,0,20,47,67
"49367",2014,0,107,81,188
"49367",2015,0,20,0,20
"49367",2016,0,35,14,49
"49367",2017,0,0,8,8
"49367",2018,0,21,0,21
"49367",2019,0,0,7,7
"49367",2020,0,7,0,7
"49368",2015,0,0,28,28
"49368",2017,0,277,148,425
"49368",2018,0,86,0,86
"49368",2019,0,55,61,116
"49368",2020,0,0,81,81
"49369",2015,0,0,28,28
"49369",2017,0,277,148,425
"49369",2018,0,86,0,86
"49369",2019,0,55,61,116
"49369",2020,0,0,81,81
"49370",2013,0,0,28,28
"49370",2015,0,28,48,76
"49370",2016,0,34,0,34
"49370",2017,0,77,14,91
"49370",2018,0,36,28,64
"49370",2019,0,88,34,122
"49370",2020,0,46,41,87
"49371",2013,0,0,7,7
"49371",2014,0,0,94,94
"49371",2015,0,28,14,42
"49371",2016,0,28,0,28
"49371",2017,0,54,0,54
"49371",2018,0,35,0,35
"49371",2019,0,22,34,56
"49371",2020,0,20,21,41
"49373",2013,0,0,15,15
"49373",2014,0,0,94,94
"49373",2015,0,42,7,49
"49373",2016,0,28,0,28
"49373",2017,0,54,8,62
"49373",2018,0,51,0,51
"49373",2019,0,22,0,22
"49373",2020,0,20,47,67
"49374",2015,0,21,21,42
"49374",2017,0,28,28,56
"49374",2018,0,0,22,22
"49374",2019,0,12,13,25
"49374",2020,0,51,63,114
"49377",2015,0,0,40,40
"49377",2017,0,166,14,180
"49377",2018,0,116,28,144
"49377",2019,0,69,81,150
"49377",2020,0,82,115,197
"49378",2015,0,21,28,49
"49378",2017,0,277,148,425
"49378",2018,0,86,0,86
"49378",2019,0,55,61,116
"49378",2020,0,49,81,130
"49381",2013,0,0,50,50
"49381",2015,0,28,20,48
"49381",2016,0,34,7,41
"49381",2017,0,173,14,187
"49381",2018,0,67,0,67
"49381",2019,0,88,14,102
"49381",2020,0,46,50,96
"50002",2017,0,133,0,133
"50002",2018,0,92,92,184
"50002",2020,0,0,79,79
"50003",2017,0,133,0,133
"50003",2018,0,92,92,184
"50003",2020,0,0,79,79
"50004",2017,0,133,0,133
"50004",2018,0,92,92,184
"50004",2020,0,0,79,79
"50006",2017,0,133,0,133
"50006",2018,0,92,92,184
"50006",2020,0,0,79,79
"50008",2017,0,133,0,133
"50008",2018,0,92,92,184
"50008",2020,0,0,79,79
"50013",2017,0,133,0,133
"50013",2018,0,92,92,184
"50013",2020,0,0,79,79
"50016",2017,0,133,0,133
"50016",2018,0,92,92,184
"50016",2020,0,0,79,79
"50019",2017,0,133,0,133
"50019",2018,0,92,92,184
"50019",2020,0,0,79,79
"50021",2017,0,133,0,133
"50021",2018,0,92,92,184
"50021",2020,0,0,79,79
"50022",2017,0,133,0,133
"50022",2018,0,92,92,184
"50022",2020,0,0,79,79
"50023",2017,0,133,0,133
"50023",2018,0,92,92,184
"50023",2020,0,0,79,79
"50024",2017,0,133,0,133
"50024",2018,0,92,92,184
"50024",2020,0,0,79,79
"50025",2017,0,133,0,133
"50025",2018,0,92,92,184
"50025",2020,0,0,79,79
"50026",2017,0,133,0,133
"50026",2018,0,92,92,184
"50026",2020,0,0,79,79
"50027",2017,0,133,0,133
"50027",2018,0,92,92,184
"50027",2020,0,0,79,79
"50028",2017,0,133,0,133
"50028",2018,0,92,92,184
"50028",2020,0,0,79,79
"50029",2017,0,133,0,133
"50029",2018,0,92,92,184
"50029",2020,0,0,79,79
"50030",2017,0,133,0,133
"50030",2018,0,92,92,184
"50030",2020,0,0,79,79
"50031",2017,0,133,0,133
"50031",2018,0,92,92,184
"50031",2020,0,0,79,79
"50032",2017,0,133,0,133
"50032",2018,0,92,92,184
"50032",2020,0,0,79,79
"50033",2017,0,133,0,133
"50033",2018,0,92,92,184
"50033",2020,0,0,79,79
"50034",2017,0,133,0,133
"50034",2018,0,92,92,184
"50034",2020,0,0,79,79
"50036",2017,0,133,0,133
"50036",2018,0,92,92,184
"50036",2020,0,0,79,79
"50038",2017,0,133,0,133
"50038",2018,0,92,92,184
"50038",2020,0,0,79,79
"50039",2017,0,133,0,133
"50039",2018,0,92,92,184
"50039",2020,0,0,79,79
"50040",2017,0,133,0,133
"50040",2018,0,92,92,184
"50040",2020,0,0,79,79
"50041",2017,0,133,0,133
"50041",2018,0,92,92,184
"50041",2020,0,0,79,79
"50042",2017,0,133,0,133
"50042",2018,0,92,92,184
"50042",2020,0,0,79,79
"50044",2017,0,133,0,133
"50044",2018,0,92,92,184
"50044",2020,0,0,79,79
"50045",2017,0,133,0,133
"50045",2018,0,92,92,184
"50045",2020,0,0,79,79
"50046",2017,0,133,0,133
"50046",2018,0,92,92,184
"50046",2020,0,0,79,79
"50048",2017,0,133,0,133
"50048",2018,0,92,92,184
"50048",2020,0,0,79,79
"50049",2017,0,133,0,133
"50049",2018,0,92,92,184
"50049",2020,0,0,79,79
"50050",2017,0,133,0,133
"50050",2018,0,92,92,184
"50050",2020,0,0,79,79
"50052",2017,0,133,0,133
"50052",2018,0,92,92,184
"50052",2020,0,0,79,79
"50054",2017,0,133,0,133
"50054",2018,0,92,92,184
"50054",2020,0,0,79,79
"50055",2017,0,133,0,133
"50055",2018,0,92,92,184
"50055",2020,0,0,79,79
"50058",2017,0,133,0,133
"50058",2018,0,92,92,184
"50058",2020,0,0,79,79
"50059",2017,0,133,0,133
"50059",2018,0,92,92,184
"50059",2020,0,0,79,79
"50060",2017,0,133,0,133
"50060",2018,0,92,92,184
"50060",2020,0,0,79,79
"50062",2017,0,133,0,133
"50062",2018,0,92,92,184
"50062",2020,0,0,79,79
"50064",2017,0,133,0,133
"50064",2018,0,92,92,184
"50064",2020,0,0,79,79
"50066",2017,0,133,0,133
"50066",2018,0,92,92,184
"50066",2020,0,0,79,79
"50069",2017,0,133,0,133
"50069",2018,0,92,92,184
"50069",2020,0,0,79,79
"50070",2017,0,133,0,133
"50070",2018,0,92,92,184
"50070",2020,0,0,79,79
"50072",2017,0,133,0,133
"50072",2018,0,92,92,184
"50072",2020,0,0,79,79
"50074",2017,0,133,0,133
"50074",2018,0,92,92,184
"50074",2020,0,0,79,79
"50076",2017,0,133,0,133
"50076",2018,0,92,92,184
"50076",2020,0,0,79,79
"50077",2017,0,133,0,133
"50077",2018,0,92,92,184
"50077",2020,0,0,79,79
"50078",2017,0,133,0,133
"50078",2018,0,92,92,184
"50078",2020,0,0,79,79
"50079",2017,0,133,0,133
"50079",2018,0,92,92,184
"50079",2020,0,0,79,79
"50081",2017,0,133,0,133
"50081",2018,0,92,92,184
"50081",2020,0,0,79,79
"50082",2017,0,133,0,133
"50082",2018,0,92,92,184
"50082",2020,0,0,79,79
"50083",2017,0,133,0,133
"50083",2018,0,92,92,184
"50083",2020,0,0,79,79
"50084",2017,0,133,0,133
"50084",2018,0,92,92,184
"50084",2020,0,0,79,79
"50085",2017,0,133,0,133
"50085",2018,0,92,92,184
"50085",2020,0,0,79,79
"50086",2017,0,133,0,133
"50086",2018,0,92,92,184
"50086",2020,0,0,79,79
"50087",2017,0,133,0,133
"50087",2018,0,92,92,184
"50087",2020,0,0,79,79
"50088",2017,0,133,0,133
"50088",2018,0,92,92,184
"50088",2020,0,0,79,79
"50090",2017,0,133,0,133
"50090",2018,0,92,92,184
"50090",2020,0,0,79,79
"50092",2017,0,133,0,133
"50092",2018,0,92,92,184
"50092",2020,0,0,79,79
"50093",2017,0,133,0,133
"50093",2018,0,92,92,184
"50093",2020,0,0,79,79
"50094",2017,0,133,0,133
"50094",2018,0,92,92,184
"50094",2020,0,0,79,79
"50095",2017,0,133,0,133
"50095",2018,0,92,92,184
"50095",2020,0,0,79,79
"50096",2017,0,133,0,133
"50096",2018,0,92,92,184
"50096",2020,0,0,79,79
"50097",2017,0,133,0,133
"50097",2018,0,92,92,184
"50097",2020,0,0,79,79
"50098",2017,0,133,0,133
"50098",2018,0,92,92,184
"50098",2020,0,0,79,79
"50099",2017,0,133,0,133
"50099",2018,0,92,92,184
"50099",2020,0,0,79,79
"50101",2017,0,133,0,133
"50101",2018,0,92,92,184
"50101",2020,0,0,79,79
"50102",2017,0,133,0,133
"50102",2018,0,92,92,184
"50102",2020,0,0,79,79
"50105",2017,0,133,0,133
"50105",2018,0,92,92,184
"50105",2020,0,0,79,79
"50106",2017,0,133,0,133
"50106",2018,0,92,92,184
"50106",2020,0,0,79,79
"50108",2017,0,133,0,133
"50108",2018,0,92,92,184
"50108",2020,0,0,79,79
"50109",2017,0,133,0,133
"50109",2018,0,92,92,184
"50109",2020,0,0,79,79
"50110",2017,0,133,0,133
"50110",2018,0,92,92,184
"50110",2020,0,0,79,79
"50111",2017,0,133,0,133
"50111",2018,0,92,92,184
"50111",2020,0,0,79,79
"50112",2017,0,133,0,133
"50112",2018,0,92,92,184
"50112",2020,0,0,79,79
"50115",2017,0,133,0,133
"50115",2018,0,92,92,184
"50115",2020,0,0,79,79
"50117",2017,0,133,0,133
"50117",2018,0,92,92,184
"50117",2020,0,0,79,79
"50118",2017,0,133,0,133
"50118",2018,0,92,92,184
"50118",2020,0,0,79,79
"50120",2017,0,133,0,133
"50120",2018,0,92,92,184
"50120",2020,0,0,79,79
"50121",2017,0,133,0,133
"50121",2018,0,92,92,184
"50121",2020,0,0,79,79
"50124",2017,0,133,0,133
"50124",2018,0,92,92,184
"50124",2020,0,0,79,79
"50126",2017,0,133,0,133
"50126",2018,0,92,92,184
"50126",2020,0,0,79,79
"50129",2017,0,133,0,133
"50129",2018,0,92,92,184
"50129",2020,0,0,79,79
"50130",2017,0,133,0,133
"50130",2018,0,92,92,184
"50130",2020,0,0,79,79
"50135",2017,0,133,0,133
"50135",2018,0,92,92,184
"50135",2020,0,0,79,79
"50137",2017,0,133,0,133
"50137",2018,0,92,92,184
"50137",2020,0,0,79,79
"50138",2017,0,133,0,133
"50138",2018,0,92,92,184
"50138",2020,0,0,79,79
"50139",2017,0,133,0,133
"50139",2018,0,92,92,184
"50139",2020,0,0,79,79
"50142",2017,0,133,0,133
"50142",2018,0,92,92,184
"50142",2020,0,0,79,79
"50143",2017,0,133,0,133
"50143",2018,0,92,92,184
"50143",2020,0,0,79,79
"50144",2017,0,133,0,133
"50144",2018,0,92,92,184
"50144",2020,0,0,79,79
"50145",2017,0,133,0,133
"50145",2018,0,92,92,184
"50145",2020,0,0,79,79
"50146",2017,0,133,0,133
"50146",2018,0,92,92,184
"50146",2020,0,0,79,79
"50147",2017,0,133,0,133
"50147",2018,0,92,92,184
"50147",2020,0,0,79,79
"50148",2017,0,133,0,133
"50148",2018,0,92,92,184
"50148",2020,0,0,79,79
"50149",2017,0,133,0,133
"50149",2018,0,92,92,184
"50149",2020,0,0,79,79
"50150",2017,0,133,0,133
"50150",2018,0,92,92,184
"50150",2020,0,0,79,79
"50151",2017,0,133,0,133
"50151",2018,0,92,92,184
"50151",2020,0,0,79,79
"50152",2017,0,133,0,133
"50152",2018,0,92,92,184
"50152",2020,0,0,79,79
"50155",2017,0,133,0,133
"50155",2018,0,92,92,184
"50155",2020,0,0,79,79
"50156",2017,0,133,0,133
"50156",2018,0,92,92,184
"50156",2020,0,0,79,79
"50158",2017,0,133,0,133
"50158",2018,0,92,92,184
"50158",2020,0,0,79,79
"50159",2017,0,133,0,133
"50159",2018,0,92,92,184
"50159",2020,0,0,79,79
"50161",2017,0,133,0,133
"50161",2018,0,92,92,184
"50161",2020,0,0,79,79
"50162",2017,0,133,0,133
"50162",2018,0,92,92,184
"50162",2020,0,0,79,79
"50164",2017,0,133,0,133
"50164",2018,0,92,92,184
"50164",2020,0,0,79,79
"50165",2017,0,133,0,133
"50165",2018,0,92,92,184
"50165",2020,0,0,79,79
"50166",2017,0,133,0,133
"50166",2018,0,92,92,184
"50166",2020,0,0,79,79
"50167",2017,0,133,0,133
"50167",2018,0,92,92,184
"50167",2020,0,0,79,79
"50168",2017,0,133,0,133
"50168",2018,0,92,92,184
"50168",2020,0,0,79,79
"50169",2017,0,133,0,133
"50169",2018,0,92,92,184
"50169",2020,0,0,79,79
"50172",2017,0,133,0,133
"50172",2018,0,92,92,184
"50172",2020,0,0,79,79
"50174",2017,0,133,0,133
"50174",2018,0,92,92,184
"50174",2020,0,0,79,79
"50175",2017,0,133,0,133
"50175",2018,0,92,92,184
"50175",2020,0,0,79,79
"50176",2017,0,133,0,133
"50176",2018,0,92,92,184
"50176",2020,0,0,79,79
"50177",2017,0,133,0,133
"50177",2018,0,92,92,184
"50177",2020,0,0,79,79
"50178",2017,0,133,0,133
"50178",2018,0,92,92,184
"50178",2020,0,0,79,79
"50181",2017,0,133,0,133
"50181",2018,0,92,92,184
"50181",2020,0,0,79,79
"50182",2017,0,133,0,133
"50182",2018,0,92,92,184
"50182",2020,0,0,79,79
"50183",2017,0,133,0,133
"50183",2018,0,92,92,184
"50183",2020,0,0,79,79
"50184",2017,0,133,0,133
"50184",2018,0,92,92,184
"50184",2020,0,0,79,79
"50185",2017,0,133,0,133
"50185",2018,0,92,92,184
"50185",2020,0,0,79,79
"50186",2017,0,133,0,133
"50186",2018,0,92,92,184
"50186",2020,0,0,79,79
"50188",2017,0,133,0,133
"50188",2018,0,92,92,184
"50188",2020,0,0,79,79
"50190",2017,0,133,0,133
"50190",2018,0,92,92,184
"50190",2020,0,0,79,79
"50192",2017,0,133,0,133
"50192",2018,0,92,92,184
"50192",2020,0,0,79,79
"50193",2017,0,133,0,133
"50193",2018,0,92,92,184
"50193",2020,0,0,79,79
"50194",2017,0,133,0,133
"50194",2018,0,92,92,184
"50194",2020,0,0,79,79
"50195",2017,0,133,0,133
"50195",2018,0,92,92,184
"50195",2020,0,0,79,79
"50196",2017,0,133,0,133
"50196",2018,0,92,92,184
"50196",2020,0,0,79,79
"50197",2017,0,133,0,133
"50197",2018,0,92,92,184
"50197",2020,0,0,79,79
"50198",2017,0,133,0,133
"50198",2018,0,92,92,184
"50198",2020,0,0,79,79
"50199",2017,0,133,0,133
"50199",2018,0,92,92,184
"50199",2020,0,0,79,79
"50200",2017,0,133,0,133
"50200",2018,0,92,92,184
"50200",2020,0,0,79,79
"50205",2017,0,133,0,133
"50205",2018,0,92,92,184
"50205",2020,0,0,79,79
"50207",2017,0,133,0,133
"50207",2018,0,92,92,184
"50207",2020,0,0,79,79
"50208",2017,0,133,0,133
"50208",2018,0,92,92,184
"50208",2020,0,0,79,79
"50209",2017,0,133,0,133
"50209",2018,0,92,92,184
"50209",2020,0,0,79,79
"50210",2017,0,133,0,133
"50210",2018,0,92,92,184
"50210",2020,0,0,79,79
"50214",2017,0,133,0,133
"50214",2018,0,92,92,184
"50214",2020,0,0,79,79
"50215",2017,0,133,0,133
"50215",2018,0,92,92,184
"50215",2020,0,0,79,79
"50216",2017,0,133,0,133
"50216",2018,0,92,92,184
"50216",2020,0,0,79,79
"50217",2017,0,133,0,133
"50217",2018,0,92,92,184
"50217",2020,0,0,79,79
"50218",2017,0,133,0,133
"50218",2018,0,92,92,184
"50218",2020,0,0,79,79
"50219",2017,0,133,0,133
"50219",2018,0,92,92,184
"50219",2020,0,0,79,79
"50221",2017,0,133,0,133
"50221",2018,0,92,92,184
"50221",2020,0,0,79,79
"50222",2017,0,133,0,133
"50222",2018,0,92,92,184
"50222",2020,0,0,79,79
"50225",2017,0,133,0,133
"50225",2018,0,92,92,184
"50225",2020,0,0,79,79
"50227",2017,0,133,0,133
"50227",2018,0,92,92,184
"50227",2020,0,0,79,79
"50228",2017,0,133,0,133
"50228",2018,0,92,92,184
"50228",2020,0,0,79,79
"50229",2017,0,133,0,133
"50229",2018,0,92,92,184
"50229",2020,0,0,79,79
"50230",2017,0,133,0,133
"50230",2018,0,92,92,184
"50230",2020,0,0,79,79
"50231",2017,0,133,0,133
"50231",2018,0,92,92,184
"50231",2020,0,0,79,79
"50232",2017,0,133,0,133
"50232",2018,0,92,92,184
"50232",2020,0,0,79,79
"50233",2017,0,133,0,133
"50233",2018,0,92,92,184
"50233",2020,0,0,79,79
"50234",2017,0,133,0,133
"50234",2018,0,92,92,184
"50234",2020,0,0,79,79
"50235",2017,0,133,0,133
"50235",2018,0,92,92,184
"50235",2020,0,0,79,79
"50236",2017,0,133,0,133
"50236",2018,0,92,92,184
"50236",2020,0,0,79,79
"50237",2017,0,133,0,133
"50237",2018,0,92,92,184
"50237",2020,0,0,79,79
"50238",2017,0,133,0,133
"50238",2018,0,92,92,184
"50238",2020,0,0,79,79
"50239",2017,0,133,0,133
"50239",2018,0,92,92,184
"50239",2020,0,0,79,79
"50240",2017,0,133,0,133
"50240",2018,0,92,92,184
"50240",2020,0,0,79,79
"50241",2017,0,133,0,133
"50241",2018,0,92,92,184
"50241",2020,0,0,79,79
"50243",2017,0,133,0,133
"50243",2018,0,92,92,184
"50243",2020,0,0,79,79
"50246",2017,0,133,0,133
"50246",2018,0,92,92,184
"50246",2020,0,0,79,79
"50247",2017,0,133,0,133
"50247",2018,0,92,92,184
"50247",2020,0,0,79,79
"50251",2017,0,133,0,133
"50251",2018,0,92,92,184
"50251",2020,0,0,79,79
"50252",2017,0,133,0,133
"50252",2018,0,92,92,184
"50252",2020,0,0,79,79
"50253",2017,0,133,0,133
"50253",2018,0,92,92,184
"50253",2020,0,0,79,79
"50256",2017,0,133,0,133
"50256",2018,0,92,92,184
"50256",2020,0,0,79,79
"50258",2017,0,133,0,133
"50258",2018,0,92,92,184
"50258",2020,0,0,79,79
"50259",2017,0,133,0,133
"50259",2018,0,92,92,184
"50259",2020,0,0,79,79
"50260",2017,0,133,0,133
"50260",2018,0,92,92,184
"50260",2020,0,0,79,79
"50261",2017,0,133,0,133
"50261",2018,0,92,92,184
"50261",2020,0,0,79,79
"50262",2017,0,133,0,133
"50262",2018,0,92,92,184
"50262",2020,0,0,79,79
"50263",2017,0,133,0,133
"50263",2018,0,92,92,184
"50263",2020,0,0,79,79
"50265",2017,0,133,0,133
"50265",2018,0,92,92,184
"50265",2020,0,0,79,79
"50266",2017,0,133,0,133
"50266",2018,0,92,92,184
"50266",2020,0,0,79,79
"50267",2017,0,133,0,133
"50267",2018,0,92,92,184
"50267",2020,0,0,79,79
"50268",2017,0,133,0,133
"50268",2018,0,92,92,184
"50268",2020,0,0,79,79
"50269",2017,0,133,0,133
"50269",2018,0,92,92,184
"50269",2020,0,0,79,79
"50270",2017,0,133,0,133
"50270",2018,0,92,92,184
"50270",2020,0,0,79,79
"50271",2017,0,133,0,133
"50271",2018,0,92,92,184
"50271",2020,0,0,79,79
"50272",2017,0,133,0,133
"50272",2018,0,92,92,184
"50272",2020,0,0,79,79
"50273",2017,0,133,0,133
"50273",2018,0,92,92,184
"50273",2020,0,0,79,79
"50274",2017,0,133,0,133
"50274",2018,0,92,92,184
"50274",2020,0,0,79,79
"50275",2017,0,133,0,133
"50275",2018,0,92,92,184
"50275",2020,0,0,79,79
"50276",2017,0,133,0,133
"50276",2018,0,92,92,184
"50276",2020,0,0,79,79
"50277",2017,0,133,0,133
"50277",2018,0,92,92,184
"50277",2020,0,0,79,79
"50278",2017,0,133,0,133
"50278",2018,0,92,92,184
"50278",2020,0,0,79,79
"50279",2017,0,133,0,133
"50279",2018,0,92,92,184
"50279",2020,0,0,79,79
"50281",2017,0,133,0,133
"50281",2018,0,92,92,184
"50281",2020,0,0,79,79
"50282",2017,0,133,0,133
"50282",2018,0,92,92,184
"50282",2020,0,0,79,79
"50283",2017,0,133,0,133
"50283",2018,0,92,92,184
"50283",2020,0,0,79,79
"50285",2017,0,133,0,133
"50285",2018,0,92,92,184
"50285",2020,0,0,79,79
"50288",2017,0,133,0,133
"50288",2018,0,92,92,184
"50288",2020,0,0,79,79
"50289",2017,0,133,0,133
"50289",2018,0,92,92,184
"50289",2020,0,0,79,79
"50290",2017,0,133,0,133
"50290",2018,0,92,92,184
"50290",2020,0,0,79,79
"50291",2017,0,133,0,133
"50291",2018,0,92,92,184
"50291",2020,0,0,79,79
"50292",2017,0,133,0,133
"50292",2018,0,92,92,184
"50292",2020,0,0,79,79
"50294",2017,0,133,0,133
"50294",2018,0,92,92,184
"50294",2020,0,0,79,79
"50295",2017,0,133,0,133
"50295",2018,0,92,92,184
"50295",2020,0,0,79,79
"50296",2017,0,133,0,133
"50296",2018,0,92,92,184
"50296",2020,0,0,79,79
"50297",2017,0,133,0,133
"50297",2018,0,92,92,184
"50297",2020,0,0,79,79
"50298",2017,0,133,0,133
"50298",2018,0,92,92,184
"50298",2020,0,0,79,79
"50299",2017,0,133,0,133
"50299",2018,0,92,92,184
"50299",2020,0,0,79,79
"50300",2017,0,133,0,133
"50300",2018,0,92,92,184
"50300",2020,0,0,79,79
"50302",2017,0,133,0,133
"50302",2018,0,92,92,184
"50302",2020,0,0,79,79
"50304",2017,0,133,0,133
"50304",2018,0,92,92,184
"50304",2020,0,0,79,79
"50305",2017,0,133,0,133
"50305",2018,0,92,92,184
"50305",2020,0,0,79,79
"50310",2017,0,133,0,133
"50310",2018,0,92,92,184
"50310",2020,0,0,79,79
"50311",2017,0,133,0,133
"50311",2018,0,92,92,184
"50311",2020,0,0,79,79
"50312",2017,0,133,0,133
"50312",2018,0,92,92,184
"50312",2020,0,0,79,79
"50315",2017,0,133,0,133
"50315",2018,0,92,92,184
"50315",2020,0,0,79,79
"50317",2017,0,133,0,133
"50317",2018,0,92,92,184
"50317",2020,0,0,79,79
"50321",2017,0,133,0,133
"50321",2018,0,92,92,184
"50321",2020,0,0,79,79
"50324",2017,0,133,0,133
"50324",2018,0,92,92,184
"50324",2020,0,0,79,79
"50326",2017,0,133,0,133
"50326",2018,0,92,92,184
"50326",2020,0,0,79,79
"50327",2017,0,133,0,133
"50327",2018,0,92,92,184
"50327",2020,0,0,79,79
"50328",2017,0,133,0,133
"50328",2018,0,92,92,184
"50328",2020,0,0,79,79
"50332",2017,0,133,0,133
"50332",2018,0,92,92,184
"50332",2020,0,0,79,79
"50334",2017,0,133,0,133
"50334",2018,0,92,92,184
"50334",2020,0,0,79,79
"50335",2017,0,133,0,133
"50335",2018,0,92,92,184
"50335",2020,0,0,79,79
"50336",2017,0,133,0,133
"50336",2018,0,92,92,184
"50336",2020,0,0,79,79
"50338",2017,0,133,0,133
"50338",2018,0,92,92,184
"50338",2020,0,0,79,79
"50340",2017,0,133,0,133
"50340",2018,0,92,92,184
"50340",2020,0,0,79,79
"50341",2017,0,133,0,133
"50341",2018,0,92,92,184
"50341",2020,0,0,79,79
"50342",2017,0,133,0,133
"50342",2018,0,92,92,184
"50342",2020,0,0,79,79
"50345",2017,0,133,0,133
"50345",2018,0,92,92,184
"50345",2020,0,0,79,79
"50347",2017,0,133,0,133
"50347",2018,0,92,92,184
"50347",2020,0,0,79,79
"50349",2017,0,133,0,133
"50349",2018,0,92,92,184
"50349",2020,0,0,79,79
"50350",2017,0,133,0,133
"50350",2018,0,92,92,184
"50350",2020,0,0,79,79
"50351",2017,0,133,0,133
"50351",2018,0,92,92,184
"50351",2020,0,0,79,79
"50352",2017,0,133,0,133
"50352",2018,0,92,92,184
"50352",2020,0,0,79,79
"50353",2017,0,133,0,133
"50353",2018,0,92,92,184
"50353",2020,0,0,79,79
"50356",2017,0,133,0,133
"50356",2018,0,92,92,184
"50356",2020,0,0,79,79
"50357",2017,0,133,0,133
"50357",2018,0,92,92,184
"50357",2020,0,0,79,79
"50359",2017,0,133,0,133
"50359",2018,0,92,92,184
"50359",2020,0,0,79,79
"50360",2017,0,133,0,133
"50360",2018,0,92,92,184
"50360",2020,0,0,79,79
"50361",2017,0,133,0,133
"50361",2018,0,92,92,184
"50361",2020,0,0,79,79
"50362",2017,0,133,0,133
"50362",2018,0,92,92,184
"50362",2020,0,0,79,79
"50363",2017,0,133,0,133
"50363",2018,0,92,92,184
"50363",2020,0,0,79,79
"50364",2017,0,133,0,133
"50364",2018,0,92,92,184
"50364",2020,0,0,79,79
"50365",2017,0,133,0,133
"50365",2018,0,92,92,184
"50365",2020,0,0,79,79
"50368",2017,0,133,0,133
"50368",2018,0,92,92,184
"50368",2020,0,0,79,79
"50369",2017,0,133,0,133
"50369",2018,0,92,92,184
"50369",2020,0,0,79,79
"50370",2017,0,133,0,133
"50370",2018,0,92,92,184
"50370",2020,0,0,79,79
"50371",2017,0,133,0,133
"50371",2018,0,92,92,184
"50371",2020,0,0,79,79
"50372",2017,0,133,0,133
"50372",2018,0,92,92,184
"50372",2020,0,0,79,79
"50373",2017,0,133,0,133
"50373",2018,0,92,92,184
"50373",2020,0,0,79,79
"50374",2017,0,133,0,133
"50374",2018,0,92,92,184
"50374",2020,0,0,79,79
"50376",2017,0,133,0,133
"50376",2018,0,92,92,184
"50376",2020,0,0,79,79
"50378",2017,0,133,0,133
"50378",2018,0,92,92,184
"50378",2020,0,0,79,79
"50379",2017,0,133,0,133
"50379",2018,0,92,92,184
"50379",2020,0,0,79,79
"50382",2017,0,133,0,133
"50382",2018,0,92,92,184
"50382",2020,0,0,79,79
"50384",2017,0,133,0,133
"50384",2018,0,92,92,184
"50384",2020,0,0,79,79
"50387",2017,0,133,0,133
"50387",2018,0,92,92,184
"50387",2020,0,0,79,79
"50388",2017,0,133,0,133
"50388",2018,0,92,92,184
"50388",2020,0,0,79,79
"50389",2017,0,133,0,133
"50389",2018,0,92,92,184
"50389",2020,0,0,79,79
"50390",2017,0,133,0,133
"50390",2018,0,92,92,184
"50390",2020,0,0,79,79
"50391",2017,0,133,0,133
"50391",2018,0,92,92,184
"50391",2020,0,0,79,79
"50393",2017,0,133,0,133
"50393",2018,0,92,92,184
"50393",2020,0,0,79,79
"50394",2017,0,133,0,133
"50394",2018,0,92,92,184
"50394",2020,0,0,79,79
"50395",2017,0,133,0,133
"50395",2018,0,92,92,184
"50395",2020,0,0,79,79
"50397",2017,0,133,0,133
"50397",2018,0,92,92,184
"50397",2020,0,0,79,79
"50398",2017,0,133,0,133
"50398",2018,0,92,92,184
"50398",2020,0,0,79,79
"50399",2017,0,133,0,133
"50399",2018,0,92,92,184
"50399",2020,0,0,79,79
"50400",2017,0,133,0,133
"50400",2018,0,92,92,184
"50400",2020,0,0,79,79
"50401",2017,0,133,0,133
"50401",2018,0,92,92,184
"50401",2020,0,0,79,79
"50402",2017,0,133,0,133
"50402",2018,0,92,92,184
"50402",2020,0,0,79,79
"50403",2017,0,133,0,133
"50403",2018,0,92,92,184
"50403",2020,0,0,79,79
"50405",2017,0,133,0,133
"50405",2018,0,92,92,184
"50405",2020,0,0,79,79
"50407",2017,0,133,0,133
"50407",2018,0,92,92,184
"50407",2020,0,0,79,79
"50408",2017,0,133,0,133
"50408",2018,0,92,92,184
"50408",2020,0,0,79,79
"50409",2017,0,133,0,133
"50409",2018,0,92,92,184
"50409",2020,0,0,79,79
"50410",2017,0,133,0,133
"50410",2018,0,92,92,184
"50410",2020,0,0,79,79
"50411",2017,0,133,0,133
"50411",2018,0,92,92,184
"50411",2020,0,0,79,79
"50412",2017,0,133,0,133
"50412",2018,0,92,92,184
"50412",2020,0,0,79,79
"50413",2017,0,133,0,133
"50413",2018,0,92,92,184
"50413",2020,0,0,79,79
"50417",2017,0,133,0,133
"50417",2018,0,92,92,184
"50417",2020,0,0,79,79
"50419",2017,0,133,0,133
"50419",2018,0,92,92,184
"50419",2020,0,0,79,79
"50420",2017,0,133,0,133
"50420",2018,0,92,92,184
"50420",2020,0,0,79,79
"50421",2017,0,133,0,133
"50421",2018,0,92,92,184
"50421",2020,0,0,79,79
"50422",2017,0,133,0,133
"50422",2018,0,92,92,184
"50422",2020,0,0,79,79
"50423",2017,0,133,0,133
"50423",2018,0,92,92,184
"50423",2020,0,0,79,79
"50425",2017,0,133,0,133
"50425",2018,0,92,92,184
"50425",2020,0,0,79,79
"50426",2017,0,133,0,133
"50426",2018,0,92,92,184
"50426",2020,0,0,79,79
"50428",2017,0,133,0,133
"50428",2018,0,92,92,184
"50428",2020,0,0,79,79
"50429",2017,0,133,0,133
"50429",2018,0,92,92,184
"50429",2020,0,0,79,79
"50430",2017,0,133,0,133
"50430",2018,0,92,92,184
"50430",2020,0,0,79,79
"50431",2017,0,133,0,133
"50431",2018,0,92,92,184
"50431",2020,0,0,79,79
"50433",2017,0,133,0,133
"50433",2018,0,92,92,184
"50433",2020,0,0,79,79
"50435",2017,0,133,0,133
"50435",2018,0,92,92,184
"50435",2020,0,0,79,79
"50436",2017,0,133,0,133
"50436",2018,0,92,92,184
"50436",2020,0,0,79,79
"50437",2017,0,133,0,133
"50437",2018,0,92,92,184
"50437",2020,0,0,79,79
"50442",2017,0,133,0,133
"50442",2018,0,92,92,184
"50442",2020,0,0,79,79
"50443",2017,0,133,0,133
"50443",2018,0,92,92,184
"50443",2020,0,0,79,79
"50444",2017,0,133,0,133
"50444",2018,0,92,92,184
"50444",2020,0,0,79,79
"50445",2017,0,133,0,133
"50445",2018,0,92,92,184
"50445",2020,0,0,79,79
"50446",2017,0,133,0,133
"50446",2018,0,92,92,184
"50446",2020,0,0,79,79
"50447",2017,0,133,0,133
"50447",2018,0,92,92,184
"50447",2020,0,0,79,79
"50448",2017,0,133,0,133
"50448",2018,0,92,92,184
"50448",2020,0,0,79,79
"50450",2017,0,133,0,133
"50450",2018,0,92,92,184
"50450",2020,0,0,79,79
"50451",2017,0,133,0,133
"50451",2018,0,92,92,184
"50451",2020,0,0,79,79
"50452",2017,0,133,0,133
"50452",2018,0,92,92,184
"50452",2020,0,0,79,79
"50453",2017,0,133,0,133
"50453",2018,0,92,92,184
"50453",2020,0,0,79,79
"50454",2017,0,133,0,133
"50454",2018,0,92,92,184
"50454",2020,0,0,79,79
"50455",2017,0,133,0,133
"50455",2018,0,92,92,184
"50455",2020,0,0,79,79
"50456",2017,0,133,0,133
"50456",2018,0,92,92,184
"50456",2020,0,0,79,79
"50457",2017,0,133,0,133
"50457",2018,0,92,92,184
"50457",2020,0,0,79,79
"50461",2017,0,133,0,133
"50461",2018,0,92,92,184
"50461",2020,0,0,79,79
"50462",2017,0,133,0,133
"50462",2018,0,92,92,184
"50462",2020,0,0,79,79
"50463",2017,0,133,0,133
"50463",2018,0,92,92,184
"50463",2020,0,0,79,79
"50464",2017,0,133,0,133
"50464",2018,0,92,92,184
"50464",2020,0,0,79,79
"50467",2017,0,133,0,133
"50467",2018,0,92,92,184
"50467",2020,0,0,79,79
"50468",2017,0,133,0,133
"50468",2018,0,92,92,184
"50468",2020,0,0,79,79
"50469",2017,0,133,0,133
"50469",2018,0,92,92,184
"50469",2020,0,0,79,79
"50471",2017,0,133,0,133
"50471",2018,0,92,92,184
"50471",2020,0,0,79,79
"50472",2017,0,133,0,133
"50472",2018,0,92,92,184
"50472",2020,0,0,79,79
"50473",2017,0,133,0,133
"50473",2018,0,92,92,184
"50473",2020,0,0,79,79
"50474",2017,0,133,0,133
"50474",2018,0,92,92,184
"50474",2020,0,0,79,79
"50475",2017,0,133,0,133
"50475",2018,0,92,92,184
"50475",2020,0,0,79,79
"50476",2017,0,133,0,133
"50476",2018,0,92,92,184
"50476",2020,0,0,79,79
"50478",2017,0,133,0,133
"50478",2018,0,92,92,184
"50478",2020,0,0,79,79
"50479",2017,0,133,0,133
"50479",2018,0,92,92,184
"50479",2020,0,0,79,79
"50480",2017,0,133,0,133
"50480",2018,0,92,92,184
"50480",2020,0,0,79,79
"50481",2017,0,133,0,133
"50481",2018,0,92,92,184
"50481",2020,0,0,79,79
"50482",2017,0,133,0,133
"50482",2018,0,92,92,184
"50482",2020,0,0,79,79
"50483",2017,0,133,0,133
"50483",2018,0,92,92,184
"50483",2020,0,0,79,79
"50484",2017,0,133,0,133
"50484",2018,0,92,92,184
"50484",2020,0,0,79,79
"50486",2017,0,133,0,133
"50486",2018,0,92,92,184
"50486",2020,0,0,79,79
"50487",2017,0,133,0,133
"50487",2018,0,92,92,184
"50487",2020,0,0,79,79
"50488",2017,0,133,0,133
"50488",2018,0,92,92,184
"50488",2020,0,0,79,79
"50489",2017,0,133,0,133
"50489",2018,0,92,92,184
"50489",2020,0,0,79,79
"50490",2017,0,133,0,133
"50490",2018,0,92,92,184
"50490",2020,0,0,79,79
"50491",2017,0,133,0,133
"50491",2018,0,92,92,184
"50491",2020,0,0,79,79
"50492",2017,0,133,0,133
"50492",2018,0,92,92,184
"50492",2020,0,0,79,79
"50493",2017,0,133,0,133
"50493",2018,0,92,92,184
"50493",2020,0,0,79,79
"50495",2017,0,133,0,133
"50495",2018,0,92,92,184
"50495",2020,0,0,79,79
"50496",2017,0,133,0,133
"50496",2018,0,92,92,184
"50496",2020,0,0,79,79
"50498",2017,0,133,0,133
"50498",2018,0,92,92,184
"50498",2020,0,0,79,79
"50499",2017,0,133,0,133
"50499",2018,0,92,92,184
"50499",2020,0,0,79,79
"50500",2017,0,133,0,133
"50500",2018,0,92,92,184
"50500",2020,0,0,79,79
"50502",2017,0,133,0,133
"50502",2018,0,92,92,184
"50502",2020,0,0,79,79
"50504",2017,0,133,0,133
"50504",2018,0,92,92,184
"50504",2020,0,0,79,79
"50505",2017,0,133,0,133
"50505",2018,0,92,92,184
"50505",2020,0,0,79,79
"50506",2017,0,133,0,133
"50506",2018,0,92,92,184
"50506",2020,0,0,79,79
"50507",2017,0,133,0,133
"50507",2018,0,92,92,184
"50507",2020,0,0,79,79
"50509",2017,0,133,0,133
"50509",2018,0,92,92,184
"50509",2020,0,0,79,79
"50510",2017,0,133,0,133
"50510",2018,0,92,92,184
"50510",2020,0,0,79,79
"50511",2017,0,133,0,133
"50511",2018,0,92,92,184
"50511",2020,0,0,79,79
"50512",2017,0,133,0,133
"50512",2018,0,92,92,184
"50512",2020,0,0,79,79
"50513",2017,0,133,0,133
"50513",2018,0,92,92,184
"50513",2020,0,0,79,79
"50514",2017,0,133,0,133
"50514",2018,0,92,92,184
"50514",2020,0,0,79,79
"50517",2017,0,133,0,133
"50517",2018,0,92,92,184
"50517",2020,0,0,79,79
"50518",2017,0,133,0,133
"50518",2018,0,92,92,184
"50518",2020,0,0,79,79
"50519",2017,0,133,0,133
"50519",2018,0,92,92,184
"50519",2020,0,0,79,79
"50521",2017,0,133,0,133
"50521",2018,0,92,92,184
"50521",2020,0,0,79,79
"50522",2017,0,133,0,133
"50522",2018,0,92,92,184
"50522",2020,0,0,79,79
"50523",2017,0,133,0,133
"50523",2018,0,92,92,184
"50523",2020,0,0,79,79
"50525",2017,0,133,0,133
"50525",2018,0,92,92,184
"50525",2020,0,0,79,79
"50528",2017,0,133,0,133
"50528",2018,0,92,92,184
"50528",2020,0,0,79,79
"50529",2017,0,133,0,133
"50529",2018,0,92,92,184
"50529",2020,0,0,79,79
"50531",2017,0,133,0,133
"50531",2018,0,92,92,184
"50531",2020,0,0,79,79
"50532",2017,0,133,0,133
"50532",2018,0,92,92,184
"50532",2020,0,0,79,79
"50533",2017,0,133,0,133
"50533",2018,0,92,92,184
"50533",2020,0,0,79,79
"50535",2017,0,133,0,133
"50535",2018,0,92,92,184
"50535",2020,0,0,79,79
"50536",2017,0,133,0,133
"50536",2018,0,92,92,184
"50536",2020,0,0,79,79
"50537",2017,0,133,0,133
"50537",2018,0,92,92,184
"50537",2020,0,0,79,79
"50538",2017,0,133,0,133
"50538",2018,0,92,92,184
"50538",2020,0,0,79,79
"50539",2017,0,133,0,133
"50539",2018,0,92,92,184
"50539",2020,0,0,79,79
"50540",2017,0,133,0,133
"50540",2018,0,92,92,184
"50540",2020,0,0,79,79
"50541",2017,0,133,0,133
"50541",2018,0,92,92,184
"50541",2020,0,0,79,79
"50542",2017,0,133,0,133
"50542",2018,0,92,92,184
"50542",2020,0,0,79,79
"50543",2017,0,133,0,133
"50543",2018,0,92,92,184
"50543",2020,0,0,79,79
"50546",2017,0,133,0,133
"50546",2018,0,92,92,184
"50546",2020,0,0,79,79
"50548",2017,0,133,0,133
"50548",2018,0,92,92,184
"50548",2020,0,0,79,79
"50549",2017,0,133,0,133
"50549",2018,0,92,92,184
"50549",2020,0,0,79,79
"50550",2017,0,133,0,133
"50550",2018,0,92,92,184
"50550",2020,0,0,79,79
"50551",2017,0,133,0,133
"50551",2018,0,92,92,184
"50551",2020,0,0,79,79
"50552",2017,0,133,0,133
"50552",2018,0,92,92,184
"50552",2020,0,0,79,79
"50553",2017,0,133,0,133
"50553",2018,0,92,92,184
"50553",2020,0,0,79,79
"50554",2017,0,133,0,133
"50554",2018,0,92,92,184
"50554",2020,0,0,79,79
"50556",2017,0,133,0,133
"50556",2018,0,92,92,184
"50556",2020,0,0,79,79
"50562",2017,0,133,0,133
"50562",2018,0,92,92,184
"50562",2020,0,0,79,79
"50563",2017,0,133,0,133
"50563",2018,0,92,92,184
"50563",2020,0,0,79,79
"50564",2017,0,133,0,133
"50564",2018,0,92,92,184
"50564",2020,0,0,79,79
"50565",2017,0,133,0,133
"50565",2018,0,92,92,184
"50565",2020,0,0,79,79
"50567",2017,0,133,0,133
"50567",2018,0,92,92,184
"50567",2020,0,0,79,79
"50568",2017,0,133,0,133
"50568",2018,0,92,92,184
"50568",2020,0,0,79,79
"50569",2017,0,133,0,133
"50569",2018,0,92,92,184
"50569",2020,0,0,79,79
"50570",2017,0,133,0,133
"50570",2018,0,92,92,184
"50570",2020,0,0,79,79
"50571",2017,0,133,0,133
"50571",2018,0,92,92,184
"50571",2020,0,0,79,79
"50572",2017,0,133,0,133
"50572",2018,0,92,92,184
"50572",2020,0,0,79,79
"50574",2017,0,133,0,133
"50574",2018,0,92,92,184
"50574",2020,0,0,79,79
"50575",2017,0,133,0,133
"50575",2018,0,92,92,184
"50575",2020,0,0,79,79
"50576",2017,0,133,0,133
"50576",2018,0,92,92,184
"50576",2020,0,0,79,79
"50577",2017,0,133,0,133
"50577",2018,0,92,92,184
"50577",2020,0,0,79,79
"50578",2017,0,133,0,133
"50578",2018,0,92,92,184
"50578",2020,0,0,79,79
"50579",2017,0,133,0,133
"50579",2018,0,92,92,184
"50579",2020,0,0,79,79
"50580",2017,0,133,0,133
"50580",2018,0,92,92,184
"50580",2020,0,0,79,79
"50582",2017,0,133,0,133
"50582",2018,0,92,92,184
"50582",2020,0,0,79,79
"50584",2017,0,133,0,133
"50584",2018,0,92,92,184
"50584",2020,0,0,79,79
"50585",2017,0,133,0,133
"50585",2018,0,92,92,184
"50585",2020,0,0,79,79
"50587",2017,0,133,0,133
"50587",2018,0,92,92,184
"50587",2020,0,0,79,79
"50588",2017,0,133,0,133
"50588",2018,0,92,92,184
"50588",2020,0,0,79,79
"50589",2017,0,133,0,133
"50589",2018,0,92,92,184
"50589",2020,0,0,79,79
"50590",2017,0,133,0,133
"50590",2018,0,92,92,184
"50590",2020,0,0,79,79
"50591",2017,0,133,0,133
"50591",2018,0,92,92,184
"50591",2020,0,0,79,79
"50592",2017,0,133,0,133
"50592",2018,0,92,92,184
"50592",2020,0,0,79,79
"50593",2017,0,133,0,133
"50593",2018,0,92,92,184
"50593",2020,0,0,79,79
"50594",2017,0,133,0,133
"50594",2018,0,92,92,184
"50594",2020,0,0,79,79
"50596",2017,0,133,0,133
"50596",2018,0,92,92,184
"50596",2020,0,0,79,79
"50597",2017,0,133,0,133
"50597",2018,0,92,92,184
"50597",2020,0,0,79,79
"50598",2017,0,133,0,133
"50598",2018,0,92,92,184
"50598",2020,0,0,79,79
"50599",2017,0,133,0,133
"50599",2018,0,92,92,184
"50599",2020,0,0,79,79
"50601",2017,0,133,0,133
"50601",2018,0,92,92,184
"50601",2020,0,0,79,79
"50603",2017,0,133,0,133
"50603",2018,0,92,92,184
"50603",2020,0,0,79,79
"50604",2017,0,133,0,133
"50604",2018,0,92,92,184
"50604",2020,0,0,79,79
"50606",2017,0,133,0,133
"50606",2018,0,92,92,184
"50606",2020,0,0,79,79
"50607",2017,0,133,0,133
"50607",2018,0,92,92,184
"50607",2020,0,0,79,79
"50609",2017,0,133,0,133
"50609",2018,0,92,92,184
"50609",2020,0,0,79,79
"50610",2017,0,133,0,133
"50610",2018,0,92,92,184
"50610",2020,0,0,79,79
"50612",2017,0,133,0,133
"50612",2018,0,92,92,184
"50612",2020,0,0,79,79
"50613",2017,0,133,0,133
"50613",2018,0,92,92,184
"50613",2020,0,0,79,79
"50615",2017,0,133,0,133
"50615",2018,0,92,92,184
"50615",2020,0,0,79,79
"50616",2017,0,133,0,133
"50616",2018,0,92,92,184
"50616",2020,0,0,79,79
"50617",2017,0,133,0,133
"50617",2018,0,92,92,184
"50617",2020,0,0,79,79
"50618",2017,0,133,0,133
"50618",2018,0,92,92,184
"50618",2020,0,0,79,79
"50619",2017,0,133,0,133
"50619",2018,0,92,92,184
"50619",2020,0,0,79,79
"50621",2017,0,133,0,133
"50621",2018,0,92,92,184
"50621",2020,0,0,79,79
"50624",2017,0,133,0,133
"50624",2018,0,92,92,184
"50624",2020,0,0,79,79
"50626",2017,0,133,0,133
"50626",2018,0,92,92,184
"50626",2020,0,0,79,79
"50628",2017,0,133,0,133
"50628",2018,0,92,92,184
"50628",2020,0,0,79,79
"50629",2017,0,133,0,133
"50629",2018,0,92,92,184
"50629",2020,0,0,79,79
"50633",2017,0,133,0,133
"50633",2018,0,92,92,184
"50633",2020,0,0,79,79
"50634",2017,0,133,0,133
"50634",2018,0,92,92,184
"50634",2020,0,0,79,79
"50637",2017,0,133,0,133
"50637",2018,0,92,92,184
"50637",2020,0,0,79,79
"50639",2017,0,133,0,133
"50639",2018,0,92,92,184
"50639",2020,0,0,79,79
"50641",2017,0,133,0,133
"50641",2018,0,92,92,184
"50641",2020,0,0,79,79
"50643",2017,0,133,0,133
"50643",2018,0,92,92,184
"50643",2020,0,0,79,79
"50647",2017,0,133,0,133
"50647",2018,0,92,92,184
"50647",2020,0,0,79,79
"50648",2017,0,133,0,133
"50648",2018,0,92,92,184
"50648",2020,0,0,79,79
"51001",2019,0,10,0,10
"51002",2019,0,10,0,10
"51003",2019,0,10,0,10
"51004",2019,0,10,0,10
"51005",2019,0,10,0,10
"51006",2019,0,0,84,84
"51007",2019,0,10,0,10
"51009",2019,0,10,0,10
"51010",2019,0,10,0,10
"51015",2019,0,10,0,10
"51017",2019,0,10,84,94
"51018",2019,0,10,0,10
"51019",2019,0,10,0,10
"51022",2019,0,10,0,10
"51023",2019,0,10,0,10
"51025",2019,0,10,0,10
"51027",2019,0,10,0,10
"51028",2019,0,10,0,10
"51029",2019,0,10,0,10
"51030",2019,0,10,0,10
"51031",2019,0,10,0,10
"51032",2019,0,10,0,10
"51034",2019,0,10,0,10
"51035",2019,0,10,0,10
"51036",2019,0,10,0,10
"51039",2019,0,10,0,10
"51040",2019,0,10,0,10
"51041",2019,0,10,0,10
"51042",2019,0,10,0,10
"51043",2019,0,10,0,10
"51044",2019,0,10,0,10
"51045",2019,0,10,0,10
"51046",2019,0,10,0,10
"51049",2019,0,10,0,10
"51051",2019,0,10,0,10
"51052",2019,0,10,0,10
"51053",2019,0,10,0,10
"51054",2019,0,10,0,10
"51055",2019,0,10,0,10
"51056",2019,0,10,0,10
"51057",2019,0,0,84,84
"51058",2019,0,10,0,10
"51060",2019,0,0,84,84
"51061",2019,0,10,0,10
"51065",2019,0,10,0,10
"51066",2019,0,10,84,94
"51074",2019,0,10,0,10
"51075",2019,0,10,0,10
"51076",2019,0,10,0,10
"51078",2019,0,10,0,10
"51079",2019,0,10,0,10
"51080",2019,0,10,84,94
"51081",2019,0,10,0,10
"51082",2019,0,10,0,10
"51083",2019,0,10,0,10
"51084",2019,0,10,0,10
"51086",2019,0,10,0,10
"51087",2019,0,10,0,10
"51088",2019,0,10,0,10
"51090",2019,0,10,0,10
"51091",2019,0,10,0,10
"51092",2019,0,10,0,10
"51093",2019,0,10,0,10
"51095",2019,0,0,84,84
"51097",2019,0,10,0,10
"51098",2019,0,10,0,10
"51099",2019,0,10,0,10
"51101",2019,0,10,0,10
"51102",2019,0,10,0,10
"51103",2019,0,10,0,10
"51104",2019,0,10,0,10
"51105",2019,0,10,0,10
"51106",2019,0,10,0,10
"51107",2019,0,10,0,10
"51108",2019,0,10,0,10
"51109",2019,0,10,0,10
"51110",2019,0,10,0,10
"51112",2019,0,10,0,10
"51115",2019,0,10,0,10
"51117",2019,0,10,0,10
"51118",2019,0,10,0,10
"51119",2019,0,10,0,10
"51122",2019,0,10,84,94
"51124",2019,0,10,0,10
"51125",2019,0,10,0,10
"51126",2019,0,10,0,10
"51127",2019,0,10,0,10
"51130",2019,0,10,84,94
"51133",2019,0,10,0,10
"51134",2019,0,10,0,10
"51137",2019,0,10,0,10
"51138",2019,0,10,0,10
"51139",2019,0,10,0,10
"51141",2019,0,10,0,10
"51142",2019,0,10,0,10
"51144",2019,0,0,84,84
"51145",2019,0,10,0,10
"51146",2019,0,10,0,10
"51147",2019,0,10,0,10
"51148",2019,0,10,0,10
"51149",2019,0,10,0,10
"51150",2019,0,10,0,10
"51151",2019,0,10,0,10
"51152",2019,0,10,0,10
"51153",2019,0,10,0,10
"51154",2019,0,10,0,10
"51155",2019,0,10,0,10
"51157",2019,0,10,0,10
"51158",2019,0,10,0,10
"51160",2019,0,10,0,10
"51161",2019,0,10,0,10
"51162",2019,0,10,0,10
"51163",2019,0,10,0,10
"51164",2019,0,10,0,10
"51165",2019,0,10,0,10
"51166",2019,0,10,0,10
"51167",2019,0,10,0,10
"51168",2019,0,10,0,10
"51169",2019,0,10,0,10
"51170",2019,0,10,0,10
"51171",2019,0,10,0,10
"51172",2019,0,10,0,10
"51173",2019,0,10,0,10
"51176",2019,0,10,0,10
"51177",2019,0,10,0,10
"51178",2019,0,10,0,10
"51179",2019,0,10,0,10
"51181",2019,0,10,0,10
"51182",2019,0,10,0,10
"51183",2019,0,10,0,10
"51184",2019,0,10,0,10
"51186",2019,0,10,0,10
"51191",2019,0,10,0,10
"51192",2019,0,10,0,10
"51193",2019,0,10,0,10
"51195",2019,0,10,0,10
"51196",2019,0,10,0,10
"51197",2019,0,10,0,10
"51200",2019,0,10,0,10
"51202",2019,0,10,0,10
"51203",2019,0,10,0,10
"51204",2019,0,10,0,10
"51205",2019,0,10,0,10
"51206",2019,0,10,0,10
"51208",2019,0,10,0,10
"51210",2019,0,10,0,10
"51211",2019,0,10,0,10
"51212",2019,0,10,0,10
"51213",2019,0,10,0,10
"51214",2019,0,10,0,10
"51216",2019,0,10,0,10
"51217",2019,0,10,0,10
"51218",2019,0,10,84,94
"51219",2019,0,10,0,10
"51220",2019,0,10,0,10
"51223",2019,0,0,84,84
"51225",2019,0,10,0,10
"51226",2019,0,10,0,10
"51227",2019,0,10,0,10
"51228",2019,0,10,0,10
"51229",2019,0,10,0,10
"51230",2019,0,10,0,10
"51231",2019,0,10,0,10
"51232",2019,0,10,0,10
"51234",2019,0,10,0,10
"51237",2019,0,10,0,10
"51238",2019,0,10,0,10
"51239",2019,0,10,0,10
"51240",2019,0,0,84,84
"51241",2019,0,10,0,10
"51242",2019,0,10,0,10
"51243",2019,0,10,0,10
"51244",2019,0,10,0,10
"51247",2019,0,10,0,10
"51248",2019,0,10,0,10
"51249",2019,0,10,0,10
"51251",2019,0,10,0,10
"51252",2019,0,10,0,10
"51254",2019,0,10,0,10
"51255",2019,0,10,0,10
"51256",2019,0,10,0,10
"51259",2019,0,10,0,10
"51260",2019,0,10,0,10
"51265",2019,0,10,0,10
"51266",2019,0,10,0,10
"51268",2019,0,10,0,10
"51270",2019,0,10,84,94
"51272",2019,0,10,0,10
"51273",2019,0,10,0,10
"51274",2019,0,10,0,10
"51275",2019,0,10,0,10
"51276",2019,0,10,0,10
"51277",2019,0,0,84,84
"51278",2019,0,10,0,10
"51279",2019,0,10,0,10
"51280",2019,0,10,0,10
"51281",2019,0,10,0,10
"51282",2019,0,10,0,10
"51283",2019,0,10,0,10
"51285",2019,0,10,0,10
"51286",2019,0,0,84,84
"51287",2019,0,10,0,10
"51289",2019,0,0,84,84
"51290",2019,0,0,84,84
"51291",2019,0,10,0,10
"51292",2019,0,10,0,10
"51293",2019,0,10,0,10
"51295",2019,0,10,0,10
"51296",2019,0,10,0,10
"51299",2019,0,10,0,10
"51301",2019,0,10,0,10
"51302",2019,0,10,0,10
"51303",2019,0,10,0,10
"51305",2019,0,10,0,10
"51307",2019,0,10,0,10
"51308",2019,0,10,0,10
"51310",2019,0,10,0,10
"51311",2019,0,0,84,84
"51312",2019,0,10,0,10
"51313",2019,0,10,0,10
"51315",2019,0,0,84,84
"51316",2019,0,0,84,84
"51317",2019,0,10,0,10
"51318",2019,0,10,0,10
"51319",2019,0,10,0,10
"51320",2019,0,10,0,10
"51322",2019,0,10,0,10
"51323",2019,0,10,0,10
"51324",2019,0,10,0,10
"51325",2019,0,10,0,10
"51326",2019,0,10,0,10
"51327",2019,0,10,0,10
"51328",2019,0,10,0,10
"51329",2019,0,10,0,10
"51333",2019,0,10,0,10
"51336",2019,0,10,0,10
"51338",2019,0,10,0,10
"51339",2019,0,10,0,10
"51340",2019,0,10,0,10
"51342",2019,0,10,0,10
"51343",2019,0,10,0,10
"51344",2019,0,10,0,10
"51346",2019,0,10,0,10
"51349",2019,0,10,0,10
"51351",2019,0,10,0,10
"51353",2019,0,10,0,10
"51354",2019,0,10,0,10
"51355",2019,0,10,0,10
"51357",2019,0,10,0,10
"51358",2019,0,0,84,84
"51360",2019,0,10,0,10
"51361",2019,0,10,0,10
"51362",2019,0,10,0,10
"51363",2019,0,10,84,94
"51365",2019,0,10,0,10
"51367",2019,0,10,0,10
"51368",2019,0,10,0,10
"51369",2019,0,10,0,10
"51371",2019,0,10,0,10
"51372",2019,0,10,0,10
"51374",2019,0,10,0,10
"51375",2019,0,10,0,10
"51376",2019,0,10,0,10
"51377",2019,0,10,0,10
"51378",2019,0,10,0,10
"51379",2019,0,10,0,10
"51381",2019,0,10,0,10
"51384",2019,0,10,0,10
"51387",2019,0,10,0,10
"51388",2019,0,10,0,10
"51389",2019,0,10,0,10
"51390",2019,0,10,0,10
"51391",2019,0,10,0,10
"51392",2019,0,10,0,10
"51397",2019,0,10,0,10
"51399",2019,0,10,0,10
"51403",2019,0,10,0,10
"51404",2019,0,10,0,10
"51409",2019,0,10,0,10
"51410",2019,0,10,0,10
"51412",2019,0,10,0,10
"51413",2019,0,10,0,10
"51415",2019,0,10,0,10
"51418",2019,0,10,0,10
"51420",2019,0,10,84,94
"51421",2019,0,10,0,10
"51422",2019,0,10,0,10
"51423",2019,0,0,84,84
"51426",2019,0,10,0,10
"51428",2019,0,10,0,10
"51429",2019,0,10,0,10
"51430",2019,0,10,0,10
"51431",2019,0,10,0,10
"51432",2019,0,10,0,10
"51433",2019,0,0,84,84
"51434",2019,0,10,0,10
"51435",2019,0,10,0,10
"51436",2019,0,10,0,10
"51438",2019,0,10,0,10
"51439",2019,0,10,0,10
"51440",2019,0,10,0,10
"51441",2019,0,0,84,84
"51442",2019,0,10,0,10
"51443",2019,0,10,0,10
"51444",2019,0,10,0,10
"51446",2019,0,10,0,10
"51447",2019,0,10,0,10
"51448",2019,0,10,0,10
"51449",2019,0,10,0,10
"51450",2019,0,10,0,10
"51451",2019,0,10,0,10
"51452",2019,0,10,0,10
"51453",2019,0,10,0,10
"51454",2019,0,10,0,10
"51456",2019,0,10,0,10
"51458",2019,0,10,0,10
"51461",2019,0,10,0,10
"51463",2019,0,10,84,94
"51464",2019,0,10,0,10
"51465",2019,0,10,0,10
"51468",2019,0,10,0,10
"51469",2019,0,10,0,10
"51470",2019,0,10,0,10
"51471",2019,0,10,0,10
"51472",2019,0,10,0,10
"51474",2019,0,10,0,10
"51475",2019,0,10,84,94
"51476",2019,0,10,0,10
"51477",2019,0,10,0,10
"51482",2019,0,10,0,10
"51483",2019,0,10,0,10
"51485",2019,0,10,0,10
"51486",2019,0,10,0,10
"51487",2019,0,10,0,10
"51489",2019,0,10,0,10
"51490",2019,0,10,0,10
"51491",2019,0,10,0,10
"51492",2019,0,10,0,10
"51493",2019,0,10,0,10
"51495",2019,0,10,0,10
"51496",2019,0,10,0,10
"51498",2019,0,10,0,10
"51499",2019,0,10,0,10
"51500",2019,0,10,0,10
"51501",2019,0,10,0,10
"51502",2019,0,10,0,10
"51503",2019,0,10,0,10
"51504",2019,0,10,0,10
"51505",2019,0,10,0,10
"51506",2019,0,10,0,10
"51507",2019,0,10,0,10
"51508",2019,0,10,0,10
"51509",2019,0,10,0,10
"51510",2019,0,10,0,10
"51511",2019,0,10,0,10
"51512",2019,0,10,0,10
"51513",2019,0,10,0,10
"51514",2019,0,10,0,10
"51515",2019,0,10,0,10
"51516",2019,0,10,0,10
"51517",2019,0,10,0,10
"51518",2019,0,10,0,10
"51520",2019,0,10,0,10
"51524",2019,0,10,0,10
"51525",2019,0,10,0,10
"51526",2019,0,10,0,10
"51529",2019,0,10,0,10
"51530",2019,0,10,0,10
"51531",2019,0,0,84,84
"51532",2019,0,10,0,10
"51535",2019,0,10,0,10
"51536",2019,0,10,0,10
"51537",2019,0,10,0,10
"51538",2019,0,10,0,10
"51539",2019,0,0,84,84
"51543",2019,0,10,0,10
"51544",2019,0,10,0,10
"51545",2019,0,10,0,10
"51546",2019,0,10,0,10
"51547",2019,0,10,0,10
"51548",2019,0,10,0,10
"51549",2019,0,10,0,10
"51550",2019,0,10,0,10
"51551",2019,0,10,0,10
"51552",2019,0,10,0,10
"51553",2019,0,10,0,10
"51555",2019,0,10,0,10
"51556",2019,0,10,0,10
"51557",2019,0,10,0,10
"51558",2019,0,10,0,10
"51559",2019,0,10,0,10
"51562",2019,0,10,0,10
"51563",2019,0,10,0,10
"51564",2019,0,10,0,10
"51565",2019,0,10,0,10
"51566",2019,0,10,0,10
"51568",2019,0,10,0,10
"51569",2019,0,10,0,10
"51570",2019,0,10,0,10
"51571",2019,0,10,0,10
"51572",2019,0,10,0,10
"51573",2019,0,10,0,10
"51574",2019,0,10,0,10
"51576",2019,0,10,0,10
"51578",2019,0,10,0,10
"51580",2019,0,10,0,10
"51582",2019,0,10,0,10
"51583",2019,0,0,84,84
"51584",2019,0,10,0,10
"51585",2019,0,10,0,10
"51587",2019,0,10,0,10
"51588",2019,0,10,0,10
"51589",2019,0,10,0,10
"51590",2019,0,10,84,94
"51591",2019,0,10,0,10
"51594",2019,0,10,0,10
"51595",2019,0,10,0,10
"51597",2019,0,10,0,10
"51599",2019,0,10,0,10
"51600",2019,0,10,0,10
"51601",2019,0,10,84,94
"51602",2019,0,10,84,94
"51603",2019,0,10,0,10
"51604",2019,0,10,0,10
"51608",2019,0,10,84,94
"51610",2019,0,10,0,10
"51611",2019,0,10,0,10
"51612",2019,0,10,0,10
"51613",2019,0,10,0,10
"51614",2019,0,10,0,10
"51616",2019,0,10,0,10
"51617",2019,0,10,0,10
"51619",2019,0,10,0,10
"51620",2019,0,10,0,10
"51622",2019,0,10,0,10
"51623",2019,0,10,0,10
"51627",2019,0,10,0,10
"51628",2019,0,10,0,10
"51629",2019,0,10,0,10
"51630",2019,0,10,0,10
"51631",2019,0,10,0,10
"51633",2019,0,10,0,10
"51634",2019,0,10,0,10
"51635",2019,0,0,84,84
"51636",2019,0,10,0,10
"51638",2019,0,10,0,10
"51640",2019,0,10,0,10
"51641",2019,0,10,0,10
"51642",2019,0,10,0,10
"51643",2019,0,10,0,10
"51645",2019,0,10,0,10
"51646",2019,0,10,0,10
"51647",2019,0,10,84,94
"51648",2019,0,10,0,10
"51649",2019,0,10,0,10
"51650",2019,0,10,0,10
"51652",2019,0,10,0,10
"51655",2019,0,10,0,10
"51656",2019,0,10,0,10
"51657",2019,0,10,0,10
"51658",2019,0,0,84,84
"51659",2019,0,10,0,10
"51660",2019,0,10,0,10
"51662",2019,0,10,0,10
"52001",2020,0,0,42,42
"52002",2020,0,0,42,42
"52003",2020,0,0,42,42
"52004",2020,0,0,42,42
"52005",2020,0,0,42,42
"52006",2020,0,0,42,42
"52007",2020,0,0,42,42
"52008",2020,0,0,42,42
"52009",2020,0,0,42,42
"52011",2020,0,0,42,42
"52012",2020,0,0,42,42
"52013",2020,0,0,42,42
"52014",2020,0,0,42,42
"52015",2020,0,0,42,42
"52016",2020,0,0,42,42
"52017",2020,0,0,42,42
"52019",2020,0,0,42,42
"52021",2020,0,0,42,42
"52022",2020,0,0,42,42
"52023",2020,0,0,42,42
"52025",2020,0,0,42,42
"52027",2020,0,0,42,42
"52028",2020,0,0,42,42
"52029",2020,0,0,42,42
"52030",2020,0,0,42,42
"52031",2020,0,0,42,42
"52033",2020,0,0,42,42
"52034",2020,0,0,42,42
"52035",2020,0,0,42,42
"52037",2020,0,0,42,42
"52038",2020,0,0,42,42
"52039",2020,0,0,42,42
"52040",2020,0,0,42,42
"52042",2020,0,0,42,42
"52043",2020,0,0,42,42
"52044",2020,0,0,42,42
"52045",2020,0,0,42,42
"52047",2020,0,0,42,42
"52050",2020,0,0,42,42
"52051",2020,0,0,42,42
"52053",2020,0,0,42,42
"52055",2020,0,0,42,42
"52056",2020,0,0,42,42
"52057",2020,0,0,42,42
"52058",2020,0,0,42,42
"52059",2020,0,0,42,42
"52060",2020,0,0,42,42
"52061",2020,0,0,42,42
"52062",2020,0,0,42,42
"52063",2020,0,0,42,42
"52064",2020,0,0,42,42
"52065",2020,0,0,42,42
"52066",2020,0,0,42,42
"52067",2020,0,0,42,42
"52069",2020,0,0,42,42
"52070",2020,0,0,42,42
"52072",2020,0,0,42,42
"52074",2020,0,0,42,42
"52075",2020,0,0,42,42
"52076",2020,0,0,42,42
"52079",2020,0,0,42,42
"52082",2020,0,0,42,42
"52083",2020,0,0,42,42
"52084",2020,0,0,42,42
"52085",2020,0,0,42,42
"52087",2020,0,0,42,42
"52088",2020,0,0,42,42
"52089",2020,0,0,42,42
"52090",2020,0,0,42,42
"52091",2020,0,0,42,42
"52092",2020,0,0,42,42
"52093",2020,0,0,42,42
"52094",2020,0,0,42,42
"52095",2020,0,0,42,42
"52097",2020,0,0,42,42
"52099",2020,0,0,42,42
"52101",2020,0,0,42,42
"52102",2020,0,0,42,42
"52103",2020,0,0,42,42
"52104",2020,0,0,42,42
"52105",2020,0,0,42,42
"52106",2020,0,0,42,42
"52107",2020,0,0,42,42
"52108",2020,0,0,42,42
"52109",2020,0,0,42,42
"52110",2020,0,0,42,42
"52113",2020,0,0,42,42
"52114",2020,0,0,42,42
"52115",2020,0,0,42,42
"52116",2020,0,0,42,42
"52118",2020,0,0,42,42
"52119",2020,0,0,42,42
"52120",2020,0,0,42,42
"52121",2020,0,0,42,42
"52122",2020,0,0,42,42
"52123",2020,0,0,42,42
"52124",2020,0,0,42,42
"52125",2020,0,0,42,42
"52126",2020,0,0,42,42
"52127",2020,0,0,42,42
"52128",2020,0,0,42,42
"52129",2020,0,0,42,42
"52130",2020,0,0,42,42
"52131",2020,0,0,42,42
"52132",2020,0,0,42,42
"52133",2020,0,0,42,42
"52134",2020,0,0,42,42
"52135",2020,0,0,42,42
"52136",2020,0,0,42,42
"52137",2020,0,0,42,42
"52138",2020,0,0,42,42
"52140",2020,0,0,42,42
"52141",2020,0,0,42,42
"52142",2020,0,0,42,42
"52145",2020,0,0,42,42
"52146",2020,0,0,42,42
"52147",2020,0,0,42,42
"52149",2020,0,0,42,42
"52151",2020,0,0,42,42
"52155",2020,0,0,42,42
"52156",2020,0,0,42,42
"52157",2020,0,0,42,42
"52158",2020,0,0,42,42
"52159",2020,0,0,42,42
"52160",2020,0,0,42,42
"52161",2020,0,0,42,42
"52162",2020,0,0,42,42
"52163",2020,0,0,42,42
"52164",2020,0,0,42,42
"52165",2020,0,0,42,42
"52167",2020,0,0,42,42
"52168",2020,0,0,42,42
"52169",2020,0,0,42,42
"52170",2020,0,0,42,42
"52171",2020,0,0,42,42
"52172",2020,0,0,42,42
"52173",2020,0,0,42,42
"52174",2020,0,0,42,42
"52175",2020,0,0,42,42
"52177",2020,0,0,42,42
"52178",2020,0,0,42,42
"52179",2020,0,0,42,42
"52181",2020,0,0,42,42
"52182",2020,0,0,42,42
"52183",2020,0,0,42,42
"52184",2020,0,0,42,42
"52185",2020,0,0,42,42
"52187",2020,0,0,42,42
"52189",2020,0,0,42,42
"52190",2020,0,0,42,42
"52193",2020,0,0,42,42
"52194",2020,0,0,42,42
"52195",2020,0,0,42,42
"52196",2020,0,0,42,42
"52197",2020,0,0,42,42
"52198",2020,0,0,42,42
"52199",2020,0,0,42,42
"52200",2020,0,0,42,42
"52201",2020,0,0,42,42
"52203",2020,0,0,42,42
"52204",2020,0,0,42,42
"52205",2020,0,0,42,42
"52206",2020,0,0,42,42
"52207",2020,0,0,42,42
"52208",2020,0,0,42,42
"52211",2020,0,0,42,42
"52212",2020,0,0,42,42
"52213",2020,0,0,42,42
"52214",2020,0,0,42,42
"52216",2020,0,0,42,42
"52217",2020,0,0,42,42
"52218",2020,0,0,42,42
"52219",2020,0,0,42,42
"52220",2020,0,0,42,42
"52221",2020,0,0,42,42
"52222",2020,0,0,42,42
"52223",2020,0,0,42,42
"52227",2020,0,0,42,42
"52228",2020,0,0,42,42
"52229",2020,0,0,42,42
"52230",2020,0,0,42,42
"52231",2020,0,0,42,42
"52232",2020,0,0,42,42
"52233",2020,0,0,42,42
"52234",2020,0,0,42,42
"52235",2020,0,0,42,42
"52237",2020,0,0,42,42
"52240",2020,0,0,42,42
"52242",2020,0,0,42,42
"52243",2020,0,0,42,42
"52244",2020,0,0,42,42
"52245",2020,0,0,42,42
"52246",2020,0,0,42,42
"52247",2020,0,0,42,42
"52248",2020,0,0,42,42
"52249",2020,0,0,42,42
"52250",2020,0,0,42,42
"52251",2020,0,0,42,42
"52253",2020,0,0,42,42
"52254",2020,0,0,42,42
"52256",2020,0,0,42,42
"52257",2020,0,0,42,42
"52258",2020,0,0,42,42
"52260",2020,0,0,42,42
"52264",2020,0,0,42,42
"52265",2020,0,0,42,42
"52266",2020,0,0,42,42
"52267",2020,0,0,42,42
"52269",2020,0,0,42,42
"52271",2020,0,0,42,42
"52272",2020,0,0,42,42
"52273",2020,0,0,42,42
"52274",2020,0,0,42,42
"52275",2020,0,0,42,42
"52276",2020,0,0,42,42
"52277",2020,0,0,42,42
"52278",2020,0,0,42,42
"52280",2020,0,0,42,42
"52282",2020,0,0,42,42
"52284",2020,0,0,42,42
"52285",2020,0,0,42,42
"52286",2020,0,0,42,42
"52287",2020,0,0,42,42
"52288",2020,0,0,42,42
"52289",2020,0,0,42,42
"52290",2020,0,0,42,42
"52291",2020,0,0,42,42
"52292",2020,0,0,42,42
"52294",2020,0,0,42,42
"52295",2020,0,0,42,42
"52297",2020,0,0,42,42
"52298",2020,0,0,42,42
"52300",2020,0,0,42,42
"52301",2020,0,0,42,42
"52302",2020,0,0,42,42
"52303",2020,0,0,42,42
"52304",2020,0,0,42,42
"52305",2020,0,0,42,42
"52306",2020,0,0,42,42
"52307",2020,0,0,42,42
"52308",2020,0,0,42,42
"52310",2020,0,0,42,42
"52311",2020,0,0,42,42
"52312",2020,0,0,42,42
"52313",2020,0,0,42,42
"52315",2020,0,0,42,42
"52316",2020,0,0,42,42
"52318",2020,0,0,42,42
"52319",2020,0,0,42,42
"52320",2020,0,0,42,42
"52321",2020,0,0,42,42
"52322",2020,0,0,42,42
"52325",2020,0,0,42,42
"52326",2020,0,0,42,42
"52327",2020,0,0,42,42
"52328",2020,0,0,42,42
"52330",2020,0,0,42,42
"52331",2020,0,0,42,42
"52332",2020,0,0,42,42
"52335",2020,0,0,42,42
"52336",2020,0,0,42,42
"52337",2020,0,0,42,42
"52341",2020,0,0,42,42
"52342",2020,0,0,42,42
"52344",2020,0,0,42,42
"52346",2020,0,0,42,42
"52347",2020,0,0,42,42
"52348",2020,0,0,42,42
"52349",2020,0,0,42,42
"52350",2020,0,0,42,42
"52352",2020,0,0,42,42
"52353",2020,0,0,42,42
"52354",2020,0,0,42,42
"52355",2020,0,0,42,42
"52356",2020,0,0,42,42
"52357",2020,0,0,42,42
"52358",2020,0,0,42,42
"52359",2020,0,0,42,42
"52360",2020,0,0,42,42
"52362",2020,0,0,42,42
"52363",2020,0,0,42,42
"52364",2020,0,0,42,42
"52365",2020,0,0,42,42
"52366",2020,0,0,42,42
"52367",2020,0,0,42,42
"52369",2020,0,0,42,42
"52370",2020,0,0,42,42
"52371",2020,0,0,42,42
"52372",2020,0,0,42,42
"52373",2020,0,0,42,42
"52374",2020,0,0,42,42
"52375",2020,0,0,42,42
"52376",2020,0,0,42,42
"52377",2020,0,0,42,42
"52378",2020,0,0,42,42
"52380",2020,0,0,42,42
"52383",2020,0,0,42,42
"52384",2020,0,0,42,42
"52385",2020,0,0,42,42
"52386",2020,0,0,42,42
"52388",2020,0,0,42,42
"52390",2020,0,0,42,42
"52391",2020,0,0,42,42
"52392",2020,0,0,42,42
"52393",2020,0,0,42,42
"52394",2020,0,0,42,42
"52395",2020,0,0,42,42
"52396",2020,0,0,42,42
"52397",2020,0,0,42,42
"52398",2020,0,0,42,42
"52399",2020,0,0,42,42
"52400",2020,0,0,42,42
"52401",2020,0,0,42,42
"52403",2020,0,0,42,42
"52405",2020,0,0,42,42
"52406",2020,0,0,42,42
"52407",2020,0,0,42,42
"52411",2020,0,0,42,42
"52413",2020,0,0,42,42
"52414",2020,0,0,42,42
"52415",2020,0,0,42,42
"52416",2020,0,0,42,42
"52419",2020,0,0,42,42
"52420",2020,0,0,42,42
"52421",2020,0,0,42,42
"52422",2020,0,0,42,42
"52423",2020,0,0,42,42
"52424",2020,0,0,42,42
"52425",2020,0,0,42,42
"52426",2020,0,0,42,42
"52428",2020,0,0,42,42
"52429",2020,0,0,42,42
"52431",2020,0,0,42,42
"52432",2020,0,0,42,42
"52433",2020,0,0,42,42
"52436",2020,0,0,42,42
"52437",2020,0,0,42,42
"52438",2020,0,0,42,42
"52439",2020,0,0,42,42
"52440",2020,0,0,42,42
"52442",2020,0,0,42,42
"52443",2020,0,0,42,42
"52444",2020,0,0,42,42
"52445",2020,0,0,42,42
"52446",2020,0,0,42,42
"52447",2020,0,0,42,42
"52448",2020,0,0,42,42
"52449",2020,0,0,42,42
"52450",2020,0,0,42,42
"52452",2020,0,0,42,42
"52453",2020,0,0,42,42
"52455",2020,0,0,42,42
"52456",2020,0,0,42,42
"52457",2020,0,0,42,42
"52459",2020,0,0,42,42
"52461",2020,0,0,42,42
"52463",2020,0,0,42,42
"52464",2020,0,0,42,42
"52465",2020,0,0,42,42
"52467",2020,0,0,42,42
"52468",2020,0,0,42,42
"52469",2020,0,0,42,42
"52470",2020,0,0,42,42
"52472",2020,0,0,42,42
"52473",2020,0,0,42,42
"52474",2020,0,0,42,42
"52475",2020,0,0,42,42
"52476",2020,0,0,42,42
"52479",2020,0,0,42,42
"52480",2020,0,0,42,42
"52482",2020,0,0,42,42
"52483",2020,0,0,42,42
"52484",2020,0,0,42,42
"52486",2020,0,0,42,42
"52487",2020,0,0,42,42
"52488",2020,0,0,42,42
"52489",2020,0,0,42,42
"52490",2020,0,0,42,42
"52491",2020,0,0,42,42
"52492",2020,0,0,42,42
"52493",2020,0,0,42,42
"52494",2020,0,0,42,42
"52495",2020,0,0,42,42
"52497",2020,0,0,42,42
"52499",2020,0,0,42,42
"52500",2020,0,0,42,42
"52502",2020,0,0,42,42
"52503",2020,0,0,42,42
"52504",2020,0,0,42,42
"52505",2020,0,0,42,42
"52506",2020,0,0,42,42
"52507",2020,0,0,42,42
"52510",2020,0,0,42,42
"52511",2020,0,0,42,42
"52512",2020,0,0,42,42
"52513",2020,0,0,42,42
"52514",2020,0,0,42,42
"52515",2020,0,0,42,42
"52516",2020,0,0,42,42
"52517",2020,0,0,42,42
"52518",2020,0,0,42,42
"52519",2020,0,0,42,42
"52520",2020,0,0,42,42
"52522",2020,0,0,42,42
"52523",2020,0,0,42,42
"52524",2020,0,0,42,42
"52525",2020,0,0,42,42
"52526",2020,0,0,42,42
"52528",2020,0,0,42,42
"52529",2020,0,0,42,42
"52534",2020,0,0,42,42
"52535",2020,0,0,42,42
"52536",2020,0,0,42,42
"52538",2020,0,0,42,42
"52539",2020,0,0,42,42
"52540",2020,0,0,42,42
"52541",2020,0,0,42,42
"52542",2020,0,0,42,42
"52543",2020,0,0,42,42
"52544",2020,0,0,42,42
"52545",2020,0,0,42,42
"52546",2020,0,0,42,42
"52547",2020,0,0,42,42
"52548",2020,0,0,42,42
"52549",2020,0,0,42,42
"52550",2020,0,0,42,42
"53001",2013,0,0,36,36
"53001",2014,0,0,65,65
"53001",2016,0,0,9,9
"53001",2017,0,0,26,26
"53001",2018,0,0,18,18
"53001",2019,0,0,8,8
"53001",2020,0,32,41,73
"53002",2013,0,0,57,57
"53002",2015,0,0,3,3
"53002",2016,0,0,14,14
"53002",2017,0,0,26,26
"53002",2018,0,0,51,51
"53002",2019,0,0,34,34
"53002",2020,0,32,32,64
"53003",2013,0,0,36,36
"53003",2015,0,0,3,3
"53003",2016,0,0,8,8
"53003",2017,0,0,81,81
"53003",2018,0,0,18,18
"53003",2019,0,0,12,12
"53003",2020,0,32,9,41
"53005",2013,0,0,57,57
"53005",2015,0,0,3,3
"53005",2016,0,0,14,14
"53005",2017,0,0,26,26
"53005",2018,0,0,51,51
"53005",2019,0,0,34,34
"53005",2020,0,32,32,64
"53007",2013,0,0,57,57
"53007",2015,0,0,3,3
"53007",2016,0,0,14,14
"53007",2017,0,0,26,26
"53007",2018,0,0,51,51
"53007",2019,0,0,34,34
"53007",2020,0,32,32,64
"53008",2013,0,0,36,36
"53008",2015,0,0,3,3
"53008",2016,0,0,14,14
"53008",2017,0,0,26,26
"53008",2018,0,0,51,51
"53008",2019,0,0,34,34
"53008",2020,0,32,32,64
"53009",2015,0,0,3,3
"53009",2016,0,0,14,14
"53009",2017,0,0,72,72
"53009",2018,0,0,18,18
"53009",2019,0,0,6,6
"53009",2020,0,32,32,64
"53010",2015,0,0,3,3
"53010",2016,0,0,14,14
"53010",2017,0,0,72,72
"53010",2018,0,0,18,18
"53010",2019,0,0,6,6
"53010",2020,0,32,32,64
"53011",2013,0,0,36,36
"53011",2014,0,0,65,65
"53011",2016,0,0,9,9
"53011",2017,0,0,26,26
"53011",2018,0,0,18,18
"53011",2019,0,0,8,8
"53011",2020,0,32,41,73
"53012",2013,0,0,36,36
"53012",2014,0,0,65,65
"53012",2016,0,0,9,9
"53012",2017,0,0,26,26
"53012",2018,0,0,2,2
"53012",2019,0,0,8,8
"53012",2020,0,32,48,80
"53013",2013,0,0,36,36
"53013",2015,0,0,3,3
"53013",2016,0,0,8,8
"53013",2017,0,0,107,107
"53013",2018,0,0,18,18
"53013",2019,0,0,12,12
"53013",2020,0,32,9,41
"53015",2013,0,0,57,57
"53015",2015,0,0,3,3
"53015",2016,0,0,14,14
"53015",2017,0,0,26,26
"53015",2018,0,0,51,51
"53015",2019,0,0,34,34
"53015",2020,0,32,32,64
"53016",2013,0,0,36,36
"53016",2015,0,0,3,3
"53016",2016,0,0,14,14
"53016",2017,0,0,87,87
"53016",2018,0,0,51,51
"53016",2019,0,0,34,34
"53016",2020,0,32,0,32
"53017",2015,0,0,3,3
"53017",2016,0,0,39,39
"53017",2017,0,0,72,72
"53017",2018,0,0,2,2
"53017",2020,0,32,39,71
"53018",2013,0,0,36,36
"53018",2014,0,0,65,65
"53018",2016,0,0,9,9
"53018",2017,0,0,26,26
"53018",2018,0,0,2,2
"53018",2019,0,0,8,8
"53018",2020,0,32,48,80
"53019",2015,0,0,3,3
"53019",2016,0,0,39,39
"53019",2017,0,0,72,72
"53019",2018,0,0,2,2
"53019",2020,0,32,39,71
"53021",2013,0,0,36,36
"53021",2015,0,0,3,3
"53021",2016,0,0,14,14
"53021",2017,0,0,26,26
"53021",2018,0,0,51,51
"53021",2019,0,0,34,34
"53021",2020,0,32,32,64
"53022",2015,0,0,3,3
"53022",2016,0,0,14,14
"53022",2017,0,0,72,72
"53022",2018,0,0,18,18
"53022",2019,0,0,6,6
"53022",2020,0,32,32,64
"53023",2013,0,0,57,57
"53023",2015,0,0,3,3
"53023",2016,0,0,14,14
"53023",2017,0,0,26,26
"53023",2018,0,0,51,51
"53023",2019,0,0,34,34
"53023",2020,0,32,32,64
"53025",2015,0,0,3,3
"53025",2016,0,0,14,14
"53025",2017,0,0,72,72
"53025",2018,0,0,18,18
"53025",2019,0,0,6,6
"53025",2020,0,32,32,64
"53026",2013,0,0,36,36
"53026",2014,0,0,65,65
"53026",2016,0,0,9,9
"53026",2017,0,0,26,26
"53026",2018,0,0,2,2
"53026",2019,0,0,8,8
"53026",2020,0,32,48,80
"53027",2015,0,0,3,3
"53027",2016,0,0,39,39
"53027",2017,0,0,72,72
"53027",2018,0,0,2,2
"53027",2020,0,32,39,71
"53028",2013,0,0,36,36
"53028",2015,0,0,3,3
"53028",2016,0,0,14,14
"53028",2017,0,0,26,26
"53028",2018,0,0,51,51
"53028",2019,0,0,34,34
"53028",2020,0,32,32,64
"53029",2015,0,0,3,3
"53029",2016,0,0,14,14
"53029",2017,0,0,72,72
"53029",2018,0,0,18,18
"53029",2019,0,0,6,6
"53029",2020,0,32,32,64
"53030",2015,0,0,3,3
"53030",2016,0,0,14,14
"53030",2017,0,0,72,72
"53030",2018,0,0,18,18
"53030",2019,0,0,6,6
"53030",2020,0,32,32,64
"53031",2013,0,0,57,57
"53031",2015,0,0,3,3
"53031",2016,0,0,14,14
"53031",2017,0,0,26,26
"53031",2018,0,0,51,51
"53031",2019,0,0,34,34
"53031",2020,0,32,32,64
"53033",2013,0,0,36,36
"53033",2014,0,0,65,65
"53033",2016,0,0,9,9
"53033",2017,0,0,26,26
"53033",2018,0,0,2,2
"53033",2019,0,0,8,8
"53033",2020,0,32,48,80
"53034",2013,0,0,57,57
"53034",2015,0,0,3,3
"53034",2016,0,0,14,14
"53034",2017,0,0,26,26
"53034",2018,0,0,51,51
"53034",2019,0,0,34,34
"53034",2020,0,32,32,64
"53035",2013,0,0,36,36
"53035",2014,0,0,65,65
"53035",2016,0,0,9,9
"53035",2017,0,0,26,26
"53035",2018,0,0,2,2
"53035",2019,0,0,8,8
"53035",2020,0,32,48,80
"53036",2015,0,0,3,3
"53036",2016,0,0,14,14
"53036",2017,0,0,72,72
"53036",2018,0,0,18,18
"53036",2019,0,0,6,6
"53036",2020,0,32,32,64
"53037",2015,0,0,3,3
"53037",2016,0,0,39,39
"53037",2017,0,0,72,72
"53037",2018,0,0,2,2
"53037",2020,0,32,39,71
"53038",2013,0,0,36,36
"53038",2015,0,0,3,3
"53038",2016,0,0,8,8
"53038",2017,0,0,107,107
"53038",2018,0,0,18,18
"53038",2019,0,0,12,12
"53038",2020,0,32,9,41
"53039",2013,0,0,57,57
"53039",2015,0,0,3,3
"53039",2016,0,0,14,14
"53039",2017,0,0,26,26
"53039",2018,0,0,51,51
"53039",2019,0,0,34,34
"53039",2020,0,32,32,64
"53040",2013,0,0,57,57
"53040",2015,0,0,3,3
"53040",2016,0,0,14,14
"53040",2017,0,0,26,26
"53040",2018,0,0,51,51
"53040",2019,0,0,34,34
"53040",2020,0,32,32,64
"53041",2013,0,0,36,36
"53041",2014,0,0,65,65
"53041",2016,0,0,9,9
"53041",2017,0,0,26,26
"53041",2018,0,0,2,2
"53041",2019,0,0,8,8
"53041",2020,0,32,48,80
"53042",2013,0,0,36,36
"53042",2015,0,0,3,3
"53042",2016,0,0,8,8
"53042",2017,0,0,81,81
"53042",2018,0,0,18,18
"53042",2019,0,0,12,12
"53042",2020,0,32,9,41
"53043",2013,0,0,57,57
"53043",2015,0,0,3,3
"53043",2016,0,0,14,14
"53043",2017,0,0,26,26
"53043",2018,0,0,51,51
"53043",2019,0,0,34,34
"53043",2020,0,32,32,64
"53045",2013,0,0,36,36
"53045",2014,0,0,65,65
"53045",2016,0,0,9,9
"53045",2017,0,0,26,26
"53045",2018,0,0,18,18
"53045",2019,0,0,8,8
"53045",2020,0,32,41,73
"53046",2015,0,0,3,3
"53046",2016,0,0,39,39
"53046",2017,0,0,72,72
"53046",2018,0,0,2,2
"53046",2020,0,32,39,71
"53047",2013,0,0,36,36
"53047",2015,0,0,3,3
"53047",2016,0,0,8,8
"53047",2017,0,0,81,81
"53047",2018,0,0,18,18
"53047",2019,0,0,12,12
"53047",2020,0,32,9,41
"53048",2013,0,0,57,57
"53048",2015,0,0,3,3
"53048",2016,0,0,14,14
"53048",2017,0,0,26,26
"53048",2018,0,0,51,51
"53048",2019,0,0,34,34
"53048",2020,0,32,32,64
"53049",2013,0,0,57,57
"53049",2015,0,0,3,3
"53049",2016,0,0,14,14
"53049",2017,0,0,26,26
"53049",2018,0,0,51,51
"53049",2019,0,0,34,34
"53049",2020,0,32,32,64
"53051",2013,0,0,36,36
"53051",2015,0,0,3,3
"53051",2016,0,0,8,8
"53051",2017,0,0,81,81
"53051",2018,0,0,18,18
"53051",2019,0,0,12,12
"53051",2020,0,32,9,41
"53052",2013,0,0,36,36
"53052",2015,0,0,3,3
"53052",2016,0,0,8,8
"53052",2017,0,0,107,107
"53052",2018,0,0,18,18
"53052",2019,0,0,12,12
"53052",2020,0,32,9,41
"53053",2013,0,0,36,36
"53053",2015,0,0,3,3
"53053",2016,0,0,14,14
"53053",2017,0,0,87,87
"53053",2018,0,0,51,51
"53053",2019,0,0,34,34
"53053",2020,0,32,0,32
"53054",2013,0,0,57,57
"53054",2015,0,0,3,3
"53054",2016,0,0,14,14
"53054",2017,0,0,26,26
"53054",2018,0,0,51,51
"53054",2019,0,0,34,34
"53054",2020,0,32,32,64
"53055",2013,0,0,36,36
"53055",2015,0,0,3,3
"53055",2016,0,0,8,8
"53055",2017,0,0,81,81
"53055",2018,0,0,18,18
"53055",2019,0,0,12,12
"53055",2020,0,32,9,41
"53056",2013,0,0,57,57
"53056",2015,0,0,3,3
"53056",2016,0,0,14,14
"53056",2017,0,0,26,26
"53056",2018,0,0,51,51
"53056",2019,0,0,34,34
"53056",2020,0,32,32,64
"53057",2013,0,0,36,36
"53057",2015,0,0,3,3
"53057",2016,0,0,14,14
"53057",2017,0,0,26,26
"53057",2018,0,0,51,51
"53057",2019,0,0,34,34
"53057",2020,0,32,32,64
"53058",2013,0,0,36,36
"53058",2014,0,0,65,65
"53058",2016,0,0,9,9
"53058",2017,0,0,26,26
"53058",2018,0,0,2,2
"53058",2019,0,0,8,8
"53058",2020,0,32,48,80
"53059",2015,0,0,3,3
"53059",2016,0,0,14,14
"53059",2017,0,0,72,72
"53059",2018,0,0,18,18
"53059",2019,0,0,6,6
"53059",2020,0,32,32,64
"53061",2013,0,0,36,36
"53061",2015,0,0,3,3
"53061",2016,0,0,8,8
"53061",2017,0,0,81,81
"53061",2018,0,0,2,2
"53061",2019,0,0,12,12
"53061",2020,0,32,9,41
"53062",2013,0,0,36,36
"53062",2014,0,0,65,65
"53062",2016,0,0,9,9
"53062",2017,0,0,26,26
"53062",2018,0,0,18,18
"53062",2019,0,0,8,8
"53062",2020,0,32,41,73
"53063",2013,0,0,57,57
"53063",2015,0,0,3,3
"53063",2016,0,0,14,14
"53063",2017,0,0,26,26
"53063",2018,0,0,51,51
"53063",2019,0,0,34,34
"53063",2020,0,32,32,64
"53064",2013,0,0,36,36
"53064",2015,0,0,3,3
"53064",2016,0,0,8,8
"53064",2017,0,0,81,81
"53064",2018,0,0,18,18
"53064",2019,0,0,12,12
"53064",2020,0,32,9,41
"53066",2013,0,0,36,36
"53066",2014,0,0,65,65
"53066",2016,0,0,9,9
"53066",2017,0,0,26,26
"53066",2018,0,0,18,18
"53066",2019,0,0,8,8
"53066",2020,0,32,41,73
"53067",2015,0,0,3,3
"53067",2016,0,0,39,39
"53067",2017,0,0,72,72
"53067",2018,0,0,2,2
"53067",2020,0,32,39,71
"53068",2013,0,0,36,36
"53068",2014,0,0,65,65
"53068",2016,0,0,9,9
"53068",2017,0,0,26,26
"53068",2018,0,0,2,2
"53068",2019,0,0,8,8
"53068",2020,0,32,48,80
"53069",2013,0,0,36,36
"53069",2015,0,0,3,3
"53069",2016,0,0,8,8
"53069",2017,0,0,81,81
"53069",2018,0,0,2,2
"53069",2019,0,0,12,12
"53069",2020,0,32,9,41
"53071",2013,0,0,36,36
"53071",2015,0,0,3,3
"53071",2016,0,0,8,8
"53071",2017,0,0,81,81
"53071",2018,0,0,18,18
"53071",2019,0,0,12,12
"53071",2020,0,32,9,41
"53072",2013,0,0,36,36
"53072",2015,0,0,3,3
"53072",2016,0,0,14,14
"53072",2017,0,0,26,26
"53072",2018,0,0,51,51
"53072",2019,0,0,34,34
"53072",2020,0,32,32,64
"53073",2013,0,0,36,36
"53073",2014,0,0,65,65
"53073",2016,0,0,9,9
"53073",2017,0,0,26,26
"53073",2018,0,0,2,2
"53073",2019,0,0,8,8
"53073",2020,0,32,48,80
"53074",2013,0,0,36,36
"53074",2015,0,0,3,3
"53074",2016,0,0,14,14
"53074",2017,0,0,26,26
"53074",2018,0,0,51,51
"53074",2019,0,0,34,34
"53074",2020,0,32,32,64
"53075",2013,0,0,36,36
"53075",2014,0,0,65,65
"53075",2016,0,0,9,9
"53075",2017,0,0,26,26
"53075",2018,0,0,18,18
"53075",2019,0,0,8,8
"53075",2020,0,32,41,73
"53076",2015,0,0,3,3
"53076",2016,0,0,39,39
"53076",2017,0,0,72,72
"53076",2018,0,0,2,2
"53076",2020,0,32,39,71
"53077",2013,0,0,36,36
"53077",2014,0,0,65,65
"53077",2016,0,0,9,9
"53077",2017,0,0,26,26
"53077",2018,0,0,18,18
"53077",2019,0,0,8,8
"53077",2020,0,32,41,73
"53078",2013,0,0,57,57
"53078",2015,0,0,3,3
"53078",2016,0,0,14,14
"53078",2017,0,0,26,26
"53078",2018,0,0,51,51
"53078",2019,0,0,34,34
"53078",2020,0,32,32,64
"53079",2013,0,0,36,36
"53079",2015,0,0,3,3
"53079",2016,0,0,8,8
"53079",2017,0,0,81,81
"53079",2018,0,0,2,2
"53079",2019,0,0,12,12
"53079",2020,0,32,9,41
"53080",2013,0,0,36,36
"53080",2015,0,0,3,3
"53080",2016,0,0,8,8
"53080",2017,0,0,81,81
"53080",2018,0,0,2,2
"53080",2019,0,0,12,12
"53080",2020,0,32,9,41
"53082",2013,0,0,36,36
"53082",2014,0,0,65,65
"53082",2016,0,0,9,9
"53082",2017,0,0,26,26
"53082",2018,0,0,18,18
"53082",2019,0,0,8,8
"53082",2020,0,32,41,73
"53083",2013,0,0,36,36
"53083",2015,0,0,3,3
"53083",2016,0,0,74,74
"53083",2017,0,0,100,100
"53083",2018,0,0,51,51
"53083",2019,0,0,63,63
"53083",2020,0,32,12,44
"53084",2013,0,0,36,36
"53084",2014,0,0,65,65
"53084",2016,0,0,9,9
"53084",2017,0,0,26,26
"53084",2018,0,0,2,2
"53084",2019,0,0,8,8
"53084",2020,0,32,48,80
"53085",2013,0,0,36,36
"53085",2015,0,0,3,3
"53085",2016,0,0,8,8
"53085",2017,0,0,107,107
"53085",2018,0,0,18,18
"53085",2019,0,0,12,12
"53085",2020,0,32,9,41
"53086",2013,0,0,57,57
"53086",2015,0,0,3,3
"53086",2016,0,0,14,14
"53086",2017,0,0,26,26
"53086",2018,0,0,51,51
"53086",2019,0,0,34,34
"53086",2020,0,32,32,64
"53087",2015,0,0,3,3
"53087",2016,0,0,39,39
"53087",2017,0,0,72,72
"53087",2018,0,0,2,2
"53087",2020,0,32,39,71
"53088",2013,0,0,36,36
"53088",2014,0,0,65,65
"53088",2016,0,0,9,9
"53088",2017,0,0,26,26
"53088",2018,0,0,2,2
"53088",2019,0,0,8,8
"53088",2020,0,32,48,80
"53089",2015,0,0,3,3
"53089",2016,0,0,14,14
"53089",2017,0,0,72,72
"53089",2018,0,0,18,18
"53089",2019,0,0,6,6
"53089",2020,0,32,32,64
"53090",2013,0,0,36,36
"53090",2014,0,0,65,65
"53090",2016,0,0,9,9
"53090",2017,0,0,26,26
"53090",2018,0,0,2,2
"53090",2019,0,0,8,8
"53090",2020,0,32,48,80
"53091",2013,0,0,36,36
"53091",2015,0,0,3,3
"53091",2016,0,0,8,8
"53091",2017,0,0,81,81
"53091",2018,0,0,18,18
"53091",2019,0,0,12,12
"53091",2020,0,32,9,41
"53093",2013,0,0,36,36
"53093",2015,0,0,3,3
"53093",2016,0,0,8,8
"53093",2017,0,0,81,81
"53093",2018,0,0,2,2
"53093",2019,0,0,12,12
"53093",2020,0,32,9,41
"53094",2013,0,0,57,57
"53094",2015,0,0,3,3
"53094",2016,0,0,14,14
"53094",2017,0,0,26,26
"53094",2018,0,0,51,51
"53094",2019,0,0,34,34
"53094",2020,0,32,32,64
"53096",2013,0,0,57,57
"53096",2015,0,0,3,3
"53096",2016,0,0,14,14
"53096",2017,0,0,26,26
"53096",2018,0,0,51,51
"53096",2019,0,0,34,34
"53096",2020,0,32,32,64
"53097",2015,0,0,3,3
"53097",2016,0,0,14,14
"53097",2017,0,0,72,72
"53097",2018,0,0,18,18
"53097",2019,0,0,6,6
"53097",2020,0,32,32,64
"53098",2013,0,0,36,36
"53098",2014,0,0,65,65
"53098",2016,0,0,9,9
"53098",2017,0,0,26,26
"53098",2018,0,0,2,2
"53098",2019,0,0,8,8
"53098",2020,0,32,48,80
"53099",2013,0,0,57,57
"53099",2015,0,0,3,3
"53099",2016,0,0,14,14
"53099",2017,0,0,26,26
"53099",2018,0,0,51,51
"53099",2019,0,0,34,34
"53099",2020,0,32,32,64
"53100",2013,0,0,36,36
"53100",2015,0,0,3,3
"53100",2016,0,0,8,8
"53100",2017,0,0,81,81
"53100",2018,0,0,2,2
"53100",2019,0,0,12,12
"53100",2020,0,32,9,41
"53101",2013,0,0,57,57
"53101",2015,0,0,3,3
"53101",2016,0,0,14,14
"53101",2017,0,0,26,26
"53101",2018,0,0,51,51
"53101",2019,0,0,34,34
"53101",2020,0,32,32,64
"53102",2013,0,0,36,36
"53102",2014,0,0,65,65
"53102",2016,0,0,9,9
"53102",2017,0,0,26,26
"53102",2018,0,0,2,2
"53102",2019,0,0,8,8
"53102",2020,0,32,48,80
"53103",2013,0,0,57,57
"53103",2015,0,0,3,3
"53103",2016,0,0,14,14
"53103",2017,0,0,26,26
"53103",2018,0,0,51,51
"53103",2019,0,0,34,34
"53103",2020,0,32,32,64
"53104",2015,0,0,3,3
"53104",2016,0,0,14,14
"53104",2017,0,0,72,72
"53104",2018,0,0,18,18
"53104",2019,0,0,6,6
"53104",2020,0,32,32,64
"53105",2013,0,0,57,57
"53105",2015,0,0,3,3
"53105",2016,0,0,14,14
"53105",2017,0,0,26,26
"53105",2018,0,0,51,51
"53105",2019,0,0,34,34
"53105",2020,0,32,32,64
"53106",2013,0,0,36,36
"53106",2015,0,0,3,3
"53106",2016,0,0,8,8
"53106",2017,0,0,107,107
"53106",2018,0,0,18,18
"53106",2019,0,0,12,12
"53106",2020,0,32,9,41
"53107",2013,0,0,36,36
"53107",2015,0,0,3,3
"53107",2016,0,0,8,8
"53107",2017,0,0,81,81
"53107",2018,0,0,2,2
"53107",2019,0,0,12,12
"53107",2020,0,32,9,41
"53108",2013,0,0,36,36
"53108",2014,0,0,65,65
"53108",2016,0,0,9,9
"53108",2017,0,0,26,26
"53108",2018,0,0,18,18
"53108",2019,0,0,8,8
"53108",2020,0,32,41,73
"53109",2013,0,0,36,36
"53109",2015,0,0,3,3
"53109",2016,0,0,14,14
"53109",2017,0,0,26,26
"53109",2018,0,0,51,51
"53109",2019,0,0,34,34
"53109",2020,0,32,32,64
"53110",2015,0,0,3,3
"53110",2016,0,0,14,14
"53110",2017,0,0,72,72
"53110",2018,0,0,18,18
"53110",2019,0,0,6,6
"53110",2020,0,32,32,64
"53111",2013,0,0,36,36
"53111",2015,0,0,3,3
"53111",2016,0,0,8,8
"53111",2017,0,0,81,81
"53111",2018,0,0,18,18
"53111",2019,0,0,12,12
"53111",2020,0,32,9,41
"53112",2013,0,0,36,36
"53112",2015,0,0,3,3
"53112",2016,0,0,8,8
"53112",2017,0,0,107,107
"53112",2018,0,0,18,18
"53112",2019,0,0,12,12
"53112",2020,0,32,9,41
"53113",2013,0,0,36,36
"53113",2015,0,0,3,3
"53113",2016,0,0,14,14
"53113",2017,0,0,26,26
"53113",2018,0,0,51,51
"53113",2019,0,0,34,34
"53113",2020,0,32,32,64
"53114",2013,0,0,36,36
"53114",2015,0,0,3,3
"53114",2016,0,0,8,8
"53114",2017,0,0,81,81
"53114",2018,0,0,18,18
"53114",2019,0,0,12,12
"53114",2020,0,32,9,41
"53115",2013,0,0,36,36
"53115",2015,0,0,3,3
"53115",2016,0,0,8,8
"53115",2017,0,0,81,81
"53115",2018,0,0,18,18
"53115",2019,0,0,12,12
"53115",2020,0,32,9,41
"53116",2013,0,0,36,36
"53116",2015,0,0,3,3
"53116",2016,0,0,8,8
"53116",2017,0,0,81,81
"53116",2018,0,0,18,18
"53116",2019,0,0,12,12
"53116",2020,0,32,9,41
"53117",2013,0,0,57,57
"53117",2015,0,0,3,3
"53117",2016,0,0,14,14
"53117",2017,0,0,26,26
"53117",2018,0,0,51,51
"53117",2019,0,0,34,34
"53117",2020,0,32,32,64
"53118",2013,0,0,36,36
"53118",2015,0,0,3,3
"53118",2016,0,0,8,8
"53118",2017,0,0,81,81
"53118",2018,0,0,2,2
"53118",2019,0,0,12,12
"53118",2020,0,32,9,41
"53119",2013,0,0,57,57
"53119",2015,0,0,3,3
"53119",2016,0,0,14,14
"53119",2017,0,0,26,26
"53119",2018,0,0,51,51
"53119",2019,0,0,34,34
"53119",2020,0,32,32,64
"53120",2013,0,0,36,36
"53120",2015,0,0,3,3
"53120",2016,0,0,14,14
"53120",2017,0,0,72,72
"53120",2018,0,0,18,18
"53120",2019,0,0,6,6
"53120",2020,0,32,0,32
"53121",2013,0,0,36,36
"53121",2015,0,0,3,3
"53121",2016,0,0,8,8
"53121",2017,0,0,81,81
"53121",2018,0,0,2,2
"53121",2019,0,0,12,12
"53121",2020,0,32,9,41
"53122",2013,0,0,36,36
"53122",2015,0,0,3,3
"53122",2016,0,0,14,14
"53122",2017,0,0,26,26
"53122",2018,0,0,51,51
"53122",2019,0,0,34,34
"53122",2020,0,32,32,64
"53123",2013,0,0,57,57
"53123",2015,0,0,3,3
"53123",2016,0,0,14,14
"53123",2017,0,0,26,26
"53123",2018,0,0,51,51
"53123",2019,0,0,34,34
"53123",2020,0,32,32,64
"53124",2013,0,0,36,36
"53124",2014,0,0,65,65
"53124",2016,0,0,9,9
"53124",2017,0,0,26,26
"53124",2018,0,0,18,18
"53124",2019,0,0,8,8
"53124",2020,0,32,41,73
"53125",2013,0,0,36,36
"53125",2015,0,0,3,3
"53125",2016,0,0,8,8
"53125",2017,0,0,81,81
"53125",2018,0,0,2,2
"53125",2019,0,0,12,12
"53125",2020,0,32,9,41
"53126",2013,0,0,36,36
"53126",2015,0,0,3,3
"53126",2016,0,0,8,8
"53126",2017,0,0,81,81
"53126",2018,0,0,18,18
"53126",2019,0,0,12,12
"53126",2020,0,32,9,41
"53127",2013,0,0,36,36
"53127",2015,0,0,3,3
"53127",2016,0,0,8,8
"53127",2017,0,0,81,81
"53127",2018,0,0,2,2
"53127",2019,0,0,12,12
"53127",2020,0,32,9,41
"53128",2013,0,0,36,36
"53128",2014,0,0,65,65
"53128",2016,0,0,9,9
"53128",2017,0,0,26,26
"53128",2018,0,0,2,2
"53128",2019,0,0,8,8
"53128",2020,0,32,48,80
"53129",2013,0,0,57,57
"53129",2015,0,0,3,3
"53129",2016,0,0,14,14
"53129",2017,0,0,26,26
"53129",2018,0,0,51,51
"53129",2019,0,0,34,34
"53129",2020,0,32,32,64
"53130",2013,0,0,57,57
"53130",2015,0,0,3,3
"53130",2016,0,0,14,14
"53130",2017,0,0,26,26
"53130",2018,0,0,51,51
"53130",2019,0,0,34,34
"53130",2020,0,32,32,64
"53131",2013,0,0,36,36
"53131",2015,0,0,3,3
"53131",2016,0,0,8,8
"53131",2017,0,0,81,81
"53131",2018,0,0,2,2
"53131",2019,0,0,12,12
"53131",2020,0,32,9,41
"53132",2013,0,0,36,36
"53132",2015,0,0,3,3
"53132",2016,0,0,8,8
"53132",2017,0,0,81,81
"53132",2018,0,0,18,18
"53132",2019,0,0,12,12
"53132",2020,0,32,9,41
"53133",2013,0,0,36,36
"53133",2015,0,0,3,3
"53133",2016,0,0,8,8
"53133",2017,0,0,81,81
"53133",2018,0,0,2,2
"53133",2019,0,0,12,12
"53133",2020,0,32,9,41
"53134",2015,0,0,3,3
"53134",2016,0,0,14,14
"53134",2017,0,0,72,72
"53134",2018,0,0,18,18
"53134",2019,0,0,6,6
"53134",2020,0,32,32,64
"53135",2013,0,0,36,36
"53135",2014,0,0,65,65
"53135",2016,0,0,9,9
"53135",2017,0,0,26,26
"53135",2018,0,0,2,2
"53135",2019,0,0,8,8
"53135",2020,0,32,48,80
"53136",2013,0,0,36,36
"53136",2014,0,0,65,65
"53136",2016,0,0,9,9
"53136",2017,0,0,26,26
"53136",2018,0,0,18,18
"53136",2019,0,0,8,8
"53136",2020,0,32,41,73
"53137",2013,0,0,36,36
"53137",2014,0,0,65,65
"53137",2016,0,0,9,9
"53137",2017,0,0,26,26
"53137",2018,0,0,18,18
"53137",2019,0,0,8,8
"53137",2020,0,32,41,73
"53139",2013,0,0,36,36
"53139",2015,0,0,3,3
"53139",2016,0,0,8,8
"53139",2017,0,0,107,107
"53139",2018,0,0,18,18
"53139",2019,0,0,12,12
"53139",2020,0,32,9,41
"53140",2013,0,0,57,57
"53140",2015,0,0,3,3
"53140",2016,0,0,14,14
"53140",2017,0,0,26,26
"53140",2018,0,0,51,51
"53140",2019,0,0,34,34
"53140",2020,0,32,32,64
"53141",2013,0,0,57,57
"53141",2015,0,0,3,3
"53141",2016,0,0,14,14
"53141",2017,0,0,26,26
"53141",2018,0,0,51,51
"53141",2019,0,0,34,34
"53141",2020,0,32,32,64
"53142",2013,0,0,36,36
"53142",2015,0,0,3,3
"53142",2016,0,0,8,8
"53142",2017,0,0,81,81
"53142",2018,0,0,2,2
"53142",2019,0,0,12,12
"53142",2020,0,32,9,41
"53143",2015,0,0,3,3
"53143",2016,0,0,14,14
"53143",2017,0,0,72,72
"53143",2018,0,0,18,18
"53143",2019,0,0,6,6
"53143",2020,0,32,32,64
"53144",2013,0,0,36,36
"53144",2015,0,0,3,3
"53144",2016,0,0,8,8
"53144",2017,0,0,81,81
"53144",2018,0,0,18,18
"53144",2019,0,0,12,12
"53144",2020,0,32,9,41
"53145",2013,0,0,36,36
"53145",2014,0,0,65,65
"53145",2016,0,0,9,9
"53145",2017,0,0,26,26
"53145",2018,0,0,18,18
"53145",2019,0,0,8,8
"53145",2020,0,32,41,73
"53146",2013,0,0,57,57
"53146",2015,0,0,3,3
"53146",2016,0,0,14,14
"53146",2017,0,0,26,26
"53146",2018,0,0,51,51
"53146",2019,0,0,34,34
"53146",2020,0,32,32,64
"53147",2013,0,0,36,36
"53147",2015,0,0,3,3
"53147",2016,0,0,14,14
"53147",2017,0,0,26,26
"53147",2018,0,0,51,51
"53147",2019,0,0,34,34
"53147",2020,0,32,32,64
"53148",2013,0,0,36,36
"53148",2014,0,0,65,65
"53148",2016,0,0,9,9
"53148",2017,0,0,26,26
"53148",2018,0,0,2,2
"53148",2019,0,0,8,8
"53148",2020,0,32,48,80
"53150",2013,0,0,57,57
"53150",2015,0,0,3,3
"53150",2016,0,0,14,14
"53150",2017,0,0,26,26
"53150",2018,0,0,51,51
"53150",2019,0,0,34,34
"53150",2020,0,32,32,64
"53151",2013,0,0,36,36
"53151",2014,0,0,65,65
"53151",2016,0,0,9,9
"53151",2017,0,0,26,26
"53151",2018,0,0,2,2
"53151",2019,0,0,8,8
"53151",2020,0,32,48,80
"53152",2015,0,0,3,3
"53152",2016,0,0,39,39
"53152",2017,0,0,72,72
"53152",2018,0,0,2,2
"53152",2020,0,32,39,71
"53153",2013,0,0,57,57
"53153",2015,0,0,3,3
"53153",2016,0,0,14,14
"53153",2017,0,0,26,26
"53153",2018,0,0,51,51
"53153",2019,0,0,34,34
"53153",2020,0,32,32,64
"53154",2013,0,0,36,36
"53154",2015,0,0,3,3
"53154",2016,0,0,8,8
"53154",2017,0,0,81,81
"53154",2018,0,0,18,18
"53154",2019,0,0,12,12
"53154",2020,0,32,9,41
"53155",2013,0,0,57,57
"53155",2015,0,0,3,3
"53155",2016,0,0,14,14
"53155",2017,0,0,26,26
"53155",2018,0,0,51,51
"53155",2019,0,0,34,34
"53155",2020,0,32,32,64
"53156",2013,0,0,57,57
"53156",2015,0,0,3,3
"53156",2016,0,0,14,14
"53156",2017,0,0,26,26
"53156",2018,0,0,51,51
"53156",2019,0,0,34,34
"53156",2020,0,32,32,64
"53157",2013,0,0,57,57
"53157",2015,0,0,3,3
"53157",2016,0,0,14,14
"53157",2017,0,0,26,26
"53157",2018,0,0,51,51
"53157",2019,0,0,34,34
"53157",2020,0,32,32,64
"53158",2013,0,0,36,36
"53158",2014,0,0,65,65
"53158",2016,0,0,9,9
"53158",2017,0,0,26,26
"53158",2018,0,0,18,18
"53158",2019,0,0,8,8
"53158",2020,0,32,41,73
"53160",2013,0,0,36,36
"53160",2015,0,0,3,3
"53160",2016,0,0,8,8
"53160",2017,0,0,81,81
"53160",2018,0,0,18,18
"53160",2019,0,0,12,12
"53160",2020,0,32,9,41
"53161",2013,0,0,36,36
"53161",2015,0,0,3,3
"53161",2016,0,0,14,14
"53161",2017,0,0,26,26
"53161",2018,0,0,51,51
"53161",2019,0,0,34,34
"53161",2020,0,32,32,64
"53162",2013,0,0,36,36
"53162",2015,0,0,3,3
"53162",2016,0,0,14,14
"53162",2017,0,0,26,26
"53162",2018,0,0,51,51
"53162",2019,0,0,34,34
"53162",2020,0,32,32,64
"53163",2013,0,0,57,57
"53163",2015,0,0,3,3
"53163",2016,0,0,14,14
"53163",2017,0,0,26,26
"53163",2018,0,0,51,51
"53163",2019,0,0,34,34
"53163",2020,0,32,32,64
"53164",2013,0,0,36,36
"53164",2015,0,0,3,3
"53164",2016,0,0,8,8
"53164",2017,0,0,81,81
"53164",2018,0,0,2,2
"53164",2019,0,0,12,12
"53164",2020,0,32,9,41
"53165",2013,0,0,36,36
"53165",2014,0,0,65,65
"53165",2016,0,0,9,9
"53165",2017,0,0,26,26
"53165",2018,0,0,2,2
"53165",2019,0,0,8,8
"53165",2020,0,32,48,80
"53168",2013,0,0,57,57
"53168",2015,0,0,3,3
"53168",2016,0,0,14,14
"53168",2017,0,0,26,26
"53168",2018,0,0,51,51
"53168",2019,0,0,34,34
"53168",2020,0,32,32,64
"53169",2013,0,0,57,57
"53169",2015,0,0,3,3
"53169",2016,0,0,14,14
"53169",2017,0,0,26,26
"53169",2018,0,0,51,51
"53169",2019,0,0,34,34
"53169",2020,0,32,32,64
"53170",2013,0,0,36,36
"53170",2015,0,0,3,3
"53170",2016,0,0,8,8
"53170",2017,0,0,81,81
"53170",2018,0,0,18,18
"53170",2019,0,0,12,12
"53170",2020,0,32,9,41
"53172",2013,0,0,57,57
"53172",2015,0,0,3,3
"53172",2016,0,0,14,14
"53172",2017,0,0,26,26
"53172",2018,0,0,51,51
"53172",2019,0,0,34,34
"53172",2020,0,32,32,64
"53173",2013,0,0,36,36
"53173",2015,0,0,3,3
"53173",2016,0,0,8,8
"53173",2017,0,0,81,81
"53173",2018,0,0,2,2
"53173",2019,0,0,12,12
"53173",2020,0,32,9,41
"53174",2013,0,0,36,36
"53174",2015,0,0,3,3
"53174",2016,0,0,8,8
"53174",2017,0,0,81,81
"53174",2018,0,0,18,18
"53174",2019,0,0,12,12
"53174",2020,0,32,9,41
"53175",2015,0,0,3,3
"53175",2016,0,0,14,14
"53175",2017,0,0,72,72
"53175",2018,0,0,18,18
"53175",2019,0,0,6,6
"53175",2020,0,32,32,64
"53176",2013,0,0,36,36
"53176",2015,0,0,3,3
"53176",2016,0,0,8,8
"53176",2017,0,0,81,81
"53176",2018,0,0,2,2
"53176",2019,0,0,12,12
"53176",2020,0,32,9,41
"53177",2013,0,0,57,57
"53177",2015,0,0,3,3
"53177",2016,0,0,14,14
"53177",2017,0,0,26,26
"53177",2018,0,0,51,51
"53177",2019,0,0,34,34
"53177",2020,0,32,32,64
"53178",2013,0,0,36,36
"53178",2014,0,0,65,65
"53178",2016,0,0,9,9
"53178",2017,0,0,26,26
"53178",2018,0,0,18,18
"53178",2019,0,0,8,8
"53178",2020,0,32,41,73
"53179",2013,0,0,36,36
"53179",2015,0,0,3,3
"53179",2016,0,0,8,8
"53179",2017,0,0,81,81
"53179",2018,0,0,18,18
"53179",2019,0,0,12,12
"53179",2020,0,32,9,41
"53180",2013,0,0,36,36
"53180",2014,0,0,65,65
"53180",2016,0,0,9,9
"53180",2017,0,0,26,26
"53180",2018,0,0,2,2
"53180",2019,0,0,8,8
"53180",2020,0,32,48,80
"53181",2013,0,0,36,36
"53181",2015,0,0,3,3
"53181",2016,0,0,8,8
"53181",2017,0,0,81,81
"53181",2018,0,0,2,2
"53181",2019,0,0,12,12
"53181",2020,0,32,9,41
"53182",2013,0,0,57,57
"53182",2015,0,0,3,3
"53182",2016,0,0,14,14
"53182",2017,0,0,26,26
"53182",2018,0,0,51,51
"53182",2019,0,0,34,34
"53182",2020,0,32,32,64
"53184",2015,0,0,3,3
"53184",2016,0,0,39,39
"53184",2017,0,0,72,72
"53184",2018,0,0,2,2
"53184",2020,0,32,39,71
"53185",2013,0,0,36,36
"53185",2015,0,0,3,3
"53185",2016,0,0,8,8
"53185",2017,0,0,107,107
"53185",2018,0,0,18,18
"53185",2019,0,0,12,12
"53185",2020,0,32,9,41
"53186",2013,0,0,36,36
"53186",2014,0,0,65,65
"53186",2016,0,0,9,9
"53186",2017,0,0,26,26
"53186",2018,0,0,18,18
"53186",2019,0,0,8,8
"53186",2020,0,32,41,73
"53187",2013,0,0,36,36
"53187",2015,0,0,3,3
"53187",2016,0,0,74,74
"53187",2017,0,0,100,100
"53187",2018,0,0,51,51
"53187",2019,0,0,63,63
"53187",2020,0,32,12,44
"53188",2013,0,0,36,36
"53188",2014,0,0,65,65
"53188",2016,0,0,9,9
"53188",2017,0,0,26,26
"53188",2018,0,0,2,2
"53188",2019,0,0,8,8
"53188",2020,0,32,48,80
"53189",2013,0,0,36,36
"53189",2015,0,0,3,3
"53189",2016,0,0,8,8
"53189",2017,0,0,81,81
"53189",2018,0,0,2,2
"53189",2019,0,0,12,12
"53189",2020,0,32,9,41
"53190",2013,0,0,36,36
"53190",2015,0,0,3,3
"53190",2016,0,0,8,8
"53190",2017,0,0,81,81
"53190",2018,0,0,18,18
"53190",2019,0,0,12,12
"53190",2020,0,32,9,41
"53191",2013,0,0,36,36
"53191",2014,0,0,65,65
"53191",2016,0,0,9,9
"53191",2017,0,0,26,26
"53191",2018,0,0,2,2
"53191",2019,0,0,8,8
"53191",2020,0,32,48,80
"53192",2013,0,0,36,36
"53192",2014,0,0,65,65
"53192",2016,0,0,9,9
"53192",2017,0,0,26,26
"53192",2018,0,0,2,2
"53192",2019,0,0,8,8
"53192",2020,0,32,48,80
"53193",2015,0,0,3,3
"53193",2016,0,0,14,14
"53193",2017,0,0,72,72
"53193",2018,0,0,18,18
"53193",2019,0,0,6,6
"53193",2020,0,32,32,64
"53195",2013,0,0,57,57
"53195",2015,0,0,3,3
"53195",2016,0,0,14,14
"53195",2017,0,0,26,26
"53195",2018,0,0,51,51
"53195",2019,0,0,34,34
"53195",2020,0,32,32,64
"53196",2013,0,0,36,36
"53196",2015,0,0,3,3
"53196",2016,0,0,8,8
"53196",2017,0,0,81,81
"53196",2018,0,0,2,2
"53196",2019,0,0,12,12
"53196",2020,0,32,9,41
"53197",2013,0,0,36,36
"53197",2014,0,0,65,65
"53197",2016,0,0,9,9
"53197",2017,0,0,26,26
"53197",2018,0,0,2,2
"53197",2019,0,0,8,8
"53197",2020,0,32,48,80
"53198",2013,0,0,36,36
"53198",2015,0,0,3,3
"53198",2016,0,0,74,74
"53198",2017,0,0,100,100
"53198",2018,0,0,51,51
"53198",2019,0,0,63,63
"53198",2020,0,32,12,44
"53199",2013,0,0,36,36
"53199",2015,0,0,3,3
"53199",2016,0,0,8,8
"53199",2017,0,0,81,81
"53199",2018,0,0,2,2
"53199",2019,0,0,12,12
"53199",2020,0,32,9,41
"53200",2013,0,0,36,36
"53200",2015,0,0,3,3
"53200",2016,0,0,14,14
"53200",2017,0,0,26,26
"53200",2018,0,0,51,51
"53200",2019,0,0,34,34
"53200",2020,0,32,32,64
"53201",2013,0,0,57,57
"53201",2015,0,0,3,3
"53201",2016,0,0,14,14
"53201",2017,0,0,26,26
"53201",2018,0,0,51,51
"53201",2019,0,0,34,34
"53201",2020,0,32,32,64
"53202",2013,0,0,36,36
"53202",2015,0,0,3,3
"53202",2016,0,0,8,8
"53202",2017,0,0,81,81
"53202",2018,0,0,18,18
"53202",2019,0,0,12,12
"53202",2020,0,32,9,41
"53203",2015,0,0,3,3
"53203",2016,0,0,39,39
"53203",2017,0,0,72,72
"53203",2018,0,0,2,2
"53203",2020,0,32,39,71
"53204",2013,0,0,36,36
"53204",2015,0,0,3,3
"53204",2016,0,0,8,8
"53204",2017,0,0,81,81
"53204",2018,0,0,2,2
"53204",2019,0,0,12,12
"53204",2020,0,32,9,41
"53206",2015,0,0,3,3
"53206",2016,0,0,14,14
"53206",2017,0,0,72,72
"53206",2018,0,0,18,18
"53206",2019,0,0,6,6
"53206",2020,0,32,32,64
"53208",2013,0,0,36,36
"53208",2015,0,0,3,3
"53208",2016,0,0,8,8
"53208",2017,0,0,81,81
"53208",2018,0,0,2,2
"53208",2019,0,0,12,12
"53208",2020,0,32,9,41
"53209",2013,0,0,36,36
"53209",2014,0,0,65,65
"53209",2016,0,0,9,9
"53209",2017,0,0,26,26
"53209",2018,0,0,18,18
"53209",2019,0,0,8,8
"53209",2020,0,32,41,73
"53210",2015,0,0,3,3
"53210",2016,0,0,14,14
"53210",2017,0,0,72,72
"53210",2018,0,0,18,18
"53210",2019,0,0,6,6
"53210",2020,0,32,32,64
"53211",2013,0,0,36,36
"53211",2015,0,0,3,3
"53211",2016,0,0,8,8
"53211",2017,0,0,81,81
"53211",2018,0,0,18,18
"53211",2019,0,0,12,12
"53211",2020,0,32,9,41
"53212",2015,0,0,3,3
"53212",2016,0,0,14,14
"53212",2017,0,0,72,72
"53212",2018,0,0,18,18
"53212",2019,0,0,6,6
"53212",2020,0,32,32,64
"53213",2013,0,0,36,36
"53213",2015,0,0,3,3
"53213",2016,0,0,8,8
"53213",2017,0,0,81,81
"53213",2018,0,0,2,2
"53213",2019,0,0,12,12
"53213",2020,0,32,9,41
"53214",2013,0,0,36,36
"53214",2014,0,0,65,65
"53214",2016,0,0,9,9
"53214",2017,0,0,26,26
"53214",2018,0,0,2,2
"53214",2019,0,0,8,8
"53214",2020,0,32,48,80
"53216",2013,0,0,36,36
"53216",2015,0,0,3,3
"53216",2016,0,0,14,14
"53216",2017,0,0,26,26
"53216",2018,0,0,51,51
"53216",2019,0,0,34,34
"53216",2020,0,32,32,64
"53218",2013,0,0,36,36
"53218",2015,0,0,3,3
"53218",2016,0,0,14,14
"53218",2017,0,0,72,72
"53218",2018,0,0,18,18
"53218",2019,0,0,6,6
"53218",2020,0,32,0,32
"53219",2013,0,0,36,36
"53219",2015,0,0,3,3
"53219",2016,0,0,8,8
"53219",2017,0,0,81,81
"53219",2018,0,0,18,18
"53219",2019,0,0,12,12
"53219",2020,0,32,9,41
"53220",2015,0,0,3,3
"53220",2016,0,0,14,14
"53220",2017,0,0,72,72
"53220",2018,0,0,18,18
"53220",2019,0,0,6,6
"53220",2020,0,32,32,64
"53221",2013,0,0,36,36
"53221",2015,0,0,3,3
"53221",2016,0,0,14,14
"53221",2017,0,0,72,72
"53221",2018,0,0,18,18
"53221",2019,0,0,6,6
"53221",2020,0,32,0,32
"53222",2013,0,0,57,57
"53222",2015,0,0,3,3
"53222",2016,0,0,14,14
"53222",2017,0,0,26,26
"53222",2018,0,0,51,51
"53222",2019,0,0,34,34
"53222",2020,0,32,32,64
"53223",2013,0,0,36,36
"53223",2015,0,0,3,3
"53223",2016,0,0,74,74
"53223",2017,0,0,100,100
"53223",2018,0,0,51,51
"53223",2019,0,0,63,63
"53223",2020,0,32,12,44
"53224",2013,0,0,57,57
"53224",2015,0,0,3,3
"53224",2016,0,0,14,14
"53224",2017,0,0,26,26
"53224",2018,0,0,51,51
"53224",2019,0,0,34,34
"53224",2020,0,32,32,64
"53225",2013,0,0,57,57
"53225",2015,0,0,3,3
"53225",2016,0,0,14,14
"53225",2017,0,0,26,26
"53225",2018,0,0,51,51
"53225",2019,0,0,34,34
"53225",2020,0,32,32,64
"53226",2013,0,0,57,57
"53226",2015,0,0,3,3
"53226",2016,0,0,14,14
"53226",2017,0,0,26,26
"53226",2018,0,0,51,51
"53226",2019,0,0,34,34
"53226",2020,0,32,32,64
"53228",2015,0,0,3,3
"53228",2016,0,0,39,39
"53228",2017,0,0,72,72
"53228",2018,0,0,2,2
"53228",2020,0,32,39,71
"53229",2013,0,0,57,57
"53229",2015,0,0,3,3
"53229",2016,0,0,14,14
"53229",2017,0,0,26,26
"53229",2018,0,0,51,51
"53229",2019,0,0,34,34
"53229",2020,0,32,32,64
"53230",2013,0,0,36,36
"53230",2015,0,0,3,3
"53230",2016,0,0,8,8
"53230",2017,0,0,81,81
"53230",2018,0,0,2,2
"53230",2019,0,0,12,12
"53230",2020,0,32,9,41
"53232",2015,0,0,3,3
"53232",2016,0,0,14,14
"53232",2017,0,0,72,72
"53232",2018,0,0,18,18
"53232",2019,0,0,6,6
"53232",2020,0,32,32,64
"53233",2015,0,0,3,3
"53233",2016,0,0,39,39
"53233",2017,0,0,72,72
"53233",2018,0,0,2,2
"53233",2020,0,32,39,71
"53234",2013,0,0,36,36
"53234",2015,0,0,3,3
"53234",2016,0,0,8,8
"53234",2017,0,0,81,81
"53234",2018,0,0,18,18
"53234",2019,0,0,12,12
"53234",2020,0,32,9,41
"53235",2013,0,0,36,36
"53235",2015,0,0,3,3
"53235",2016,0,0,8,8
"53235",2017,0,0,81,81
"53235",2018,0,0,2,2
"53235",2019,0,0,12,12
"53235",2020,0,32,9,41
"53236",2013,0,0,36,36
"53236",2015,0,0,3,3
"53236",2016,0,0,74,74
"53236",2017,0,0,100,100
"53236",2018,0,0,51,51
"53236",2019,0,0,63,63
"53236",2020,0,32,12,44
"53237",2013,0,0,36,36
"53237",2015,0,0,3,3
"53237",2016,0,0,8,8
"53237",2017,0,0,81,81
"53237",2018,0,0,2,2
"53237",2019,0,0,12,12
"53237",2020,0,32,9,41
"53238",2013,0,0,36,36
"53238",2015,0,0,3,3
"53238",2016,0,0,8,8
"53238",2017,0,0,81,81
"53238",2018,0,0,2,2
"53238",2019,0,0,12,12
"53238",2020,0,32,9,41
"53240",2013,0,0,36,36
"53240",2014,0,0,65,65
"53240",2016,0,0,9,9
"53240",2017,0,0,26,26
"53240",2018,0,0,2,2
"53240",2019,0,0,8,8
"53240",2020,0,32,48,80
"53242",2013,0,0,36,36
"53242",2014,0,0,65,65
"53242",2016,0,0,9,9
"53242",2017,0,0,26,26
"53242",2018,0,0,2,2
"53242",2019,0,0,8,8
"53242",2020,0,32,48,80
"53243",2013,0,0,57,57
"53243",2015,0,0,3,3
"53243",2016,0,0,14,14
"53243",2017,0,0,26,26
"53243",2018,0,0,51,51
"53243",2019,0,0,34,34
"53243",2020,0,32,32,64
"53245",2013,0,0,57,57
"53245",2015,0,0,3,3
"53245",2016,0,0,14,14
"53245",2017,0,0,26,26
"53245",2018,0,0,51,51
"53245",2019,0,0,34,34
"53245",2020,0,32,32,64
"53246",2013,0,0,36,36
"53246",2015,0,0,3,3
"53246",2016,0,0,8,8
"53246",2017,0,0,107,107
"53246",2018,0,0,18,18
"53246",2019,0,0,12,12
"53246",2020,0,32,9,41
"53247",2013,0,0,57,57
"53247",2015,0,0,3,3
"53247",2016,0,0,14,14
"53247",2017,0,0,26,26
"53247",2018,0,0,51,51
"53247",2019,0,0,34,34
"53247",2020,0,32,32,64
"53248",2015,0,0,3,3
"53248",2016,0,0,39,39
"53248",2017,0,0,72,72
"53248",2018,0,0,2,2
"53248",2020,0,32,39,71
"53249",2013,0,0,36,36
"53249",2015,0,0,3,3
"53249",2016,0,0,39,39
"53249",2017,0,0,72,72
"53249",2018,0,0,18,18
"53249",2020,0,32,7,39
"53250",2013,0,0,36,36
"53250",2014,0,0,65,65
"53250",2016,0,0,9,9
"53250",2017,0,0,26,26
"53250",2018,0,0,2,2
"53250",2019,0,0,8,8
"53250",2020,0,32,48,80
"53251",2013,0,0,36,36
"53251",2014,0,0,65,65
"53251",2016,0,0,9,9
"53251",2017,0,0,26,26
"53251",2018,0,0,2,2
"53251",2019,0,0,8,8
"53251",2020,0,32,48,80
"53253",2013,0,0,36,36
"53253",2014,0,0,65,65
"53253",2016,0,0,9,9
"53253",2017,0,0,26,26
"53253",2018,0,0,2,2
"53253",2019,0,0,8,8
"53253",2020,0,32,48,80
"53255",2015,0,0,3,3
"53255",2016,0,0,14,14
"53255",2017,0,0,72,72
"53255",2018,0,0,18,18
"53255",2019,0,0,6,6
"53255",2020,0,32,32,64
"53256",2013,0,0,36,36
"53256",2015,0,0,3,3
"53256",2016,0,0,74,74
"53256",2017,0,0,100,100
"53256",2018,0,0,51,51
"53256",2019,0,0,63,63
"53256",2020,0,32,12,44
"53257",2015,0,0,3,3
"53257",2016,0,0,39,39
"53257",2017,0,0,72,72
"53257",2018,0,0,2,2
"53257",2020,0,32,39,71
"53258",2013,0,0,36,36
"53258",2014,0,0,65,65
"53258",2016,0,0,9,9
"53258",2017,0,0,26,26
"53258",2018,0,0,2,2
"53258",2019,0,0,8,8
"53258",2020,0,32,48,80
"53259",2013,0,0,36,36
"53259",2014,0,0,65,65
"53259",2016,0,0,9,9
"53259",2017,0,0,26,26
"53259",2018,0,0,2,2
"53259",2019,0,0,8,8
"53259",2020,0,32,48,80
"53260",2013,0,0,36,36
"53260",2014,0,0,65,65
"53260",2016,0,0,9,9
"53260",2017,0,0,26,26
"53260",2018,0,0,2,2
"53260",2019,0,0,8,8
"53260",2020,0,32,48,80
"53261",2013,0,0,36,36
"53261",2015,0,0,3,3
"53261",2016,0,0,8,8
"53261",2017,0,0,81,81
"53261",2018,0,0,2,2
"53261",2019,0,0,12,12
"53261",2020,0,32,9,41
"53262",2015,0,0,3,3
"53262",2016,0,0,14,14
"53262",2017,0,0,72,72
"53262",2018,0,0,18,18
"53262",2019,0,0,6,6
"53262",2020,0,32,32,64
"53263",2013,0,0,36,36
"53263",2015,0,0,3,3
"53263",2016,0,0,8,8
"53263",2017,0,0,81,81
"53263",2018,0,0,2,2
"53263",2019,0,0,12,12
"53263",2020,0,32,9,41
"53264",2015,0,0,3,3
"53264",2016,0,0,39,39
"53264",2017,0,0,72,72
"53264",2018,0,0,2,2
"53264",2020,0,32,39,71
"53265",2015,0,0,3,3
"53265",2016,0,0,39,39
"53265",2017,0,0,72,72
"53265",2018,0,0,2,2
"53265",2020,0,32,39,71
"53266",2013,0,0,36,36
"53266",2015,0,0,3,3
"53266",2016,0,0,14,14
"53266",2017,0,0,87,87
"53266",2018,0,0,51,51
"53266",2019,0,0,34,34
"53266",2020,0,32,0,32
"53267",2015,0,0,3,3
"53267",2016,0,0,14,14
"53267",2017,0,0,72,72
"53267",2018,0,0,18,18
"53267",2019,0,0,6,6
"53267",2020,0,32,32,64
"53269",2013,0,0,36,36
"53269",2015,0,0,3,3
"53269",2016,0,0,8,8
"53269",2017,0,0,81,81
"53269",2018,0,0,18,18
"53269",2019,0,0,12,12
"53269",2020,0,32,9,41
"53270",2013,0,0,36,36
"53270",2015,0,0,3,3
"53270",2016,0,0,8,8
"53270",2017,0,0,81,81
"53270",2018,0,0,18,18
"53270",2019,0,0,12,12
"53270",2020,0,32,9,41
"53271",2013,0,0,36,36
"53271",2015,0,0,3,3
"53271",2016,0,0,8,8
"53271",2017,0,0,107,107
"53271",2018,0,0,18,18
"53271",2019,0,0,12,12
"53271",2020,0,32,9,41
"53272",2013,0,0,36,36
"53272",2015,0,0,3,3
"53272",2016,0,0,8,8
"53272",2017,0,0,81,81
"53272",2018,0,0,2,2
"53272",2019,0,0,12,12
"53272",2020,0,32,9,41
"53273",2015,0,0,3,3
"53273",2016,0,0,14,14
"53273",2017,0,0,72,72
"53273",2018,0,0,18,18
"53273",2019,0,0,6,6
"53273",2020,0,32,32,64
"53276",2015,0,0,3,3
"53276",2016,0,0,14,14
"53276",2017,0,0,72,72
"53276",2018,0,0,18,18
"53276",2019,0,0,6,6
"53276",2020,0,32,32,64
"54001",2020,0,0,24,24
"54002",2020,0,0,24,24
"54003",2020,0,0,24,24
"54004",2020,0,0,24,24
"54005",2020,0,0,24,24
"54006",2020,0,0,24,24
"54007",2020,0,0,24,24
"54008",2020,0,0,24,24
"54009",2020,0,0,24,24
"54010",2020,0,0,24,24
"54011",2020,0,0,24,24
"54012",2020,0,0,24,24
"54013",2020,0,0,24,24
"54014",2020,0,0,24,24
"54015",2020,0,0,24,24
"54016",2020,0,0,24,24
"54017",2020,0,0,24,24
"54018",2020,0,0,24,24
"54019",2020,0,0,24,24
"54020",2020,0,0,24,24
"54021",2020,0,0,24,24
"54022",2020,0,0,24,24
"54023",2020,0,0,24,24
"54024",2020,0,0,24,24
"54025",2020,0,0,24,24
"54026",2020,0,0,24,24
"54027",2020,0,0,24,24
"54028",2020,0,0,24,24
"54029",2020,0,0,24,24
"54030",2020,0,0,24,24
"54031",2020,0,0,24,24
"54032",2020,0,0,24,24
"54033",2020,0,0,24,24
"54034",2020,0,0,24,24
"54035",2020,0,0,24,24
"54036",2020,0,0,24,24
"54037",2020,0,0,24,24
"54038",2020,0,0,24,24
"54039",2020,0,0,24,24
"54040",2020,0,0,24,24
"54041",2020,0,0,24,24
"54042",2020,0,0,24,24
"54043",2020,0,0,24,24
"54044",2020,0,0,24,24
"54045",2020,0,0,24,24
"54046",2020,0,0,24,24
"54047",2020,0,0,24,24
"54048",2020,0,0,24,24
"54049",2020,0,0,24,24
"54050",2020,0,0,24,24
"54051",2020,0,0,24,24
"54052",2020,0,0,24,24
"54053",2020,0,0,24,24
"54054",2020,0,0,24,24
"54055",2020,0,0,24,24
"54056",2020,0,0,24,24
"54057",2020,0,0,24,24
"54058",2020,0,0,24,24
"54059",2020,0,0,24,24
"54060",2020,0,0,24,24
"54061",2020,0,0,24,24
"54062",2020,0,0,24,24
"54063",2020,0,0,24,24
"54064",2020,0,0,24,24
"54065",2020,0,0,24,24
"54066",2020,0,0,24,24
"54067",2020,0,0,24,24
"54068",2020,0,0,24,24
"54069",2020,0,0,24,24
"54070",2020,0,0,24,24
"54071",2020,0,0,24,24
"54072",2020,0,0,24,24
"54073",2020,0,0,24,24
"54074",2020,0,0,24,24
"54075",2020,0,0,24,24
"54076",2020,0,0,24,24
"54077",2020,0,0,24,24
"54078",2020,0,0,24,24
"54079",2020,0,0,24,24
"54080",2020,0,0,24,24
"54081",2020,0,0,24,24
"54082",2020,0,0,24,24
"54083",2020,0,0,24,24
"54084",2020,0,0,24,24
"54085",2020,0,0,24,24
"54086",2020,0,0,24,24
"54087",2020,0,0,24,24
"54088",2020,0,0,24,24
"54089",2020,0,0,24,24
"54090",2020,0,0,24,24
"54091",2020,0,0,24,24
"54092",2020,0,0,24,24
"54093",2020,0,0,24,24
"54094",2020,0,0,24,24
"54095",2020,0,0,24,24
"54096",2020,0,0,24,24
"54097",2020,0,0,24,24
"54098",2020,0,0,24,24
"54099",2020,0,0,24,24
"54100",2020,0,0,24,24
"54101",2020,0,0,24,24
"54102",2020,0,0,24,24
"54103",2020,0,0,24,24
"54104",2020,0,0,24,24
"54105",2020,0,0,24,24
"54106",2020,0,0,24,24
"54107",2020,0,0,24,24
"54108",2020,0,0,24,24
"54109",2020,0,0,24,24
"54110",2020,0,0,24,24
"54111",2020,0,0,24,24
"54112",2020,0,0,24,24
"54113",2020,0,0,24,24
"54114",2020,0,0,24,24
"54115",2020,0,0,24,24
"54116",2020,0,0,24,24
"54117",2020,0,0,24,24
"54118",2020,0,0,24,24
"54119",2020,0,0,24,24
"54120",2020,0,0,24,24
"54121",2020,0,0,24,24
"54122",2020,0,0,24,24
"54123",2020,0,0,24,24
"54124",2020,0,0,24,24
"54125",2020,0,0,24,24
"54126",2020,0,0,24,24
"54127",2020,0,0,24,24
"54128",2020,0,0,24,24
"54129",2020,0,0,24,24
"54130",2020,0,0,24,24
"54131",2020,0,0,24,24
"54132",2020,0,0,24,24
"54133",2020,0,0,24,24
"54134",2020,0,0,24,24
"54135",2020,0,0,24,24
"54136",2020,0,0,24,24
"54137",2020,0,0,24,24
"54138",2020,0,0,24,24
"54139",2020,0,0,24,24
"54140",2020,0,0,24,24
"54141",2020,0,0,24,24
"54142",2020,0,0,24,24
"54143",2020,0,0,24,24
"54144",2020,0,0,24,24
"54145",2020,0,0,24,24
"54146",2020,0,0,24,24
"54147",2020,0,0,24,24
"54148",2020,0,0,24,24
"54149",2020,0,0,24,24
"54150",2020,0,0,24,24
"54151",2020,0,0,24,24
"54152",2020,0,0,24,24
"54153",2020,0,0,24,24
"54154",2020,0,0,24,24
"54155",2020,0,0,24,24
"54156",2020,0,0,24,24
"54157",2020,0,0,24,24
"54158",2020,0,0,24,24
"54159",2020,0,0,24,24
"54160",2020,0,0,24,24
"54161",2020,0,0,24,24
"54162",2020,0,0,24,24
"54163",2020,0,0,24,24
"54164",2020,0,0,24,24
"54165",2020,0,0,24,24
"54166",2020,0,0,24,24
"54167",2020,0,0,24,24
"54168",2020,0,0,24,24
"54169",2020,0,0,24,24
"54170",2020,0,0,24,24
"54171",2020,0,0,24,24
"54172",2020,0,0,24,24
"54173",2020,0,0,24,24
"54174",2020,0,0,24,24
"54175",2020,0,0,24,24
"54176",2020,0,0,24,24
"54177",2020,0,0,24,24
"54178",2020,0,0,24,24
"54179",2020,0,0,24,24
"54180",2020,0,0,24,24
"54181",2020,0,0,24,24
"54182",2020,0,0,24,24
"54183",2020,0,0,24,24
"54184",2020,0,0,24,24
"54185",2020,0,0,24,24
"54186",2020,0,0,24,24
"54187",2020,0,0,24,24
"54188",2020,0,0,24,24
"54189",2020,0,0,24,24
"54190",2020,0,0,24,24
"54191",2020,0,0,24,24
"54192",2020,0,0,24,24
"54193",2020,0,0,24,24
"54194",2020,0,0,24,24
"54195",2020,0,0,24,24
"54196",2020,0,0,24,24
"54197",2020,0,0,24,24
"54198",2020,0,0,24,24
"54199",2020,0,0,24,24
"54200",2020,0,0,24,24
"54201",2020,0,0,24,24
"54202",2020,0,0,24,24
"54203",2020,0,0,24,24
"54204",2020,0,0,24,24
"54205",2020,0,0,24,24
"54206",2020,0,0,24,24
"54207",2020,0,0,24,24
"54208",2020,0,0,24,24
"54209",2020,0,0,24,24
"54210",2020,0,0,24,24
"54211",2020,0,0,24,24
"54212",2020,0,0,24,24
"54213",2020,0,0,24,24
"54214",2020,0,0,24,24
"54215",2020,0,0,24,24
"54216",2020,0,0,24,24
"54217",2020,0,0,24,24
"54218",2020,0,0,24,24
"54219",2020,0,0,24,24
"54220",2020,0,0,24,24
"54221",2020,0,0,24,24
"54222",2020,0,0,24,24
"54223",2020,0,0,24,24
"54224",2020,0,0,24,24
"54225",2020,0,0,24,24
"54226",2020,0,0,24,24
"54227",2020,0,0,24,24
"54228",2020,0,0,24,24
"54229",2020,0,0,24,24
"54230",2020,0,0,24,24
"54231",2020,0,0,24,24
"54232",2020,0,0,24,24
"54233",2020,0,0,24,24
"54234",2020,0,0,24,24
"54235",2020,0,0,24,24
"54236",2020,0,0,24,24
"54237",2020,0,0,24,24
"54238",2020,0,0,24,24
"54239",2020,0,0,24,24
"54240",2020,0,0,24,24
"54241",2020,0,0,24,24
"54242",2020,0,0,24,24
"54243",2020,0,0,24,24
"54244",2020,0,0,24,24
"54245",2020,0,0,24,24
"54246",2020,0,0,24,24
"54247",2020,0,0,24,24
"54248",2020,0,0,24,24
"54249",2020,0,0,24,24
"54250",2020,0,0,24,24
"54251",2020,0,0,24,24
"54252",2020,0,0,24,24
"54253",2020,0,0,24,24
"54254",2020,0,0,24,24
"54255",2020,0,0,24,24
"54256",2020,0,0,24,24
"54257",2020,0,0,24,24
"54258",2020,0,0,24,24
"54259",2020,0,0,24,24
"54260",2020,0,0,24,24
"54261",2020,0,0,24,24
"54262",2020,0,0,24,24
"54263",2020,0,0,24,24
"54264",2020,0,0,24,24
"54265",2020,0,0,24,24
"54266",2020,0,0,24,24
"54268",2020,0,0,24,24
"54269",2020,0,0,24,24
"54270",2020,0,0,24,24
"54271",2020,0,0,24,24
"54272",2020,0,0,24,24
"54273",2020,0,0,24,24
"54274",2020,0,0,24,24
"54275",2020,0,0,24,24
"54276",2020,0,0,24,24
"54277",2020,0,0,24,24
"54278",2020,0,0,24,24
"54279",2020,0,0,24,24
"54280",2020,0,0,24,24
"54281",2020,0,0,24,24
"54282",2020,0,0,24,24
"54283",2020,0,0,24,24
"54284",2020,0,0,24,24
"54285",2020,0,0,24,24
"54286",2020,0,0,24,24
"54287",2020,0,0,24,24
"54288",2020,0,0,24,24
"54289",2020,0,0,24,24
"54290",2020,0,0,24,24
"54291",2020,0,0,24,24
"54292",2020,0,0,24,24
"54293",2020,0,0,24,24
"54294",2020,0,0,24,24
"54295",2020,0,0,24,24
"54296",2020,0,0,24,24
"54297",2020,0,0,24,24
"54298",2020,0,0,24,24
"54299",2020,0,0,24,24
"54300",2020,0,0,24,24
"54301",2020,0,0,24,24
"54302",2020,0,0,24,24
"54303",2020,0,0,24,24
"54304",2020,0,0,24,24
"54305",2020,0,0,24,24
"54306",2020,0,0,24,24
"54307",2020,0,0,24,24
"54308",2020,0,0,24,24
"54309",2020,0,0,24,24
"54310",2020,0,0,24,24
"54311",2020,0,0,24,24
"54312",2020,0,0,24,24
"54313",2020,0,0,24,24
"54314",2020,0,0,24,24
"54315",2020,0,0,24,24
"54316",2020,0,0,24,24
"54317",2020,0,0,24,24
"54318",2020,0,0,24,24
"54320",2020,0,0,24,24
"54321",2020,0,0,24,24
"54322",2020,0,0,24,24
"54323",2020,0,0,24,24
"54324",2020,0,0,24,24
"54325",2020,0,0,24,24
"54326",2020,0,0,24,24
"54327",2020,0,0,24,24
"54328",2020,0,0,24,24
"54329",2020,0,0,24,24
"54330",2020,0,0,24,24
"54331",2020,0,0,24,24
"54332",2020,0,0,24,24
"54333",2020,0,0,24,24
"54334",2020,0,0,24,24
"54335",2020,0,0,24,24
"54336",2020,0,0,24,24
"54337",2020,0,0,24,24
"54338",2020,0,0,24,24
"54339",2020,0,0,24,24
"54340",2020,0,0,24,24
"54343",2020,0,0,24,24
"54344",2020,0,0,24,24
"54345",2020,0,0,24,24
"54346",2020,0,0,24,24
"54348",2020,0,0,24,24
"54349",2020,0,0,24,24
"54350",2020,0,0,24,24
"54351",2020,0,0,24,24
"54352",2020,0,0,24,24
"54353",2020,0,0,24,24
"54354",2020,0,0,24,24
"54355",2020,0,0,24,24
"54356",2020,0,0,24,24
"54357",2020,0,0,24,24
"54358",2020,0,0,24,24
"54359",2020,0,0,24,24
"54360",2020,0,0,24,24
"54362",2020,0,0,24,24
"54363",2020,0,0,24,24
"54364",2020,0,0,24,24
"54365",2020,0,0,24,24
"54366",2020,0,0,24,24
"54367",2020,0,0,24,24
"54368",2020,0,0,24,24
"54369",2020,0,0,24,24
"54370",2020,0,0,24,24
"54371",2020,0,0,24,24
"54372",2020,0,0,24,24
"54373",2020,0,0,24,24
"54374",2020,0,0,24,24
"54375",2020,0,0,24,24
"54376",2020,0,0,24,24
"54377",2020,0,0,24,24
"54378",2020,0,0,24,24
"54379",2020,0,0,24,24
"54380",2020,0,0,24,24
"54381",2020,0,0,24,24
"54382",2020,0,0,24,24
"54383",2020,0,0,24,24
"54385",2020,0,0,24,24
"54386",2020,0,0,24,24
"54387",2020,0,0,24,24
"54388",2020,0,0,24,24
"54389",2020,0,0,24,24
"54390",2020,0,0,24,24
"54391",2020,0,0,24,24
"54392",2020,0,0,24,24
"54393",2020,0,0,24,24
"54394",2020,0,0,24,24
"54395",2020,0,0,24,24
"54396",2020,0,0,24,24
"54397",2020,0,0,24,24
"54398",2020,0,0,24,24
"54399",2020,0,0,24,24
"54400",2020,0,0,24,24
"54401",2020,0,0,24,24
"54402",2020,0,0,24,24
"54403",2020,0,0,24,24
"54404",2020,0,0,24,24
"54405",2020,0,0,24,24
"54406",2020,0,0,24,24
"54407",2020,0,0,24,24
"54408",2020,0,0,24,24
"54409",2020,0,0,24,24
"54410",2020,0,0,24,24
"54411",2020,0,0,24,24
"54412",2020,0,0,24,24
"54413",2020,0,0,24,24
"54414",2020,0,0,24,24
"54415",2020,0,0,24,24
"54416",2020,0,0,24,24
"54417",2020,0,0,24,24
"54418",2020,0,0,24,24
"54419",2020,0,0,24,24
"54420",2020,0,0,24,24
"54421",2020,0,0,24,24
"54422",2020,0,0,24,24
"54423",2020,0,0,24,24
"54424",2020,0,0,24,24
"54425",2020,0,0,24,24
"54426",2020,0,0,24,24
"54427",2020,0,0,24,24
"54428",2020,0,0,24,24
"54429",2020,0,0,24,24
"54430",2020,0,0,24,24
"54431",2020,0,0,24,24
"54432",2020,0,0,24,24
"54433",2020,0,0,24,24
"54434",2020,0,0,24,24
"54435",2020,0,0,24,24
"54436",2020,0,0,24,24
"54437",2020,0,0,24,24
"54438",2020,0,0,24,24
"54439",2020,0,0,24,24
"54440",2020,0,0,24,24
"54441",2020,0,0,24,24
"54442",2020,0,0,24,24
"54443",2020,0,0,24,24
"54444",2020,0,0,24,24
"54445",2020,0,0,24,24
"54446",2020,0,0,24,24
"54447",2020,0,0,24,24
"54449",2020,0,0,24,24
"54450",2020,0,0,24,24
"54451",2020,0,0,24,24
"54452",2020,0,0,24,24
"54453",2020,0,0,24,24
"54455",2020,0,0,24,24
"54456",2020,0,0,24,24
"54457",2020,0,0,24,24
"54458",2020,0,0,24,24
"54459",2020,0,0,24,24
"54460",2020,0,0,24,24
"54461",2020,0,0,24,24
"54462",2020,0,0,24,24
"54463",2020,0,0,24,24
"54464",2020,0,0,24,24
"54465",2020,0,0,24,24
"54466",2020,0,0,24,24
"54467",2020,0,0,24,24
"54468",2020,0,0,24,24
"54469",2020,0,0,24,24
"54470",2020,0,0,24,24
"54471",2020,0,0,24,24
"54472",2020,0,0,24,24
"54473",2020,0,0,24,24
"54474",2020,0,0,24,24
"54475",2020,0,0,24,24
"54476",2020,0,0,24,24
"54477",2020,0,0,24,24
"54478",2020,0,0,24,24
"54479",2020,0,0,24,24
"54480",2020,0,0,24,24
"54481",2020,0,0,24,24
"54482",2020,0,0,24,24
"54483",2020,0,0,24,24
"54484",2020,0,0,24,24
"54485",2020,0,0,24,24
"54486",2020,0,0,24,24
"54487",2020,0,0,24,24
"54488",2020,0,0,24,24
"54489",2020,0,0,24,24
"54490",2020,0,0,24,24
"54491",2020,0,0,24,24
"54492",2020,0,0,24,24
"54493",2020,0,0,24,24
"54494",2020,0,0,24,24
"54495",2020,0,0,24,24
"54496",2020,0,0,24,24
"54497",2020,0,0,24,24
"54498",2020,0,0,24,24
"54499",2020,0,0,24,24
"54500",2020,0,0,24,24
"54501",2020,0,0,24,24
"54502",2020,0,0,24,24
"54504",2020,0,0,24,24
"54505",2020,0,0,24,24
"54507",2020,0,0,24,24
"54508",2020,0,0,24,24
"54509",2020,0,0,24,24
"54510",2020,0,0,24,24
"54511",2020,0,0,24,24
"54512",2020,0,0,24,24
"54513",2020,0,0,24,24
"54514",2020,0,0,24,24
"54515",2020,0,0,24,24
"54516",2020,0,0,24,24
"54517",2020,0,0,24,24
"54518",2020,0,0,24,24
"54519",2020,0,0,24,24
"54520",2020,0,0,24,24
"54521",2020,0,0,24,24
"54522",2020,0,0,24,24
"54523",2020,0,0,24,24
"54524",2020,0,0,24,24
"54525",2020,0,0,24,24
"54526",2020,0,0,24,24
"54527",2020,0,0,24,24
"54528",2020,0,0,24,24
"54529",2020,0,0,24,24
"54530",2020,0,0,24,24
"54531",2020,0,0,24,24
"54532",2020,0,0,24,24
"54533",2020,0,0,24,24
"54534",2020,0,0,24,24
"54535",2020,0,0,24,24
"54536",2020,0,0,24,24
"54537",2020,0,0,24,24
"54538",2020,0,0,24,24
"54539",2020,0,0,24,24
"54540",2020,0,0,24,24
"54541",2020,0,0,24,24
"54542",2020,0,0,24,24
"54543",2020,0,0,24,24
"54544",2020,0,0,24,24
"54545",2020,0,0,24,24
"54546",2020,0,0,24,24
"54547",2020,0,0,24,24
"54548",2020,0,0,24,24
"54549",2020,0,0,24,24
"54550",2020,0,0,24,24
"54551",2020,0,0,24,24
"54552",2020,0,0,24,24
"54553",2020,0,0,24,24
"54554",2020,0,0,24,24
"54555",2020,0,0,24,24
"54556",2020,0,0,24,24
"54557",2020,0,0,24,24
"54558",2020,0,0,24,24
"54559",2020,0,0,24,24
"54560",2020,0,0,24,24
"54561",2020,0,0,24,24
"54562",2020,0,0,24,24
"54563",2020,0,0,24,24
"54564",2020,0,0,24,24
"54565",2020,0,0,24,24
"54566",2020,0,0,24,24
"54567",2020,0,0,24,24
"54568",2020,0,0,24,24
"54569",2020,0,0,24,24
"54570",2020,0,0,24,24
"54571",2020,0,0,24,24
"54572",2020,0,0,24,24
"54573",2020,0,0,24,24
"54574",2020,0,0,24,24
"54575",2020,0,0,24,24
"54576",2020,0,0,24,24
"54577",2020,0,0,24,24
"54578",2020,0,0,24,24
"54579",2020,0,0,24,24
"54580",2020,0,0,24,24
"54581",2020,0,0,24,24
"54582",2020,0,0,24,24
"54583",2020,0,0,24,24
"54584",2020,0,0,24,24
"54585",2020,0,0,24,24
"54586",2020,0,0,24,24
"54587",2020,0,0,24,24
"54588",2020,0,0,24,24
"54589",2020,0,0,24,24
"54590",2020,0,0,24,24
"54591",2020,0,0,24,24
"54592",2020,0,0,24,24
"54593",2020,0,0,24,24
"54594",2020,0,0,24,24
"54595",2020,0,0,24,24
"54596",2020,0,0,24,24
"54597",2020,0,0,24,24
"54598",2020,0,0,24,24
"54599",2020,0,0,24,24
"54600",2020,0,0,24,24
"54601",2020,0,0,24,24
"54602",2020,0,0,24,24
"55001",2017,0,0,17,17
"55002",2017,0,0,17,17
"55004",2017,0,0,17,17
"55005",2017,0,0,17,17
"55007",2017,0,0,17,17
"55008",2017,0,0,17,17
"55009",2017,0,0,17,17
"55010",2017,0,0,17,17
"55011",2017,0,0,17,17
"55012",2017,0,0,17,17
"55013",2017,0,0,17,17
"55014",2017,0,0,17,17
"55015",2017,0,0,17,17
"55017",2017,0,0,17,17
"55018",2017,0,0,17,17
"55021",2017,0,0,17,17
"55022",2017,0,0,17,17
"55023",2017,0,0,17,17
"55024",2017,0,0,17,17
"55025",2017,0,0,17,17
"55026",2017,0,0,17,17
"55027",2017,0,0,17,17
"55028",2017,0,0,17,17
"55029",2017,0,0,17,17
"55031",2017,0,0,17,17
"55032",2017,0,0,17,17
"55033",2017,0,0,17,17
"55034",2017,0,0,17,17
"55035",2017,0,0,17,17
"55036",2017,0,0,17,17
"55037",2017,0,0,17,17
"55038",2017,0,0,17,17
"55039",2017,0,0,17,17
"55040",2017,0,0,17,17
"55041",2017,0,0,17,17
"55042",2017,0,0,17,17
"55043",2017,0,0,17,17
"55044",2017,0,0,17,17
"55045",2017,0,0,17,17
"55046",2017,0,0,17,17
"55047",2017,0,0,17,17
"55048",2017,0,0,17,17
"55049",2017,0,0,17,17
"55050",2017,0,0,17,17
"55051",2017,0,0,17,17
"55053",2017,0,0,17,17
"55054",2017,0,0,17,17
"55055",2017,0,0,17,17
"55057",2017,0,0,17,17
"55058",2017,0,0,17,17
"55059",2017,0,0,17,17
"55060",2017,0,0,17,17
"55061",2017,0,0,17,17
"55062",2017,0,0,17,17
"55063",2017,0,0,17,17
"55064",2017,0,0,17,17
"55065",2017,0,0,17,17
"55066",2017,0,0,17,17
"55067",2017,0,0,17,17
"55068",2017,0,0,17,17
"55069",2017,0,0,17,17
"55070",2017,0,0,17,17
"55071",2017,0,0,17,17
"55072",2017,0,0,17,17
"55073",2017,0,0,17,17
"55075",2017,0,0,17,17
"55076",2017,0,0,17,17
"55077",2017,0,0,17,17
"55078",2017,0,0,17,17
"55079",2017,0,0,17,17
"55080",2017,0,0,17,17
"55081",2017,0,0,17,17
"55082",2017,0,0,17,17
"55083",2017,0,0,17,17
"55084",2017,0,0,17,17
"55085",2017,0,0,17,17
"55087",2017,0,0,17,17
"55088",2017,0,0,17,17
"55089",2017,0,0,17,17
"55093",2017,0,0,17,17
"55094",2017,0,0,17,17
"55095",2017,0,0,17,17
"55096",2017,0,0,17,17
"55097",2017,0,0,17,17
"55099",2017,0,0,17,17
"55100",2017,0,0,17,17
"55101",2017,0,0,17,17
"55102",2017,0,0,17,17
"55103",2017,0,0,17,17
"55104",2017,0,0,17,17
"55105",2017,0,0,17,17
"55106",2017,0,0,17,17
"55107",2017,0,0,17,17
"55108",2017,0,0,17,17
"55109",2017,0,0,17,17
"55110",2017,0,0,17,17
"55111",2017,0,0,17,17
"55113",2017,0,0,17,17
"55114",2017,0,0,17,17
"55115",2017,0,0,17,17
"55116",2017,0,0,17,17
"55117",2017,0,0,17,17
"55118",2017,0,0,17,17
"55119",2017,0,0,17,17
"55120",2017,0,0,17,17
"55121",2017,0,0,17,17
"55122",2017,0,0,17,17
"55123",2017,0,0,17,17
"55124",2017,0,0,17,17
"55125",2017,0,0,17,17
"55127",2017,0,0,17,17
"55128",2017,0,0,17,17
"55129",2017,0,0,17,17
"55132",2017,0,0,17,17
"55133",2017,0,0,17,17
"55134",2017,0,0,17,17
"55137",2017,0,0,17,17
"55138",2017,0,0,17,17
"55139",2017,0,0,17,17
"55140",2017,0,0,17,17
"55141",2017,0,0,17,17
"55142",2017,0,0,17,17
"55143",2017,0,0,17,17
"55144",2017,0,0,17,17
"55145",2017,0,0,17,17
"55146",2017,0,0,17,17
"55148",2017,0,0,17,17
"55149",2017,0,0,17,17
"55150",2017,0,0,17,17
"55153",2017,0,0,17,17
"55154",2017,0,0,17,17
"55155",2017,0,0,17,17
"55156",2017,0,0,17,17
"55157",2017,0,0,17,17
"55158",2017,0,0,17,17
"55159",2017,0,0,17,17
"55160",2017,0,0,17,17
"55162",2017,0,0,17,17
"55163",2017,0,0,17,17
"55165",2017,0,0,17,17
"55166",2017,0,0,17,17
"55167",2017,0,0,17,17
"55168",2017,0,0,17,17
"55169",2017,0,0,17,17
"55170",2017,0,0,17,17
"55171",2017,0,0,17,17
"55172",2017,0,0,17,17
"55173",2017,0,0,17,17
"55174",2017,0,0,17,17
"55175",2017,0,0,17,17
"55177",2017,0,0,17,17
"55178",2017,0,0,17,17
"55179",2017,0,0,17,17
"55180",2017,0,0,17,17
"55181",2017,0,0,17,17
"55182",2017,0,0,17,17
"55183",2017,0,0,17,17
"55184",2017,0,0,17,17
"55185",2017,0,0,17,17
"55186",2017,0,0,17,17
"55188",2017,0,0,17,17
"55189",2017,0,0,17,17
"55191",2017,0,0,17,17
"55192",2017,0,0,17,17
"55193",2017,0,0,17,17
"55194",2017,0,0,17,17
"55195",2017,0,0,17,17
"55196",2017,0,0,17,17
"55197",2017,0,0,17,17
"55198",2017,0,0,17,17
"55199",2017,0,0,17,17
"55200",2017,0,0,17,17
"55201",2017,0,0,17,17
"55202",2017,0,0,17,17
"55204",2017,0,0,17,17
"55206",2017,0,0,17,17
"55207",2017,0,0,17,17
"55208",2017,0,0,17,17
"55210",2017,0,0,17,17
"55211",2017,0,0,17,17
"55212",2017,0,0,17,17
"55214",2017,0,0,17,17
"55215",2017,0,0,17,17
"55216",2017,0,0,17,17
"55217",2017,0,0,17,17
"55218",2017,0,0,17,17
"55219",2017,0,0,17,17
"55220",2017,0,0,17,17
"55221",2017,0,0,17,17
"55222",2017,0,0,17,17
"55224",2017,0,0,17,17
"55225",2017,0,0,17,17
"55226",2017,0,0,17,17
"55228",2017,0,0,17,17
"55229",2017,0,0,17,17
"55232",2017,0,0,17,17
"55236",2017,0,0,17,17
"55237",2017,0,0,17,17
"55239",2017,0,0,17,17
"55241",2017,0,0,17,17
"55242",2017,0,0,17,17
"55243",2017,0,0,17,17
"55244",2017,0,0,17,17
"55245",2017,0,0,17,17
"55246",2017,0,0,17,17
"55247",2017,0,0,17,17
"55248",2017,0,0,17,17
"55250",2017,0,0,17,17
"55251",2017,0,0,17,17
"55252",2017,0,0,17,17
"55253",2017,0,0,17,17
"55254",2017,0,0,17,17
"55255",2017,0,0,17,17
"55256",2017,0,0,17,17
"55257",2017,0,0,17,17
"55258",2017,0,0,17,17
"55260",2017,0,0,17,17
"55261",2017,0,0,17,17
"55262",2017,0,0,17,17
"55263",2017,0,0,17,17
"55264",2017,0,0,17,17
"55265",2017,0,0,17,17
"55266",2017,0,0,17,17
"55267",2017,0,0,17,17
"55268",2017,0,0,17,17
"55269",2017,0,0,17,17
"55270",2017,0,0,17,17
"55271",2017,0,0,17,17
"55272",2017,0,0,17,17
"55274",2017,0,0,17,17
"55275",2017,0,0,17,17
"55276",2017,0,0,17,17
"55278",2017,0,0,17,17
"55279",2017,0,0,17,17
"55280",2017,0,0,17,17
"55281",2017,0,0,17,17
"55282",2017,0,0,17,17
"55284",2017,0,0,17,17
"55285",2017,0,0,17,17
"55286",2017,0,0,17,17
"55288",2017,0,0,17,17
"55289",2017,0,0,17,17
"55290",2017,0,0,17,17
"55291",2017,0,0,17,17
"55292",2017,0,0,17,17
"55293",2017,0,0,17,17
"55295",2017,0,0,17,17
"55296",2017,0,0,17,17
"55297",2017,0,0,17,17
"55298",2017,0,0,17,17
"55299",2017,0,0,17,17
"55300",2017,0,0,17,17
"55301",2017,0,0,17,17
"55302",2017,0,0,17,17
"55303",2017,0,0,17,17
"55304",2017,0,0,17,17
"55306",2017,0,0,17,17
"55307",2017,0,0,17,17
"55310",2017,0,0,17,17
"55311",2017,0,0,17,17
"55312",2017,0,0,17,17
"55313",2017,0,0,17,17
"55315",2017,0,0,17,17
"55316",2017,0,0,17,17
"55317",2017,0,0,17,17
"55320",2017,0,0,17,17
"55321",2017,0,0,17,17
"55322",2017,0,0,17,17
"55323",2017,0,0,17,17
"55324",2017,0,0,17,17
"55325",2017,0,0,17,17
"55326",2017,0,0,17,17
"55327",2017,0,0,17,17
"55328",2017,0,0,17,17
"55329",2017,0,0,17,17
"55330",2017,0,0,17,17
"55331",2017,0,0,17,17
"55332",2017,0,0,17,17
"55333",2017,0,0,17,17
"55334",2017,0,0,17,17
"55335",2017,0,0,17,17
"55336",2017,0,0,17,17
"55338",2017,0,0,17,17
"55339",2017,0,0,17,17
"55340",2017,0,0,17,17
"55341",2017,0,0,17,17
"55343",2017,0,0,17,17
"55344",2017,0,0,17,17
"55345",2017,0,0,17,17
"55346",2017,0,0,17,17
"55347",2017,0,0,17,17
"55348",2017,0,0,17,17
"55349",2017,0,0,17,17
"55350",2017,0,0,17,17
"55351",2017,0,0,17,17
"55352",2017,0,0,17,17
"55353",2017,0,0,17,17
"55355",2017,0,0,17,17
"55356",2017,0,0,17,17
"55357",2017,0,0,17,17
"55358",2017,0,0,17,17
"55359",2017,0,0,17,17
"55360",2017,0,0,17,17
"55361",2017,0,0,17,17
"55362",2017,0,0,17,17
"55363",2017,0,0,17,17
"55364",2017,0,0,17,17
"55365",2017,0,0,17,17
"55366",2017,0,0,17,17
"55367",2017,0,0,17,17
"55368",2017,0,0,17,17
"55369",2017,0,0,17,17
"55370",2017,0,0,17,17
"55371",2017,0,0,17,17
"55372",2017,0,0,17,17
"55373",2017,0,0,17,17
"55374",2017,0,0,17,17
"55375",2017,0,0,17,17
"55376",2017,0,0,17,17
"55377",2017,0,0,17,17
"55378",2017,0,0,17,17
"55379",2017,0,0,17,17
"55380",2017,0,0,17,17
"55381",2017,0,0,17,17
"55382",2017,0,0,17,17
"55383",2017,0,0,17,17
"55384",2017,0,0,17,17
"55385",2017,0,0,17,17
"55386",2017,0,0,17,17
"55387",2017,0,0,17,17
"55388",2017,0,0,17,17
"55389",2017,0,0,17,17
"55391",2017,0,0,17,17
"55394",2017,0,0,17,17
"55395",2017,0,0,17,17
"55396",2017,0,0,17,17
"55397",2017,0,0,17,17
"55398",2017,0,0,17,17
"55399",2017,0,0,17,17
"55400",2017,0,0,17,17
"55401",2017,0,0,17,17
"55403",2017,0,0,17,17
"55404",2017,0,0,17,17
"55405",2017,0,0,17,17
"55406",2017,0,0,17,17
"55407",2017,0,0,17,17
"55408",2017,0,0,17,17
"55409",2017,0,0,17,17
"55410",2017,0,0,17,17
"55411",2017,0,0,17,17
"55412",2017,0,0,17,17
"55414",2017,0,0,17,17
"55415",2017,0,0,17,17
"55416",2017,0,0,17,17
"55419",2017,0,0,17,17
"55420",2017,0,0,17,17
"55421",2017,0,0,17,17
"55422",2017,0,0,17,17
"55423",2017,0,0,17,17
"55424",2017,0,0,17,17
"55425",2017,0,0,17,17
"55426",2017,0,0,17,17
"55427",2017,0,0,17,17
"55428",2017,0,0,17,17
"55429",2017,0,0,17,17
"55430",2017,0,0,17,17
"55431",2017,0,0,17,17
"55433",2017,0,0,17,17
"55434",2017,0,0,17,17
"55435",2017,0,0,17,17
"55436",2017,0,0,17,17
"55437",2017,0,0,17,17
"55438",2017,0,0,17,17
"55439",2017,0,0,17,17
"55442",2017,0,0,17,17
"55443",2017,0,0,17,17
"55444",2017,0,0,17,17
"55445",2017,0,0,17,17
"55446",2017,0,0,17,17
"55447",2017,0,0,17,17
"55448",2017,0,0,17,17
"55449",2017,0,0,17,17
"55450",2017,0,0,17,17
"55452",2017,0,0,17,17
"55453",2017,0,0,17,17
"55454",2017,0,0,17,17
"55456",2017,0,0,17,17
"55457",2017,0,0,17,17
"55458",2017,0,0,17,17
"55459",2017,0,0,17,17
"55460",2017,0,0,17,17
"55461",2017,0,0,17,17
"55462",2017,0,0,17,17
"55463",2017,0,0,17,17
"55464",2017,0,0,17,17
"55465",2017,0,0,17,17
"55466",2017,0,0,17,17
"55467",2017,0,0,17,17
"55468",2017,0,0,17,17
"55469",2017,0,0,17,17
"55470",2017,0,0,17,17
"55471",2017,0,0,17,17
"55472",2017,0,0,17,17
"55473",2017,0,0,17,17
"55474",2017,0,0,17,17
"55475",2017,0,0,17,17
"55476",2017,0,0,17,17
"55477",2017,0,0,17,17
"55479",2017,0,0,17,17
"55481",2017,0,0,17,17
"55482",2017,0,0,17,17
"55484",2017,0,0,17,17
"55485",2017,0,0,17,17
"55487",2017,0,0,17,17
"55488",2017,0,0,17,17
"55489",2017,0,0,17,17
"55490",2017,0,0,17,17
"55492",2017,0,0,17,17
"55493",2017,0,0,17,17
"55494",2017,0,0,17,17
"55495",2017,0,0,17,17
"55496",2017,0,0,17,17
"55497",2017,0,0,17,17
"55498",2017,0,0,17,17
"55500",2017,0,0,17,17
"55501",2017,0,0,17,17
"55502",2017,0,0,17,17
"55503",2017,0,0,17,17
"55504",2017,0,0,17,17
"55505",2017,0,0,17,17
"55506",2017,0,0,17,17
"55507",2017,0,0,17,17
"55508",2017,0,0,17,17
"55509",2017,0,0,17,17
"55510",2017,0,0,17,17
"55511",2017,0,0,17,17
"55512",2017,0,0,17,17
"55514",2017,0,0,17,17
"55515",2017,0,0,17,17
"55516",2017,0,0,17,17
"55517",2017,0,0,17,17
"55518",2017,0,0,17,17
"55519",2017,0,0,17,17
"55520",2017,0,0,17,17
"55521",2017,0,0,17,17
"55522",2017,0,0,17,17
"55523",2017,0,0,17,17
"55525",2017,0,0,17,17
"55526",2017,0,0,17,17
"55527",2017,0,0,17,17
"55528",2017,0,0,17,17
"55530",2017,0,0,17,17
"55531",2017,0,0,17,17
"55532",2017,0,0,17,17
"55533",2017,0,0,17,17
"55534",2017,0,0,17,17
"55535",2017,0,0,17,17
"55536",2017,0,0,17,17
"55537",2017,0,0,17,17
"55540",2017,0,0,17,17
"55541",2017,0,0,17,17
"55543",2017,0,0,17,17
"55544",2017,0,0,17,17
"55545",2017,0,0,17,17
"55546",2017,0,0,17,17
"55547",2017,0,0,17,17
"55549",2017,0,0,17,17
"55551",2017,0,0,17,17
"55552",2017,0,0,17,17
"55553",2017,0,0,17,17
"55554",2017,0,0,17,17
"55555",2017,0,0,17,17
"55556",2017,0,0,17,17
"55557",2017,0,0,17,17
"55559",2017,0,0,17,17
"55560",2017,0,0,17,17
"55561",2017,0,0,17,17
"55562",2017,0,0,17,17
"55563",2017,0,0,17,17
"55565",2017,0,0,17,17
"55566",2017,0,0,17,17
"55567",2017,0,0,17,17
"55568",2017,0,0,17,17
"55569",2017,0,0,17,17
"55570",2017,0,0,17,17
"55571",2017,0,0,17,17
"55572",2017,0,0,17,17
"55573",2017,0,0,17,17
"55574",2017,0,0,17,17
"55575",2017,0,0,17,17
"55577",2017,0,0,17,17
"55578",2017,0,0,17,17
"55579",2017,0,0,17,17
"55580",2017,0,0,17,17
"55581",2017,0,0,17,17
"55582",2017,0,0,17,17
"55583",2017,0,0,17,17
"55584",2017,0,0,17,17
"55586",2017,0,0,17,17
"56001",2020,0,0,27,27
"56002",2020,0,0,27,27
"56003",2020,0,0,27,27
"56004",2020,0,0,27,27
"56005",2020,0,0,27,27
"56006",2020,0,0,27,27
"56007",2020,0,0,27,27
"56008",2020,0,0,27,27
"56009",2020,0,0,27,27
"56010",2020,0,0,27,27
"56011",2020,0,0,27,27
"56012",2020,0,0,27,27
"56013",2020,0,0,27,27
"56014",2020,0,0,27,27
"56015",2020,0,0,27,27
"56017",2020,0,0,27,27
"56018",2020,0,0,27,27
"56019",2020,0,0,27,27
"56020",2020,0,0,27,27
"56021",2020,0,0,27,27
"56022",2020,0,0,27,27
"56023",2020,0,0,27,27
"56024",2020,0,0,27,27
"56025",2020,0,0,27,27
"56026",2020,0,0,27,27
"56027",2020,0,0,27,27
"56028",2020,0,0,27,27
"56029",2020,0,0,27,27
"56030",2020,0,0,27,27
"56031",2020,0,0,27,27
"56032",2020,0,0,27,27
"56033",2020,0,0,27,27
"56034",2020,0,0,27,27
"56035",2020,0,0,27,27
"56036",2020,0,0,27,27
"56039",2020,0,0,27,27
"56040",2020,0,0,27,27
"56041",2020,0,0,27,27
"56042",2020,0,0,27,27
"56043",2020,0,0,27,27
"56044",2020,0,0,27,27
"56045",2020,0,0,27,27
"56046",2020,0,0,27,27
"56047",2020,0,0,27,27
"56048",2020,0,0,27,27
"56050",2020,0,0,27,27
"56051",2020,0,0,27,27
"56052",2020,0,0,27,27
"56053",2020,0,0,27,27
"56054",2020,0,0,27,27
"56055",2020,0,0,27,27
"56056",2020,0,0,27,27
"56057",2020,0,0,27,27
"56058",2020,0,0,27,27
"56060",2020,0,0,27,27
"56061",2020,0,0,27,27
"56062",2020,0,0,27,27
"56063",2020,0,0,27,27
"56065",2020,0,0,27,27
"56066",2020,0,0,27,27
"56067",2020,0,0,27,27
"56068",2020,0,0,27,27
"56069",2020,0,0,27,27
"56070",2020,0,0,27,27
"56071",2020,0,0,27,27
"56072",2020,0,0,27,27
"56073",2020,0,0,27,27
"56074",2020,0,0,27,27
"56075",2020,0,0,27,27
"56076",2020,0,0,27,27
"56077",2020,0,0,27,27
"56078",2020,0,0,27,27
"56079",2020,0,0,27,27
"56080",2020,0,0,27,27
"56081",2020,0,0,27,27
"56082",2020,0,0,27,27
"56083",2020,0,0,27,27
"56084",2020,0,0,27,27
"56085",2020,0,0,27,27
"56086",2020,0,0,27,27
"56087",2020,0,0,27,27
"56088",2020,0,0,27,27
"56089",2020,0,0,27,27
"56090",2020,0,0,27,27
"56091",2020,0,0,27,27
"56092",2020,0,0,27,27
"56093",2020,0,0,27,27
"56094",2020,0,0,27,27
"56096",2020,0,0,27,27
"56097",2020,0,0,27,27
"56098",2020,0,0,27,27
"56099",2020,0,0,27,27
"56100",2020,0,0,27,27
"56101",2020,0,0,27,27
"56102",2020,0,0,27,27
"56103",2020,0,0,27,27
"56104",2020,0,0,27,27
"56105",2020,0,0,27,27
"56106",2020,0,0,27,27
"56107",2020,0,0,27,27
"56108",2020,0,0,27,27
"56109",2020,0,0,27,27
"56110",2020,0,0,27,27
"56111",2020,0,0,27,27
"56112",2020,0,0,27,27
"56113",2020,0,0,27,27
"56114",2020,0,0,27,27
"56115",2020,0,0,27,27
"56116",2020,0,0,27,27
"56117",2020,0,0,27,27
"56118",2020,0,0,27,27
"56119",2020,0,0,27,27
"56120",2020,0,0,27,27
"56121",2020,0,0,27,27
"56122",2020,0,0,27,27
"56123",2020,0,0,27,27
"56124",2020,0,0,27,27
"56125",2020,0,0,27,27
"56126",2020,0,0,27,27
"56127",2020,0,0,27,27
"56128",2020,0,0,27,27
"56129",2020,0,0,27,27
"56130",2020,0,0,27,27
"56131",2020,0,0,27,27
"56132",2020,0,0,27,27
"56133",2020,0,0,27,27
"56134",2020,0,0,27,27
"56135",2020,0,0,27,27
"56136",2020,0,0,27,27
"56137",2020,0,0,27,27
"56139",2020,0,0,27,27
"56140",2020,0,0,27,27
"56141",2020,0,0,27,27
"56143",2020,0,0,27,27
"56144",2020,0,0,27,27
"56145",2020,0,0,27,27
"56146",2020,0,0,27,27
"56147",2020,0,0,27,27
"56148",2020,0,0,27,27
"56149",2020,0,0,27,27
"56151",2020,0,0,27,27
"56152",2020,0,0,27,27
"56153",2020,0,0,27,27
"56154",2020,0,0,27,27
"56155",2020,0,0,27,27
"56156",2020,0,0,27,27
"56157",2020,0,0,27,27
"56158",2020,0,0,27,27
"56159",2020,0,0,27,27
"56160",2020,0,0,27,27
"56161",2020,0,0,27,27
"56162",2020,0,0,27,27
"56163",2020,0,0,27,27
"56164",2020,0,0,27,27
"56165",2020,0,0,27,27
"56166",2020,0,0,27,27
"56167",2020,0,0,27,27
"56168",2020,0,0,27,27
"56169",2020,0,0,27,27
"56170",2020,0,0,27,27
"56171",2020,0,0,27,27
"56172",2020,0,0,27,27
"56173",2020,0,0,27,27
"56174",2020,0,0,27,27
"56175",2020,0,0,27,27
"56176",2020,0,0,27,27
"56177",2020,0,0,27,27
"56178",2020,0,0,27,27
"56179",2020,0,0,27,27
"56180",2020,0,0,27,27
"56181",2020,0,0,27,27
"56182",2020,0,0,27,27
"56184",2020,0,0,27,27
"56185",2020,0,0,27,27
"56186",2020,0,0,27,27
"56188",2020,0,0,27,27
"56189",2020,0,0,27,27
"56190",2020,0,0,27,27
"56191",2020,0,0,27,27
"56193",2020,0,0,27,27
"56194",2020,0,0,27,27
"56195",2020,0,0,27,27
"56196",2020,0,0,27,27
"56197",2020,0,0,27,27
"56198",2020,0,0,27,27
"56199",2020,0,0,27,27
"56200",2020,0,0,27,27
"56201",2020,0,0,27,27
"56202",2020,0,0,27,27
"56203",2020,0,0,27,27
"56204",2020,0,0,27,27
"56205",2020,0,0,27,27
"56206",2020,0,0,27,27
"56207",2020,0,0,27,27
"56208",2020,0,0,27,27
"56209",2020,0,0,27,27
"56210",2020,0,0,27,27
"56211",2020,0,0,27,27
"56212",2020,0,0,27,27
"56213",2020,0,0,27,27
"56214",2020,0,0,27,27
"56215",2020,0,0,27,27
"56216",2020,0,0,27,27
"56218",2020,0,0,27,27
"56219",2020,0,0,27,27
"56220",2020,0,0,27,27
"56221",2020,0,0,27,27
"56222",2020,0,0,27,27
"56223",2020,0,0,27,27
"56224",2020,0,0,27,27
"56225",2020,0,0,27,27
"56226",2020,0,0,27,27
"56227",2020,0,0,27,27
"56228",2020,0,0,27,27
"56229",2020,0,0,27,27
"56230",2020,0,0,27,27
"56231",2020,0,0,27,27
"56232",2020,0,0,27,27
"56233",2020,0,0,27,27
"56234",2020,0,0,27,27
"56236",2020,0,0,27,27
"56237",2020,0,0,27,27
"56238",2020,0,0,27,27
"56239",2020,0,0,27,27
"56240",2020,0,0,27,27
"56241",2020,0,0,27,27
"56242",2020,0,0,27,27
"56243",2020,0,0,27,27
"56244",2020,0,0,27,27
"56245",2020,0,0,27,27
"56246",2020,0,0,27,27
"56247",2020,0,0,27,27
"56248",2020,0,0,27,27
"56249",2020,0,0,27,27
"56250",2020,0,0,27,27
"56251",2020,0,0,27,27
"56252",2020,0,0,27,27
"56253",2020,0,0,27,27
"56254",2020,0,0,27,27
"56255",2020,0,0,27,27
"56256",2020,0,0,27,27
"56257",2020,0,0,27,27
"56258",2020,0,0,27,27
"56259",2020,0,0,27,27
"56260",2020,0,0,27,27
"56261",2020,0,0,27,27
"56262",2020,0,0,27,27
"56263",2020,0,0,27,27
"56264",2020,0,0,27,27
"57003",2017,0,0,23,23
"57003",2018,0,0,32,32
"57006",2017,0,0,23,23
"57006",2018,0,0,32,32
"57011",2017,0,0,23,23
"57011",2018,0,0,32,32
"57013",2017,0,0,23,23
"57013",2018,0,0,32,32
"57033",2017,0,0,23,23
"57033",2018,0,0,32,32
"57034",2017,0,0,23,23
"57034",2018,0,0,32,32
"57046",2017,0,0,23,23
"57046",2018,0,0,32,32
"57050",2017,0,0,23,23
"57050",2018,0,0,32,32
"57056",2017,0,0,23,23
"57056",2018,0,0,32,32
"57058",2017,0,0,23,23
"57058",2018,0,0,32,32
"57061",2017,0,0,23,23
"57061",2018,0,0,32,32
"57064",2017,0,0,23,23
"57064",2018,0,0,32,32
"57065",2017,0,0,23,23
"57065",2018,0,0,32,32
"57066",2017,0,0,23,23
"57066",2018,0,0,32,32
"57069",2017,0,0,23,23
"57069",2018,0,0,32,32
"57071",2017,0,0,23,23
"57071",2018,0,0,32,32
"57073",2017,0,0,23,23
"57073",2018,0,0,32,32
"57074",2017,0,0,23,23
"57074",2018,0,0,32,32
"57080",2017,0,0,23,23
"57080",2018,0,0,32,32
"57083",2017,0,0,23,23
"57083",2018,0,0,32,32
"57089",2017,0,0,23,23
"57089",2018,0,0,32,32
"57091",2017,0,0,23,23
"57091",2018,0,0,32,32
"57092",2017,0,0,23,23
"57092",2018,0,0,32,32
"57093",2017,0,0,23,23
"57093",2018,0,0,32,32
"57100",2017,0,0,23,23
"57100",2018,0,0,32,32
"57101",2017,0,0,23,23
"57101",2018,0,0,32,32
"57103",2017,0,0,23,23
"57103",2018,0,0,32,32
"57108",2017,0,0,23,23
"57108",2018,0,0,32,32
"57113",2017,0,0,23,23
"57113",2018,0,0,32,32
"57114",2017,0,0,23,23
"57114",2018,0,0,32,32
"57119",2017,0,0,23,23
"57119",2018,0,0,32,32
"57123",2017,0,0,23,23
"57123",2018,0,0,32,32
"57144",2017,0,0,23,23
"57144",2018,0,0,32,32
"57160",2017,0,0,23,23
"57160",2018,0,0,32,32
"57163",2017,0,0,23,23
"57163",2018,0,0,32,32
"57165",2017,0,0,23,23
"57165",2018,0,0,32,32
"57168",2017,0,0,23,23
"57168",2018,0,0,32,32
"57169",2017,0,0,23,23
"57169",2018,0,0,32,32
"57175",2017,0,0,23,23
"57175",2018,0,0,32,32
"57176",2017,0,0,23,23
"57176",2018,0,0,32,32
"57178",2017,0,0,23,23
"57178",2018,0,0,32,32
"57180",2017,0,0,23,23
"57180",2018,0,0,32,32
"57188",2017,0,0,23,23
"57188",2018,0,0,32,32
"57192",2017,0,0,23,23
"57192",2018,0,0,32,32
"57195",2017,0,0,23,23
"57195",2018,0,0,32,32
"57196",2017,0,0,23,23
"57196",2018,0,0,32,32
"57197",2017,0,0,23,23
"57197",2018,0,0,32,32
"57201",2017,0,0,23,23
"57201",2018,0,0,32,32
"57202",2017,0,0,23,23
"57202",2018,0,0,32,32
"57205",2017,0,0,23,23
"57205",2018,0,0,32,32
"57207",2017,0,0,23,23
"57207",2018,0,0,32,32
"57210",2017,0,0,23,23
"57210",2018,0,0,32,32
"57216",2017,0,0,23,23
"57216",2018,0,0,32,32
"57222",2017,0,0,23,23
"57222",2018,0,0,32,32
"57227",2017,0,0,23,23
"57227",2018,0,0,32,32
"57229",2017,0,0,5,5
"57232",2017,0,0,23,23
"57232",2018,0,0,32,32
"57233",2017,0,0,23,23
"57233",2018,0,0,32,32
"57234",2017,0,0,23,23
"57234",2018,0,0,32,32
"57240",2017,0,0,23,23
"57240",2018,0,0,32,32
"57244",2017,0,0,23,23
"57244",2018,0,0,32,32
"57248",2017,0,0,23,23
"57248",2018,0,0,32,32
"57250",2017,0,0,23,23
"57250",2018,0,0,32,32
"57253",2017,0,0,23,23
"57253",2018,0,0,32,32
"57255",2017,0,0,23,23
"57255",2018,0,0,32,32
"57258",2017,0,0,23,23
"57258",2018,0,0,32,32
"57260",2017,0,0,23,23
"57260",2018,0,0,32,32
"57261",2017,0,0,23,23
"57261",2018,0,0,32,32
"57263",2017,0,0,23,23
"57263",2018,0,0,32,32
"57264",2017,0,0,23,23
"57264",2018,0,0,32,32
"57267",2017,0,0,23,23
"57267",2018,0,0,32,32
"57274",2017,0,0,23,23
"57274",2018,0,0,32,32
"57278",2017,0,0,23,23
"57278",2018,0,0,32,32
"57280",2017,0,0,23,23
"57280",2018,0,0,32,32
"57288",2017,0,0,23,23
"57288",2018,0,0,32,32
"57289",2017,0,0,23,23
"57289",2018,0,0,32,32
"57291",2017,0,0,23,23
"57291",2018,0,0,32,32
"57294",2017,0,0,23,23
"57294",2018,0,0,32,32
"57298",2017,0,0,23,23
"57298",2018,0,0,32,32
"57299",2017,0,0,23,23
"57299",2018,0,0,32,32
"57300",2017,0,0,23,23
"57300",2018,0,0,32,32
"57301",2017,0,0,23,23
"57301",2018,0,0,32,32
"57302",2017,0,0,5,5
"57304",2017,0,0,23,23
"57304",2018,0,0,32,32
"57308",2017,0,0,23,23
"57308",2018,0,0,32,32
"57310",2017,0,0,23,23
"57310",2018,0,0,32,32
"57314",2017,0,0,23,23
"57314",2018,0,0,32,32
"57315",2017,0,0,23,23
"57315",2018,0,0,32,32
"57317",2017,0,0,23,23
"57317",2018,0,0,32,32
"57318",2017,0,0,23,23
"57318",2018,0,0,32,32
"57320",2017,0,0,23,23
"57320",2018,0,0,32,32
"57321",2017,0,0,23,23
"57321",2018,0,0,32,32
"57324",2017,0,0,23,23
"57324",2018,0,0,32,32
"57325",2017,0,0,23,23
"57325",2018,0,0,32,32
"57330",2017,0,0,23,23
"57330",2018,0,0,32,32
"57332",2017,0,0,23,23
"57332",2018,0,0,32,32
"57333",2017,0,0,23,23
"57333",2018,0,0,32,32
"57334",2017,0,0,23,23
"57334",2018,0,0,32,32
"57335",2017,0,0,23,23
"57335",2018,0,0,32,32
"57336",2017,0,0,23,23
"57336",2018,0,0,32,32
"57338",2017,0,0,23,23
"57338",2018,0,0,32,32
"57339",2017,0,0,23,23
"57339",2018,0,0,32,32
"57340",2017,0,0,23,23
"57340",2018,0,0,32,32
"57342",2017,0,0,5,5
"57344",2017,0,0,23,23
"57344",2018,0,0,32,32
"57346",2017,0,0,23,23
"57346",2018,0,0,32,32
"57347",2017,0,0,23,23
"57347",2018,0,0,32,32
"57348",2017,0,0,23,23
"57348",2018,0,0,32,32
"57355",2017,0,0,23,23
"57355",2018,0,0,32,32
"57357",2017,0,0,23,23
"57357",2018,0,0,32,32
"57360",2017,0,0,23,23
"57360",2018,0,0,32,32
"57362",2017,0,0,23,23
"57362",2018,0,0,32,32
"57366",2017,0,0,23,23
"57366",2018,0,0,32,32
"57374",2017,0,0,23,23
"57374",2018,0,0,32,32
"57376",2017,0,0,23,23
"57376",2018,0,0,32,32
"57377",2017,0,0,23,23
"57377",2018,0,0,32,32
"57380",2017,0,0,23,23
"57380",2018,0,0,32,32
"57382",2017,0,0,23,23
"57382",2018,0,0,32,32
"57390",2017,0,0,23,23
"57390",2018,0,0,32,32
"57393",2017,0,0,23,23
"57393",2018,0,0,32,32
"57394",2017,0,0,23,23
"57394",2018,0,0,32,32
"57402",2017,0,0,23,23
"57402",2018,0,0,32,32
"57407",2017,0,0,23,23
"57407",2018,0,0,32,32
"57408",2017,0,0,23,23
"57408",2018,0,0,32,32
"57410",2017,0,0,23,23
"57410",2018,0,0,32,32
"57414",2017,0,0,23,23
"57414",2018,0,0,32,32
"57419",2017,0,0,23,23
"57419",2018,0,0,32,32
"57421",2017,0,0,23,23
"57421",2018,0,0,32,32
"57427",2017,0,0,23,23
"57427",2018,0,0,32,32
"57456",2017,0,0,23,23
"57456",2018,0,0,32,32
"57460",2017,0,0,23,23
"57460",2018,0,0,32,32
"57461",2017,0,0,23,23
"57461",2018,0,0,32,32
"57462",2017,0,0,23,23
"57462",2018,0,0,32,32
"57466",2017,0,0,23,23
"57466",2018,0,0,32,32
"57468",2017,0,0,23,23
"57468",2018,0,0,32,32
"57469",2017,0,0,23,23
"57469",2018,0,0,32,32
"57470",2017,0,0,23,23
"57470",2018,0,0,32,32
"57477",2017,0,0,23,23
"57477",2018,0,0,32,32
"57478",2017,0,0,23,23
"57478",2018,0,0,32,32
"57484",2017,0,0,23,23
"57484",2018,0,0,32,32
"57489",2017,0,0,23,23
"57489",2018,0,0,32,32
"57494",2017,0,0,23,23
"57494",2018,0,0,32,32
"57496",2017,0,0,23,23
"57496",2018,0,0,32,32
"57497",2017,0,0,23,23
"57497",2018,0,0,32,32
"57499",2017,0,0,23,23
"57499",2018,0,0,32,32
"57500",2017,0,0,23,23
"57500",2018,0,0,32,32
"57501",2017,0,0,23,23
"57501",2018,0,0,32,32
"57504",2017,0,0,23,23
"57504",2018,0,0,32,32
"57505",2017,0,0,23,23
"57505",2018,0,0,32,32
"57506",2017,0,0,23,23
"57506",2018,0,0,32,32
"57509",2017,0,0,23,23
"57509",2018,0,0,32,32
"57513",2017,0,0,23,23
"57513",2018,0,0,32,32
"57514",2017,0,0,23,23
"57514",2018,0,0,32,32
"57517",2017,0,0,23,23
"57517",2018,0,0,32,32
"57518",2017,0,0,23,23
"57518",2018,0,0,32,32
"57521",2017,0,0,23,23
"57521",2018,0,0,32,32
"57526",2017,0,0,23,23
"57526",2018,0,0,32,32
"57535",2017,0,0,23,23
"57535",2018,0,0,32,32
"57536",2017,0,0,23,23
"57536",2018,0,0,32,32
"57537",2017,0,0,23,23
"57537",2018,0,0,32,32
"57540",2017,0,0,23,23
"57540",2018,0,0,32,32
"57541",2017,0,0,23,23
"57541",2018,0,0,32,32
"57544",2017,0,0,23,23
"57544",2018,0,0,32,32
"57550",2017,0,0,23,23
"57550",2018,0,0,32,32
"57551",2017,0,0,23,23
"57551",2018,0,0,32,32
"57556",2017,0,0,23,23
"57556",2018,0,0,32,32
"57561",2017,0,0,23,23
"57561",2018,0,0,32,32
"57564",2017,0,0,5,5
"57566",2017,0,0,23,23
"57566",2018,0,0,32,32
"57568",2017,0,0,23,23
"57568",2018,0,0,32,32
"57571",2017,0,0,23,23
"57571",2018,0,0,32,32
"57573",2017,0,0,23,23
"57573",2018,0,0,32,32
"57577",2017,0,0,23,23
"57577",2018,0,0,32,32
"57579",2017,0,0,23,23
"57579",2018,0,0,32,32
"57581",2017,0,0,23,23
"57581",2018,0,0,32,32
"57583",2017,0,0,5,5
"57584",2017,0,0,23,23
"57584",2018,0,0,32,32
"57589",2017,0,0,23,23
"57589",2018,0,0,32,32
"57590",2017,0,0,23,23
"57590",2018,0,0,32,32
"57592",2017,0,0,23,23
"57592",2018,0,0,32,32
"57594",2017,0,0,23,23
"57594",2018,0,0,32,32
"57596",2017,0,0,23,23
"57596",2018,0,0,32,32
"57598",2017,0,0,23,23
"57598",2018,0,0,32,32
"57606",2017,0,0,23,23
"57606",2018,0,0,32,32
"57611",2017,0,0,5,5
"57613",2017,0,0,23,23
"57613",2018,0,0,32,32
"57614",2017,0,0,23,23
"57614",2018,0,0,32,32
"57615",2017,0,0,23,23
"57615",2018,0,0,32,32
"57618",2017,0,0,23,23
"57618",2018,0,0,32,32
"57619",2017,0,0,23,23
"57619",2018,0,0,32,32
"57623",2017,0,0,23,23
"57623",2018,0,0,32,32
"57628",2017,0,0,23,23
"57628",2018,0,0,32,32
"57629",2017,0,0,23,23
"57629",2018,0,0,32,32
"57630",2017,0,0,23,23
"57630",2018,0,0,32,32
"57631",2017,0,0,23,23
"57631",2018,0,0,32,32
"57633",2017,0,0,23,23
"57633",2018,0,0,32,32
"57635",2017,0,0,23,23
"57635",2018,0,0,32,32
"57636",2017,0,0,23,23
"57636",2018,0,0,32,32
"57637",2017,0,0,23,23
"57637",2018,0,0,32,32
"57638",2017,0,0,23,23
"57638",2018,0,0,32,32
"57639",2017,0,0,23,23
"57639",2018,0,0,32,32
"57641",2017,0,0,23,23
"57641",2018,0,0,32,32
"57651",2017,0,0,23,23
"57651",2018,0,0,32,32
"57658",2017,0,0,23,23
"57658",2018,0,0,32,32
"57659",2017,0,0,23,23
"57659",2018,0,0,32,32
"57660",2017,0,0,23,23
"57660",2018,0,0,32,32
"57661",2017,0,0,23,23
"57661",2018,0,0,32,32
"57665",2017,0,0,23,23
"57665",2018,0,0,32,32
"57669",2017,0,0,23,23
"57669",2018,0,0,32,32
"57675",2017,0,0,23,23
"57675",2018,0,0,32,32
"57680",2017,0,0,23,23
"57680",2018,0,0,32,32
"57682",2017,0,0,23,23
"57682",2018,0,0,32,32
"57685",2017,0,0,23,23
"57685",2018,0,0,32,32
"57696",2017,0,0,23,23
"57696",2018,0,0,32,32
"57697",2017,0,0,23,23
"57697",2018,0,0,32,32
"57703",2017,0,0,23,23
"57703",2018,0,0,32,32
"57709",2017,0,0,23,23
"57709",2018,0,0,32,32
"57711",2017,0,0,23,23
"57711",2018,0,0,32,32
"57713",2017,0,0,23,23
"57713",2018,0,0,32,32
"57721",2017,0,0,23,23
"57721",2018,0,0,32,32
"57723",2017,0,0,23,23
"57723",2018,0,0,32,32
"57725",2017,0,0,23,23
"57725",2018,0,0,32,32
"57732",2017,0,0,23,23
"57732",2018,0,0,32,32
"57734",2017,0,0,23,23
"57734",2018,0,0,32,32
"57738",2017,0,0,23,23
"57738",2018,0,0,32,32
"57741",2017,0,0,23,23
"57741",2018,0,0,32,32
"57742",2017,0,0,23,23
"57742",2018,0,0,32,32
"57743",2017,0,0,23,23
"57743",2018,0,0,32,32
"57745",2017,0,0,23,23
"57745",2018,0,0,32,32
"57746",2017,0,0,23,23
"57746",2018,0,0,32,32
"57747",2017,0,0,23,23
"57747",2018,0,0,32,32
"57748",2017,0,0,23,23
"57748",2018,0,0,32,32
"57750",2017,0,0,23,23
"57750",2018,0,0,32,32
"57752",2017,0,0,23,23
"57752",2018,0,0,32,32
"57756",2017,0,0,23,23
"57756",2018,0,0,32,32
"57760",2017,0,0,23,23
"57760",2018,0,0,32,32
"57761",2017,0,0,23,23
"57761",2018,0,0,32,32
"57765",2017,0,0,23,23
"57765",2018,0,0,32,32
"58001",2016,0,0,40,40
"58001",2018,0,29,0,29
"58001",2019,0,27,42,69
"58002",2016,0,0,40,40
"58002",2018,0,29,0,29
"58002",2019,0,27,15,42
"58003",2017,0,0,42,42
"58003",2018,0,29,0,29
"58003",2019,0,27,42,69
"58003",2020,0,0,32,32
"58004",2016,0,0,40,40
"58004",2017,0,0,86,86
"58004",2018,0,29,15,44
"58004",2019,0,27,15,42
"58004",2020,0,0,20,20
"58005",2018,0,29,0,29
"58005",2019,0,27,15,42
"58006",2016,0,0,40,40
"58006",2017,0,0,86,86
"58006",2018,0,29,0,29
"58006",2019,0,27,42,69
"58006",2020,0,0,20,20
"58007",2016,0,0,40,40
"58007",2018,0,29,0,29
"58007",2019,0,27,15,42
"58008",2018,0,29,29,58
"58008",2019,0,27,55,82
"58009",2016,0,0,40,40
"58009",2018,0,29,20,49
"58009",2019,0,27,15,42
"58009",2020,0,0,20,20
"58010",2017,0,0,86,86
"58010",2018,0,29,20,49
"58010",2019,0,27,42,69
"58010",2020,0,0,20,20
"58011",2018,0,29,29,58
"58011",2019,0,27,55,82
"58012",2016,0,0,40,40
"58012",2018,0,29,0,29
"58012",2019,0,27,15,42
"58013",2016,0,0,40,40
"58013",2018,0,29,20,49
"58013",2019,0,27,15,42
"58014",2016,0,0,40,40
"58014",2018,0,29,20,49
"58014",2019,0,27,15,42
"58015",2018,0,29,0,29
"58015",2019,0,27,15,42
"58016",2018,0,29,29,58
"58016",2019,0,27,55,82
"58017",2016,0,0,40,40
"58017",2018,0,29,0,29
"58017",2019,0,27,42,69
"58018",2016,0,0,40,40
"58018",2018,0,29,20,49
"58018",2019,0,27,15,42
"58019",2017,0,0,61,61
"58019",2018,0,29,0,29
"58019",2019,0,27,15,42
"58019",2020,0,0,20,20
"58020",2017,0,0,42,42
"58020",2018,0,29,0,29
"58020",2019,0,27,0,27
"58021",2017,0,0,42,42
"58021",2018,0,29,0,29
"58021",2019,0,27,0,27
"58023",2018,0,29,29,58
"58023",2019,0,27,42,69
"58024",2016,0,0,40,40
"58024",2017,0,0,25,25
"58024",2018,0,29,0,29
"58024",2019,0,27,42,69
"58025",2018,0,29,105,134
"58025",2019,0,27,55,82
"58025",2020,0,0,96,96
"58026",2018,0,29,0,29
"58026",2019,0,27,15,42
"58027",2016,0,0,40,40
"58027",2018,0,29,20,49
"58027",2019,0,27,15,42
"58027",2020,0,0,20,20
"58028",2016,0,0,40,40
"58028",2017,0,0,86,86
"58028",2018,0,29,0,29
"58028",2019,0,27,42,69
"58028",2020,0,0,20,20
"58029",2014,0,0,29,29
"58029",2017,0,0,14,14
"58029",2018,0,29,64,93
"58029",2019,0,27,15,42
"58030",2016,0,0,40,40
"58030",2017,0,0,86,86
"58030",2018,0,29,15,44
"58030",2019,0,27,15,42
"58030",2020,0,0,20,20
"58031",2016,0,0,40,40
"58031",2017,0,0,86,86
"58031",2018,0,29,0,29
"58031",2019,0,27,42,69
"58031",2020,0,0,20,20
"58032",2014,0,0,29,29
"58032",2017,0,0,14,14
"58032",2018,0,29,105,134
"58032",2019,0,27,28,55
"58032",2020,0,0,32,32
"58033",2016,0,0,40,40
"58033",2018,0,29,0,29
"58033",2019,0,27,15,42
"58034",2018,0,29,0,29
"58034",2019,0,27,42,69
"58035",2016,0,0,40,40
"58035",2018,0,29,15,44
"58035",2019,0,27,42,69
"58035",2020,0,0,20,20
"58036",2016,0,0,40,40
"58036",2018,0,29,0,29
"58036",2019,0,27,15,42
"58037",2018,0,29,29,58
"58037",2019,0,27,42,69
"58038",2018,0,29,0,29
"58038",2019,0,27,15,42
"58039",2018,0,29,29,58
"58039",2019,0,27,55,82
"58040",2018,0,29,0,29
"58040",2019,0,27,15,42
"58041",2014,0,0,29,29
"58041",2017,0,0,14,14
"58041",2018,0,29,64,93
"58041",2019,0,27,15,42
"58042",2018,0,29,105,134
"58042",2019,0,27,28,55
"58042",2020,0,0,60,60
"58043",2014,0,0,29,29
"58043",2017,0,0,14,14
"58043",2018,0,29,64,93
"58043",2019,0,27,15,42
"58044",2016,0,0,40,40
"58044",2018,0,29,0,29
"58044",2019,0,27,15,42
"58045",2016,0,0,40,40
"58045",2018,0,29,20,49
"58045",2019,0,27,15,42
"58045",2020,0,0,20,20
"58046",2016,0,0,40,40
"58046",2017,0,0,61,61
"58046",2018,0,29,0,29
"58046",2019,0,27,15,42
"58046",2020,0,0,20,20
"58047",2018,0,29,29,58
"58047",2019,0,27,55,82
"58048",2016,0,0,40,40
"58048",2018,0,29,20,49
"58048",2019,0,27,15,42
"58048",2020,0,0,20,20
"58049",2017,0,0,42,42
"58049",2018,0,29,0,29
"58049",2019,0,27,42,69
"58049",2020,0,0,32,32
"58050",2018,0,29,0,29
"58050",2019,0,27,15,42
"58051",2017,0,0,42,42
"58051",2018,0,29,0,29
"58051",2019,0,27,0,27
"58052",2014,0,0,29,29
"58052",2017,0,0,14,14
"58052",2018,0,29,64,93
"58052",2019,0,27,15,42
"58053",2016,0,0,40,40
"58053",2018,0,29,20,49
"58053",2019,0,27,15,42
"58054",2014,0,0,29,29
"58054",2017,0,0,14,14
"58054",2018,0,29,64,93
"58054",2019,0,27,15,42
"58055",2016,0,0,40,40
"58055",2017,0,0,86,86
"58055",2018,0,29,15,44
"58055",2019,0,27,15,42
"58055",2020,0,0,20,20
"58056",2018,0,29,105,134
"58056",2019,0,27,28,55
"58056",2020,0,0,60,60
"58057",2017,0,0,42,42
"58057",2018,0,29,0,29
"58057",2019,0,27,0,27
"58058",2014,0,0,29,29
"58058",2017,0,0,14,14
"58058",2018,0,29,105,134
"58058",2019,0,27,28,55
"58058",2020,0,0,32,32
"58059",2018,0,29,105,134
"58059",2019,0,27,28,55
"58059",2020,0,0,60,60
"58060",2017,0,0,61,61
"58060",2018,0,29,0,29
"58060",2019,0,27,15,42
"58060",2020,0,0,20,20
"58061",2016,0,0,40,40
"58061",2018,0,29,20,49
"58061",2019,0,27,15,42
"58061",2020,0,0,20,20
"58062",2017,0,0,86,86
"58062",2018,0,29,20,49
"58062",2019,0,27,42,69
"58062",2020,0,0,20,20
"58063",2017,0,0,61,61
"58063",2018,0,29,0,29
"58063",2019,0,27,42,69
"58064",2016,0,0,40,40
"58064",2018,0,29,20,49
"58064",2019,0,27,15,42
"58064",2020,0,0,20,20
"58065",2016,0,0,40,40
"58065",2017,0,0,61,61
"58065",2018,0,29,0,29
"58065",2019,0,27,15,42
"58066",2018,0,29,0,29
"58066",2019,0,27,42,69
"58067",2016,0,0,40,40
"58067",2018,0,29,20,49
"58067",2019,0,27,15,42
"58067",2020,0,0,20,20
"58068",2018,0,29,0,29
"58068",2019,0,27,42,69
"58069",2018,0,29,29,58
"58069",2019,0,27,55,82
"58070",2016,0,0,40,40
"58070",2018,0,29,20,49
"58070",2019,0,27,15,42
"58071",2014,0,0,29,29
"58071",2017,0,0,14,14
"58071",2018,0,29,64,93
"58071",2019,0,27,15,42
"58072",2017,0,0,42,42
"58072",2018,0,29,0,29
"58072",2019,0,27,0,27
"58073",2018,0,29,29,58
"58073",2019,0,27,55,82
"58074",2017,0,0,61,61
"58074",2018,0,29,0,29
"58074",2019,0,27,15,42
"58075",2018,0,29,29,58
"58075",2019,0,27,55,82
"58076",2018,0,29,0,29
"58076",2019,0,27,42,69
"58077",2016,0,0,40,40
"58077",2018,0,29,0,29
"58077",2019,0,27,15,42
"58078",2016,0,0,40,40
"58078",2017,0,0,86,86
"58078",2018,0,29,0,29
"58078",2019,0,27,42,69
"58078",2020,0,0,20,20
"58079",2018,0,29,0,29
"58079",2019,0,27,15,42
"58080",2016,0,0,40,40
"58080",2017,0,0,25,25
"58080",2018,0,29,0,29
"58080",2019,0,27,42,69
"58081",2016,0,0,40,40
"58081",2018,0,29,20,49
"58081",2019,0,27,15,42
"58081",2020,0,0,20,20
"58082",2017,0,0,61,61
"58082",2018,0,29,0,29
"58082",2019,0,27,42,69
"58083",2018,0,29,29,58
"58083",2019,0,27,55,82
"58084",2016,0,0,40,40
"58084",2018,0,29,20,49
"58084",2019,0,27,15,42
"58085",2014,0,0,29,29
"58085",2017,0,0,14,14
"58085",2018,0,29,64,93
"58085",2019,0,27,15,42
"58086",2016,0,0,40,40
"58086",2018,0,29,0,29
"58086",2019,0,27,15,42
"58087",2017,0,0,42,42
"58087",2018,0,29,0,29
"58087",2019,0,27,0,27
"58088",2016,0,0,40,40
"58088",2018,0,29,20,49
"58088",2019,0,27,42,69
"58088",2020,0,0,20,20
"58089",2014,0,0,29,29
"58089",2017,0,0,14,14
"58089",2018,0,29,105,134
"58089",2019,0,27,28,55
"58089",2020,0,0,32,32
"58090",2014,0,0,29,29
"58090",2017,0,0,14,14
"58090",2018,0,29,64,93
"58090",2019,0,27,15,42
"58092",2016,0,0,40,40
"58092",2018,0,29,15,44
"58092",2019,0,27,15,42
"58093",2014,0,0,29,29
"58093",2017,0,0,14,14
"58093",2018,0,29,64,93
"58093",2019,0,27,15,42
"58094",2016,0,0,40,40
"58094",2018,0,29,0,29
"58094",2019,0,27,15,42
"58095",2017,0,0,42,42
"58095",2018,0,29,0,29
"58095",2019,0,27,0,27
"58096",2018,0,29,20,49
"58096",2019,0,27,28,55
"58096",2020,0,0,45,45
"58097",2016,0,0,40,40
"58097",2017,0,0,86,86
"58097",2018,0,29,15,44
"58097",2019,0,27,15,42
"58097",2020,0,0,20,20
"58098",2018,0,29,29,58
"58098",2019,0,27,55,82
"58099",2018,0,29,0,29
"58099",2019,0,27,42,69
"58101",2016,0,0,40,40
"58101",2018,0,29,20,49
"58101",2019,0,27,15,42
"58101",2020,0,0,20,20
"58102",2018,0,29,105,134
"58102",2019,0,27,28,55
"58102",2020,0,0,60,60
"58103",2018,0,29,29,58
"58103",2019,0,27,55,82
"58104",2017,0,0,42,42
"58104",2018,0,29,0,29
"58104",2019,0,27,0,27
"58105",2016,0,0,40,40
"58105",2017,0,0,86,86
"58105",2018,0,29,0,29
"58105",2019,0,27,42,69
"58105",2020,0,0,20,20
"58106",2017,0,0,42,42
"58106",2018,0,29,0,29
"58106",2019,0,27,42,69
"58106",2020,0,0,32,32
"58107",2018,0,29,0,29
"58107",2019,0,27,42,69
"58108",2018,0,29,29,58
"58108",2019,0,27,42,69
"58109",2014,0,0,29,29
"58109",2017,0,0,14,14
"58109",2018,0,29,105,134
"58109",2019,0,27,28,55
"58109",2020,0,0,32,32
"58110",2018,0,29,0,29
"58110",2019,0,27,42,69
"58111",2017,0,0,61,61
"58111",2018,0,29,0,29
"58111",2019,0,27,42,69
"58112",2016,0,0,40,40
"58112",2017,0,0,86,86
"58112",2018,0,29,0,29
"58112",2019,0,27,42,69
"58112",2020,0,0,20,20
"58113",2016,0,0,40,40
"58113",2017,0,0,86,86
"58113",2018,0,29,15,44
"58113",2019,0,27,15,42
"58113",2020,0,0,20,20
"58114",2017,0,0,61,61
"58114",2018,0,29,0,29
"58114",2019,0,27,15,42
"58114",2020,0,0,20,20
"58115",2017,0,0,42,42
"58115",2018,0,29,0,29
"58115",2019,0,27,0,27
"58116",2018,0,29,29,58
"58116",2019,0,27,55,82
"58117",2016,0,0,40,40
"58117",2018,0,29,20,49
"58117",2019,0,27,42,69
"58117",2020,0,0,20,20
"58118",2017,0,0,61,61
"58118",2018,0,29,0,29
"58118",2019,0,27,15,42
"58118",2020,0,0,20,20
"58119",2016,0,0,40,40
"58119",2017,0,0,86,86
"58119",2018,0,29,0,29
"58119",2019,0,27,42,69
"58119",2020,0,0,20,20
"58120",2018,0,29,29,58
"58120",2019,0,27,42,69
"58121",2016,0,0,40,40
"58121",2018,0,29,20,49
"58121",2019,0,27,42,69
"58121",2020,0,0,20,20
"58122",2018,0,29,105,134
"58122",2019,0,27,28,55
"58122",2020,0,0,60,60
"58123",2018,0,29,0,29
"58123",2019,0,27,15,42
"58124",2016,0,0,40,40
"58124",2018,0,29,20,49
"58124",2019,0,27,42,69
"58124",2020,0,0,20,20
"58125",2017,0,0,42,42
"58125",2018,0,29,15,44
"58125",2019,0,27,42,69
"58125",2020,0,0,20,20
"58126",2017,0,0,42,42
"58126",2018,0,29,0,29
"58126",2019,0,27,0,27
"58127",2016,0,0,40,40
"58127",2018,0,29,20,49
"58127",2019,0,27,15,42
"58128",2017,0,0,61,61
"58128",2018,0,29,0,29
"58128",2019,0,27,15,42
"58129",2017,0,0,42,42
"58129",2018,0,29,0,29
"58129",2019,0,27,42,69
"58129",2020,0,0,32,32
"58130",2014,0,0,29,29
"58130",2017,0,0,14,14
"58130",2018,0,29,64,93
"58130",2019,0,27,15,42
"58131",2016,0,0,40,40
"58131",2018,0,29,20,49
"58131",2019,0,27,42,69
"58131",2020,0,0,20,20
"58132",2016,0,0,40,40
"58132",2018,0,29,0,29
"58132",2019,0,27,15,42
"58133",2018,0,29,0,29
"58133",2019,0,27,15,42
"58134",2016,0,0,40,40
"58134",2017,0,0,86,86
"58134",2018,0,29,0,29
"58134",2019,0,27,42,69
"58134",2020,0,0,20,20
"58135",2016,0,0,40,40
"58135",2017,0,0,86,86
"58135",2018,0,29,15,44
"58135",2019,0,27,15,42
"58135",2020,0,0,20,20
"58136",2016,0,0,40,40
"58136",2017,0,0,86,86
"58136",2018,0,29,0,29
"58136",2019,0,27,42,69
"58136",2020,0,0,20,20
"58137",2017,0,0,61,61
"58137",2018,0,29,0,29
"58137",2019,0,27,15,42
"58137",2020,0,0,20,20
"58138",2017,0,0,42,42
"58138",2018,0,29,0,29
"58138",2019,0,27,0,27
"58139",2017,0,0,61,61
"58139",2018,0,29,0,29
"58139",2019,0,27,15,42
"58139",2020,0,0,20,20
"58140",2017,0,0,61,61
"58140",2018,0,29,0,29
"58140",2019,0,27,15,42
"58141",2017,0,0,86,86
"58141",2018,0,29,20,49
"58141",2019,0,27,42,69
"58141",2020,0,0,20,20
"58142",2016,0,0,40,40
"58142",2017,0,0,61,61
"58142",2018,0,29,0,29
"58142",2019,0,27,15,42
"58143",2016,0,0,40,40
"58143",2017,0,0,86,86
"58143",2018,0,29,0,29
"58143",2019,0,27,42,69
"58143",2020,0,0,20,20
"58144",2017,0,0,42,42
"58144",2018,0,29,0,29
"58144",2019,0,27,0,27
"58145",2018,0,29,29,58
"58145",2019,0,27,42,69
"58146",2017,0,0,42,42
"58146",2018,0,29,0,29
"58146",2019,0,27,0,27
"58147",2016,0,0,40,40
"58147",2018,0,29,15,44
"58147",2019,0,27,42,69
"58147",2020,0,0,20,20
"58148",2017,0,0,42,42
"58148",2018,0,29,0,29
"58148",2019,0,27,0,27
"58149",2017,0,0,61,61
"58149",2018,0,29,0,29
"58149",2019,0,27,15,42
"58149",2020,0,0,20,20
"58150",2018,0,29,29,58
"58150",2019,0,27,55,82
"58151",2016,0,0,40,40
"58151",2017,0,0,86,86
"58151",2018,0,29,15,44
"58151",2019,0,27,15,42
"58151",2020,0,0,20,20
"58152",2017,0,0,42,42
"58152",2018,0,29,0,29
"58152",2019,0,27,0,27
"58153",2018,0,29,29,58
"58153",2019,0,27,55,82
"58154",2018,0,29,29,58
"58154",2019,0,27,55,82
"58155",2018,0,29,105,134
"58155",2019,0,27,28,55
"58155",2020,0,0,60,60
"58156",2016,0,0,40,40
"58156",2018,0,29,20,49
"58156",2019,0,27,15,42
"58157",2017,0,0,42,42
"58157",2018,0,29,0,29
"58157",2019,0,27,42,69
"58157",2020,0,0,32,32
"58158",2017,0,0,42,42
"58158",2018,0,29,0,29
"58158",2019,0,27,0,27
"58159",2018,0,29,29,58
"58159",2019,0,27,55,82
"58160",2018,0,29,0,29
"58160",2019,0,27,0,27
"58161",2018,0,29,0,29
"58161",2019,0,27,15,42
"58162",2014,0,0,29,29
"58162",2017,0,0,14,14
"58162",2018,0,29,105,134
"58162",2019,0,27,28,55
"58162",2020,0,0,32,32
"58163",2014,0,0,29,29
"58163",2017,0,0,14,14
"58163",2018,0,29,105,134
"58163",2019,0,27,28,55
"58163",2020,0,0,32,32
"58164",2018,0,29,105,134
"58164",2019,0,27,28,55
"58164",2020,0,0,60,60
"58165",2018,0,29,29,58
"58165",2019,0,27,55,82
"58166",2018,0,29,15,44
"58166",2019,0,27,42,69
"58168",2017,0,0,61,61
"58168",2018,0,29,0,29
"58168",2019,0,27,15,42
"58168",2020,0,0,20,20
"58169",2018,0,29,29,58
"58169",2019,0,27,55,82
"58170",2018,0,29,29,58
"58170",2019,0,27,55,82
"58171",2016,0,0,40,40
"58171",2017,0,0,86,86
"58171",2018,0,29,15,44
"58171",2019,0,27,15,42
"58171",2020,0,0,20,20
"58172",2017,0,0,61,61
"58172",2018,0,29,0,29
"58172",2019,0,27,15,42
"58172",2020,0,0,20,20
"58173",2017,0,0,61,61
"58173",2018,0,29,0,29
"58173",2019,0,27,15,42
"58173",2020,0,0,20,20
"58174",2016,0,0,40,40
"58174",2018,0,29,20,49
"58174",2019,0,27,15,42
"58175",2016,0,0,40,40
"58175",2017,0,0,61,61
"58175",2018,0,29,0,29
"58175",2019,0,27,15,42
"58176",2016,0,0,40,40
"58176",2018,0,29,15,44
"58176",2019,0,27,42,69
"58176",2020,0,0,20,20
"58177",2018,0,29,0,29
"58177",2019,0,27,42,69
"58178",2016,0,0,40,40
"58178",2017,0,0,86,86
"58178",2018,0,29,15,44
"58178",2019,0,27,15,42
"58178",2020,0,0,20,20
"58179",2018,0,29,0,29
"58179",2019,0,27,42,69
"58180",2017,0,0,42,42
"58180",2018,0,29,15,44
"58180",2019,0,27,42,69
"58180",2020,0,0,20,20
"58181",2018,0,29,0,29
"58181",2019,0,27,15,42
"58182",2018,0,29,0,29
"58182",2019,0,27,15,42
"58183",2018,0,29,29,58
"58183",2019,0,27,55,82
"58184",2016,0,0,40,40
"58184",2018,0,29,15,44
"58184",2019,0,27,15,42
"58185",2017,0,0,42,42
"58185",2018,0,29,15,44
"58185",2019,0,27,42,69
"58185",2020,0,0,20,20
"58186",2016,0,0,40,40
"58186",2018,0,29,20,49
"58186",2019,0,27,15,42
"58186",2020,0,0,20,20
"58187",2018,0,29,105,134
"58187",2019,0,27,55,82
"58187",2020,0,0,96,96
"58188",2016,0,0,40,40
"58188",2018,0,29,20,49
"58188",2019,0,27,15,42
"58188",2020,0,0,20,20
"58189",2018,0,29,105,134
"58189",2019,0,27,28,55
"58189",2020,0,0,60,60
"58190",2018,0,29,29,58
"58190",2019,0,27,42,69
"58191",2014,0,0,29,29
"58191",2017,0,0,14,14
"58191",2018,0,29,64,93
"58191",2019,0,27,15,42
"58192",2017,0,0,42,42
"58192",2018,0,29,0,29
"58192",2019,0,27,0,27
"58193",2018,0,29,105,134
"58193",2019,0,27,55,82
"58193",2020,0,0,96,96
"58194",2018,0,29,0,29
"58194",2019,0,27,0,27
"58195",2017,0,0,61,61
"58195",2018,0,29,0,29
"58195",2019,0,27,15,42
"58195",2020,0,0,20,20
"58196",2016,0,0,40,40
"58196",2018,0,29,15,44
"58196",2019,0,27,42,69
"58196",2020,0,0,20,20
"58197",2018,0,29,29,58
"58197",2019,0,27,55,82
"58198",2018,0,29,0,29
"58198",2019,0,27,28,55
"58199",2018,0,29,0,29
"58199",2019,0,27,42,69
"58200",2018,0,29,0,29
"58200",2019,0,27,15,42
"58201",2016,0,0,40,40
"58201",2018,0,29,20,49
"58201",2019,0,27,15,42
"58201",2020,0,0,20,20
"58202",2016,0,0,40,40
"58202",2017,0,0,61,61
"58202",2018,0,29,0,29
"58202",2019,0,27,15,42
"58203",2016,0,0,40,40
"58203",2018,0,29,20,49
"58203",2019,0,27,15,42
"58204",2016,0,0,40,40
"58204",2018,0,29,15,44
"58204",2019,0,27,42,69
"58204",2020,0,0,20,20
"58205",2018,0,29,15,44
"58205",2019,0,27,42,69
"58206",2014,0,0,29,29
"58206",2017,0,0,14,14
"58206",2018,0,29,64,93
"58206",2019,0,27,15,42
"58207",2016,0,0,40,40
"58207",2018,0,29,20,49
"58207",2019,0,27,15,42
"58207",2020,0,0,20,20
"58208",2016,0,0,40,40
"58208",2018,0,29,0,29
"58208",2019,0,27,15,42
"58209",2018,0,29,105,134
"58209",2019,0,27,28,55
"58209",2020,0,0,60,60
"58210",2017,0,0,42,42
"58210",2018,0,29,15,44
"58210",2019,0,27,42,69
"58210",2020,0,0,20,20
"58211",2017,0,0,61,61
"58211",2018,0,29,0,29
"58211",2019,0,27,15,42
"58211",2020,0,0,20,20
"58212",2016,0,0,40,40
"58212",2018,0,29,20,49
"58212",2019,0,27,42,69
"58212",2020,0,0,20,20
"58213",2018,0,29,105,134
"58213",2019,0,27,28,55
"58213",2020,0,0,60,60
"58214",2016,0,0,40,40
"58214",2018,0,29,20,49
"58214",2019,0,27,15,42
"58214",2020,0,0,20,20
"58215",2018,0,29,105,134
"58215",2019,0,27,28,55
"58215",2020,0,0,60,60
"58216",2018,0,29,29,58
"58216",2019,0,27,42,69
"58217",2018,0,29,29,58
"58217",2019,0,27,55,82
"58218",2016,0,0,40,40
"58218",2018,0,29,20,49
"58218",2019,0,27,42,69
"58218",2020,0,0,20,20
"58219",2018,0,29,0,29
"58219",2019,0,27,15,42
"58220",2016,0,0,40,40
"58220",2018,0,29,20,49
"58220",2019,0,27,15,42
"58220",2020,0,0,20,20
"58221",2017,0,0,61,61
"58221",2018,0,29,0,29
"58221",2019,0,27,15,42
"58221",2020,0,0,20,20
"58222",2018,0,29,0,29
"58222",2019,0,27,15,42
"58223",2016,0,0,40,40
"58223",2017,0,0,86,86
"58223",2018,0,29,15,44
"58223",2019,0,27,15,42
"58223",2020,0,0,20,20
"58224",2018,0,29,29,58
"58224",2019,0,27,55,82
"58225",2017,0,0,42,42
"58225",2018,0,29,0,29
"58225",2019,0,27,0,27
"58226",2017,0,0,42,42
"58226",2018,0,29,0,29
"58226",2019,0,27,42,69
"58226",2020,0,0,32,32
"58227",2016,0,0,40,40
"58227",2018,0,29,0,29
"58227",2019,0,27,15,42
"58228",2018,0,29,105,134
"58228",2019,0,27,28,55
"58228",2020,0,0,60,60
"58229",2017,0,0,42,42
"58229",2018,0,29,0,29
"58229",2019,0,27,42,69
"58229",2020,0,0,32,32
"58230",2018,0,29,29,58
"58230",2019,0,27,42,69
"58231",2016,0,0,40,40
"58231",2018,0,29,20,49
"58231",2019,0,27,15,42
"58231",2020,0,0,20,20
"58232",2016,0,0,40,40
"58232",2017,0,0,86,86
"58232",2018,0,29,0,29
"58232",2019,0,27,42,69
"58232",2020,0,0,20,20
"58233",2016,0,0,40,40
"58233",2018,0,29,15,44
"58233",2019,0,27,42,69
"58233",2020,0,0,20,20
"58234",2016,0,0,40,40
"58234",2018,0,29,20,49
"58234",2019,0,27,42,69
"58234",2020,0,0,20,20
"58235",2017,0,0,42,42
"58235",2018,0,29,0,29
"58235",2019,0,27,42,69
"58235",2020,0,0,32,32
"58236",2018,0,29,105,134
"58236",2019,0,27,28,55
"58236",2020,0,0,60,60
"58237",2018,0,29,29,58
"58237",2019,0,27,55,82
"58238",2016,0,0,40,40
"58238",2018,0,29,20,49
"58238",2019,0,27,42,69
"58238",2020,0,0,20,20
"58239",2016,0,0,40,40
"58239",2017,0,0,86,86
"58239",2018,0,29,0,29
"58239",2019,0,27,42,69
"58239",2020,0,0,20,20
"58240",2016,0,0,40,40
"58240",2018,0,29,15,44
"58240",2019,0,27,15,42
"58241",2017,0,0,42,42
"58241",2018,0,29,0,29
"58241",2019,0,27,0,27
"58242",2018,0,29,0,29
"58242",2019,0,27,15,42
"58243",2016,0,0,40,40
"58243",2017,0,0,86,86
"58243",2018,0,29,15,44
"58243",2019,0,27,15,42
"58243",2020,0,0,20,20
"58244",2017,0,0,61,61
"58244",2018,0,29,0,29
"58244",2019,0,27,42,69
"58245",2017,0,0,61,61
"58245",2018,0,29,0,29
"58245",2019,0,27,15,42
"58245",2020,0,0,20,20
"58246",2017,0,0,61,61
"58246",2018,0,29,0,29
"58246",2019,0,27,15,42
"58247",2016,0,0,40,40
"58247",2018,0,29,15,44
"58247",2019,0,27,42,69
"58247",2020,0,0,20,20
"58248",2018,0,29,105,134
"58248",2019,0,27,28,55
"58248",2020,0,0,60,60
"58249",2017,0,0,61,61
"58249",2018,0,29,0,29
"58249",2019,0,27,42,69
"58250",2018,0,29,20,49
"58250",2019,0,27,28,55
"58250",2020,0,0,45,45
"58251",2016,0,0,40,40
"58251",2018,0,29,0,29
"58251",2019,0,27,15,42
"58252",2016,0,0,40,40
"58252",2018,0,29,20,49
"58252",2019,0,27,15,42
"58252",2020,0,0,20,20
"58253",2016,0,0,40,40
"58253",2018,0,29,15,44
"58253",2019,0,27,42,69
"58253",2020,0,0,20,20
"58254",2016,0,0,40,40
"58254",2018,0,29,20,49
"58254",2019,0,27,42,69
"58254",2020,0,0,20,20
"58255",2018,0,29,29,58
"58255",2019,0,27,42,69
"58256",2018,0,29,105,134
"58256",2019,0,27,28,55
"58256",2020,0,0,60,60
"58257",2016,0,0,40,40
"58257",2017,0,0,86,86
"58257",2018,0,29,0,29
"58257",2019,0,27,42,69
"58257",2020,0,0,20,20
"58258",2016,0,0,40,40
"58258",2017,0,0,86,86
"58258",2018,0,29,0,29
"58258",2019,0,27,42,69
"58258",2020,0,0,20,20
"58259",2017,0,0,42,42
"58259",2018,0,29,0,29
"58259",2019,0,27,0,27
"58260",2017,0,0,42,42
"58260",2018,0,29,0,29
"58260",2019,0,27,0,27
"58261",2018,0,29,105,134
"58261",2019,0,27,28,55
"58261",2020,0,0,60,60
"58262",2018,0,29,0,29
"58262",2019,0,27,42,69
"58263",2014,0,0,29,29
"58263",2017,0,0,14,14
"58263",2018,0,29,64,93
"58263",2019,0,27,15,42
"58264",2017,0,0,42,42
"58264",2018,0,29,0,29
"58264",2019,0,27,0,27
"58265",2018,0,29,105,134
"58265",2019,0,27,28,55
"58265",2020,0,0,60,60
"58266",2016,0,0,40,40
"58266",2017,0,0,14,14
"58266",2018,0,29,0,29
"58266",2019,0,27,15,42
"58267",2016,0,0,40,40
"58267",2018,0,29,15,44
"58267",2019,0,27,42,69
"58267",2020,0,0,20,20
"58268",2017,0,0,61,61
"58268",2018,0,29,0,29
"58268",2019,0,27,15,42
"58268",2020,0,0,20,20
"58269",2016,0,0,40,40
"58269",2018,0,29,15,44
"58269",2019,0,27,42,69
"58269",2020,0,0,20,20
"58270",2016,0,0,40,40
"58270",2018,0,29,0,29
"58270",2019,0,27,15,42
"58271",2018,0,29,29,58
"58271",2019,0,27,55,82
"58272",2018,0,29,0,29
"58272",2019,0,27,42,69
"58273",2016,0,0,40,40
"58273",2018,0,29,15,44
"58273",2019,0,27,42,69
"58273",2020,0,0,20,20
"58274",2017,0,0,61,61
"58274",2018,0,29,0,29
"58274",2019,0,27,15,42
"58274",2020,0,0,20,20
"58275",2016,0,0,40,40
"58275",2017,0,0,86,86
"58275",2018,0,29,0,29
"58275",2019,0,27,42,69
"58275",2020,0,0,20,20
"58276",2017,0,0,61,61
"58276",2018,0,29,0,29
"58276",2019,0,27,15,42
"58277",2018,0,29,0,29
"58277",2019,0,27,42,69
"58278",2017,0,0,42,42
"58278",2018,0,29,0,29
"58278",2019,0,27,0,27
"58279",2016,0,0,40,40
"58279",2018,0,29,20,49
"58279",2019,0,27,42,69
"58279",2020,0,0,20,20
"58280",2016,0,0,40,40
"58280",2017,0,0,86,86
"58280",2018,0,29,0,29
"58280",2019,0,27,42,69
"58280",2020,0,0,20,20
"58281",2018,0,29,105,134
"58281",2019,0,27,28,55
"58281",2020,0,0,60,60
"58282",2018,0,29,0,29
"58282",2019,0,27,28,55
"58283",2014,0,0,29,29
"58283",2017,0,0,14,14
"58283",2018,0,29,64,93
"58283",2019,0,27,15,42
"58284",2018,0,29,0,29
"58284",2019,0,27,15,42
"58285",2018,0,29,0,29
"58285",2019,0,27,15,42
"58286",2018,0,29,0,29
"58286",2019,0,27,15,42
"58287",2017,0,0,61,61
"58287",2018,0,29,0,29
"58287",2019,0,27,15,42
"58287",2020,0,0,20,20
"58288",2018,0,29,29,58
"58288",2019,0,27,55,82
"58289",2017,0,0,61,61
"58289",2018,0,29,0,29
"58289",2019,0,27,15,42
"58289",2020,0,0,20,20
"58290",2016,0,0,40,40
"58290",2017,0,0,61,61
"58290",2018,0,29,0,29
"58290",2019,0,27,15,42
"58290",2020,0,0,20,20
"58291",2016,0,0,40,40
"58291",2017,0,0,86,86
"58291",2018,0,29,15,44
"58291",2019,0,27,15,42
"58291",2020,0,0,20,20
"58292",2016,0,0,40,40
"58292",2017,0,0,86,86
"58292",2018,0,29,15,44
"58292",2019,0,27,15,42
"58292",2020,0,0,20,20
"58293",2017,0,0,42,42
"58293",2018,0,29,0,29
"58293",2019,0,27,0,27
"58294",2017,0,0,42,42
"58294",2018,0,29,0,29
"58294",2019,0,27,0,27
"58295",2018,0,29,105,134
"58295",2019,0,27,28,55
"58295",2020,0,0,60,60
"58296",2017,0,0,42,42
"58296",2018,0,29,0,29
"58296",2019,0,27,0,27
"58297",2016,0,0,40,40
"58297",2017,0,0,86,86
"58297",2018,0,29,0,29
"58297",2019,0,27,42,69
"58297",2020,0,0,20,20
"58298",2018,0,29,105,134
"58298",2019,0,27,28,55
"58298",2020,0,0,60,60
"58299",2014,0,0,29,29
"58299",2017,0,0,14,14
"58299",2018,0,29,105,134
"58299",2019,0,27,28,55
"58299",2020,0,0,32,32
"58300",2016,0,0,40,40
"58300",2018,0,29,20,49
"58300",2019,0,27,42,69
"58300",2020,0,0,20,20
"58301",2017,0,0,61,61
"58301",2018,0,29,0,29
"58301",2019,0,27,15,42
"58302",2018,0,29,105,134
"58302",2019,0,27,28,55
"58302",2020,0,0,60,60
"58303",2016,0,0,40,40
"58303",2018,0,29,20,49
"58303",2019,0,27,42,69
"58303",2020,0,0,20,20
"58304",2016,0,0,40,40
"58304",2018,0,29,20,49
"58304",2019,0,27,15,42
"58305",2018,0,29,29,58
"58305",2019,0,27,55,82
"58306",2016,0,0,40,40
"58306",2017,0,0,86,86
"58306",2018,0,29,15,44
"58306",2019,0,27,15,42
"58306",2020,0,0,20,20
"58307",2018,0,29,105,134
"58307",2019,0,27,28,55
"58307",2020,0,0,60,60
"58308",2018,0,29,29,58
"58308",2019,0,27,55,82
"58309",2017,0,0,61,61
"58309",2018,0,29,0,29
"58309",2019,0,27,15,42
"58310",2014,0,0,29,29
"58310",2017,0,0,14,14
"58310",2018,0,29,64,93
"58310",2019,0,27,15,42
"58311",2016,0,0,40,40
"58311",2017,0,0,86,86
"58311",2018,0,29,0,29
"58311",2019,0,27,42,69
"58311",2020,0,0,20,20
"58312",2018,0,29,0,29
"58312",2019,0,27,15,42
"58313",2016,0,0,40,40
"58313",2018,0,29,0,29
"58313",2019,0,27,15,42
"59001",2018,0,8,8,16
"59001",2020,0,18,108,126
"59002",2018,0,8,8,16
"59002",2020,0,18,108,126
"59003",2018,0,8,8,16
"59003",2019,0,0,59,59
"59003",2020,0,18,108,126
"59004",2018,0,8,8,16
"59004",2020,0,18,216,234
"59005",2018,0,8,8,16
"59005",2020,0,18,134,152
"59006",2018,0,8,8,16
"59006",2020,0,18,108,126
"59007",2018,0,8,8,16
"59007",2020,0,18,216,234
"59008",2018,0,8,8,16
"59008",2020,0,18,216,234
"59009",2018,0,8,8,16
"59009",2020,0,18,134,152
"59010",2018,0,8,8,16
"59010",2020,0,18,108,126
"59011",2018,0,8,8,16
"59011",2020,0,18,134,152
"59012",2018,0,8,8,16
"59012",2019,0,0,59,59
"59012",2020,0,18,108,126
"59013",2018,0,8,8,16
"59013",2020,0,18,134,152
"59014",2018,0,8,8,16
"59014",2020,0,18,108,126
"59015",2018,0,8,8,16
"59015",2020,0,18,108,126
"59016",2018,0,8,162,170
"59016",2019,0,0,101,101
"59016",2020,0,18,216,234
"59017",2018,0,8,162,170
"59017",2020,0,18,216,234
"59018",2018,0,8,162,170
"59018",2020,0,18,108,126
"59019",2018,0,8,8,16
"59019",2020,0,18,108,126
"59021",2018,0,8,8,16
"59021",2020,0,18,108,126
"59022",2018,0,8,8,16
"59022",2020,0,18,134,152
"59023",2018,0,8,8,16
"59023",2020,0,18,108,126
"59024",2018,0,8,8,16
"59024",2020,0,18,216,234
"59025",2018,0,8,162,170
"59025",2020,0,18,216,234
"59026",2018,0,8,8,16
"59026",2020,0,18,108,126
"59027",2018,0,8,8,16
"59027",2020,0,18,108,126
"59028",2018,0,8,8,16
"59028",2020,0,18,134,152
"59029",2018,0,8,8,16
"59029",2020,0,18,134,152
"59031",2018,0,8,8,16
"59031",2020,0,18,108,126
"59032",2018,0,8,8,16
"59032",2020,0,18,108,126
"59033",2018,0,8,8,16
"59033",2019,0,0,59,59
"59033",2020,0,18,108,126
"59034",2018,0,8,8,16
"59034",2020,0,18,134,152
"59035",2018,0,8,8,16
"59035",2019,0,0,59,59
"59035",2020,0,18,108,126
"59036",2018,0,8,8,16
"59036",2019,0,0,59,59
"59036",2020,0,18,108,126
"59037",2018,0,8,8,16
"59037",2020,0,18,108,126
"59038",2018,0,8,8,16
"59038",2020,0,18,108,126
"59039",2018,0,8,8,16
"59039",2020,0,18,108,126
"59041",2018,0,8,8,16
"59041",2019,0,0,59,59
"59041",2020,0,18,108,126
"59042",2018,0,8,8,16
"59042",2020,0,18,134,152
"59043",2018,0,8,162,170
"59043",2020,0,18,216,234
"59044",2018,0,8,8,16
"59044",2020,0,18,134,152
"59045",2018,0,8,8,16
"59045",2019,0,0,59,59
"59045",2020,0,18,108,126
"59046",2018,0,8,162,170
"59046",2020,0,18,108,126
"59047",2018,0,8,8,16
"59047",2020,0,18,108,126
"59048",2018,0,8,8,16
"59048",2020,0,18,108,126
"59049",2018,0,8,8,16
"59049",2020,0,18,108,126
"59050",2018,0,8,8,16
"59050",2019,0,0,59,59
"59050",2020,0,18,108,126
"59051",2018,0,8,8,16
"59051",2020,0,18,134,152
"59052",2018,0,8,8,16
"59052",2020,0,18,134,152
"59053",2018,0,8,8,16
"59053",2020,0,18,108,126
"59054",2018,0,8,162,170
"59054",2020,0,18,108,126
"59055",2018,0,8,8,16
"59055",2020,0,18,108,126
"59056",2018,0,8,8,16
"59056",2020,0,18,134,152
"59057",2018,0,8,8,16
"59057",2020,0,18,108,126
"59058",2018,0,8,8,16
"59058",2019,0,0,59,59
"59058",2020,0,18,108,126
"59059",2018,0,8,8,16
"59059",2020,0,18,108,126
"59060",2018,0,8,8,16
"59060",2020,0,18,108,126
"59061",2018,0,8,8,16
"59061",2019,0,0,59,59
"59061",2020,0,18,108,126
"59062",2018,0,8,8,16
"59062",2019,0,0,59,59
"59062",2020,0,18,108,126
"59063",2018,0,8,8,16
"59063",2020,0,18,108,126
"59064",2018,0,8,8,16
"59064",2020,0,18,216,234
"59065",2018,0,8,8,16
"59065",2020,0,18,108,126
"59066",2018,0,8,8,16
"59066",2019,0,0,59,59
"59066",2020,0,18,108,126
"59067",2018,0,8,162,170
"59067",2019,0,0,101,101
"59067",2020,0,18,216,234
"59068",2018,0,8,8,16
"59068",2019,0,0,59,59
"59068",2020,0,18,108,126
"59069",2018,0,8,8,16
"59069",2020,0,18,108,126
"59070",2018,0,8,8,16
"59070",2020,0,18,108,126
"59071",2018,0,8,8,16
"59071",2020,0,18,134,152
"59072",2018,0,8,8,16
"59072",2020,0,18,108,126
"59073",2018,0,8,162,170
"59073",2020,0,18,108,126
"59074",2018,0,8,8,16
"59074",2020,0,18,108,126
"59075",2018,0,8,8,16
"59075",2020,0,18,108,126
"59076",2018,0,8,8,16
"59076",2020,0,18,108,126
"59077",2018,0,8,8,16
"59077",2020,0,18,108,126
"59078",2018,0,8,8,16
"59078",2019,0,0,59,59
"59078",2020,0,18,108,126
"59079",2018,0,8,8,16
"59079",2020,0,18,108,126
"59080",2018,0,8,8,16
"59080",2020,0,18,216,234
"59081",2018,0,8,8,16
"59081",2020,0,18,108,126
"59082",2018,0,8,162,170
"59082",2019,0,0,101,101
"59082",2020,0,18,216,234
"59083",2018,0,8,162,170
"59083",2020,0,18,108,126
"59084",2018,0,8,162,170
"59084",2020,0,18,216,234
"59085",2018,0,8,8,16
"59085",2020,0,18,108,126
"59086",2018,0,8,162,170
"59086",2020,0,18,108,126
"59087",2018,0,8,162,170
"59087",2020,0,18,216,234
"59088",2018,0,8,162,170
"59088",2020,0,18,216,234
"59089",2018,0,8,162,170
"59089",2020,0,18,108,126
"59090",2018,0,8,8,16
"59090",2020,0,18,134,152
"59091",2018,0,8,162,170
"59091",2020,0,18,216,234
"59092",2018,0,8,8,16
"59092",2020,0,18,108,126
"59093",2018,0,8,8,16
"59093",2019,0,0,59,59
"59093",2020,0,18,108,126
"59094",2018,0,8,162,170
"59094",2019,0,0,101,101
"59094",2020,0,18,216,234
"59096",2018,0,8,8,16
"59096",2020,0,18,134,152
"59097",2018,0,8,8,16
"59097",2020,0,18,108,126
"59098",2018,0,8,8,16
"59098",2020,0,18,134,152
"59099",2018,0,8,8,16
"59099",2020,0,18,108,126
"59100",2018,0,8,8,16
"59100",2020,0,18,216,234
"59101",2018,0,8,8,16
"59101",2019,0,0,59,59
"59101",2020,0,18,108,126
"59102",2018,0,8,8,16
"59102",2020,0,18,108,126
"59103",2018,0,8,8,16
"59103",2019,0,0,59,59
"59103",2020,0,18,108,126
"59104",2018,0,8,8,16
"59104",2020,0,18,108,126
"59105",2018,0,8,8,16
"59105",2020,0,18,216,234
"59106",2018,0,8,8,16
"59106",2020,0,18,134,152
"59107",2018,0,8,162,170
"59107",2019,0,0,101,101
"59107",2020,0,18,216,234
"59108",2018,0,8,8,16
"59108",2020,0,18,108,126
"59109",2018,0,8,8,16
"59109",2020,0,18,216,234
"59110",2018,0,8,162,170
"59110",2019,0,0,101,101
"59110",2020,0,18,216,234
"59111",2018,0,8,162,170
"59111",2020,0,18,108,126
"59112",2018,0,8,8,16
"59112",2020,0,18,108,126
"59113",2018,0,8,8,16
"59113",2020,0,18,216,234
"59114",2018,0,8,8,16
"59114",2020,0,18,108,126
"59115",2018,0,8,8,16
"59115",2020,0,18,108,126
"59116",2018,0,8,8,16
"59116",2020,0,18,108,126
"59117",2018,0,8,8,16
"59117",2020,0,18,108,126
"59118",2018,0,8,8,16
"59118",2020,0,18,108,126
"59119",2018,0,8,162,170
"59119",2020,0,18,108,126
"59120",2018,0,8,162,170
"59120",2020,0,18,108,126
"59121",2018,0,8,8,16
"59121",2020,0,18,108,126
"59122",2018,0,8,8,16
"59122",2020,0,18,108,126
"59123",2018,0,8,8,16
"59123",2020,0,18,134,152
"59124",2018,0,8,8,16
"59124",2020,0,18,134,152
"59125",2018,0,8,8,16
"59125",2020,0,18,108,126
"59126",2018,0,8,8,16
"59126",2020,0,18,108,126
"59127",2018,0,8,8,16
"59127",2020,0,18,108,126
"59128",2018,0,8,8,16
"59128",2020,0,18,134,152
"59129",2018,0,8,8,16
"59129",2020,0,18,134,152
"59130",2018,0,8,162,170
"59130",2019,0,0,101,101
"59130",2020,0,18,216,234
"59131",2018,0,8,162,170
"59131",2019,0,0,101,101
"59131",2020,0,18,216,234
"59132",2018,0,8,8,16
"59132",2020,0,18,108,126
"59133",2018,0,8,8,16
"59133",2020,0,18,134,152
"59134",2018,0,8,8,16
"59134",2019,0,0,59,59
"59134",2020,0,18,108,126
"59135",2018,0,8,162,170
"59135",2020,0,18,108,126
"59136",2018,0,8,8,16
"59136",2020,0,18,108,126
"59137",2018,0,8,8,16
"59137",2020,0,18,108,126
"59138",2018,0,8,8,16
"59138",2020,0,18,108,126
"59139",2018,0,8,8,16
"59139",2020,0,18,108,126
"59140",2018,0,8,8,16
"59140",2020,0,18,108,126
"59141",2018,0,8,8,16
"59141",2020,0,18,108,126
"59142",2018,0,8,8,16
"59142",2019,0,0,59,59
"59142",2020,0,18,108,126
"59143",2018,0,8,162,170
"59143",2020,0,18,216,234
"59144",2018,0,8,8,16
"59144",2020,0,18,108,126
"59145",2018,0,8,8,16
"59145",2020,0,18,134,152
"59146",2018,0,8,8,16
"59146",2020,0,18,134,152
"59147",2018,0,8,8,16
"59147",2019,0,0,59,59
"59147",2020,0,18,108,126
"59148",2018,0,8,8,16
"59148",2019,0,0,59,59
"59148",2020,0,18,108,126
"59149",2018,0,8,8,16
"59149",2020,0,18,108,126
"59150",2018,0,8,8,16
"59150",2020,0,18,134,152
"59151",2018,0,8,8,16
"59151",2019,0,0,59,59
"59151",2020,0,18,108,126
"59152",2018,0,8,8,16
"59152",2020,0,18,134,152
"59153",2018,0,8,8,16
"59153",2020,0,18,108,126
"59155",2018,0,8,162,170
"59155",2019,0,0,101,101
"59155",2020,0,18,216,234
"59156",2018,0,8,8,16
"59156",2020,0,18,108,126
"59157",2018,0,8,8,16
"59157",2019,0,0,59,59
"59157",2020,0,18,108,126
"59158",2018,0,8,8,16
"59158",2020,0,18,216,234
"59159",2018,0,8,162,170
"59159",2019,0,0,101,101
"59159",2020,0,18,216,234
"59160",2018,0,8,8,16
"59160",2020,0,18,108,126
"59161",2018,0,8,8,16
"59161",2020,0,18,108,126
"59162",2018,0,8,162,170
"59162",2020,0,18,108,126
"59163",2018,0,8,8,16
"59163",2020,0,18,134,152
"59164",2018,0,8,8,16
"59164",2020,0,18,108,126
"59165",2018,0,8,8,16
"59165",2020,0,18,108,126
"59166",2018,0,8,8,16
"59166",2020,0,18,108,126
"59167",2018,0,8,8,16
"59167",2020,0,18,108,126
"59168",2018,0,8,8,16
"59168",2020,0,18,134,152
"59169",2018,0,8,8,16
"59169",2019,0,0,59,59
"59169",2020,0,18,108,126
"59170",2018,0,8,8,16
"59170",2020,0,18,108,126
"59171",2018,0,8,8,16
"59171",2020,0,18,108,126
"59172",2018,0,8,8,16
"59172",2020,0,18,108,126
"59173",2018,0,8,8,16
"59173",2020,0,18,134,152
"59174",2018,0,8,8,16
"59174",2019,0,0,59,59
"59174",2020,0,18,108,126
"59175",2018,0,8,8,16
"59175",2019,0,0,59,59
"59175",2020,0,18,108,126
"59176",2018,0,8,8,16
"59176",2020,0,18,108,126
"59177",2018,0,8,8,16
"59177",2019,0,0,59,59
"59177",2020,0,18,108,126
"59178",2018,0,8,8,16
"59178",2020,0,18,108,126
"59179",2018,0,8,8,16
"59179",2020,0,18,108,126
"59180",2018,0,8,162,170
"59180",2020,0,18,216,234
"59181",2018,0,8,8,16
"59181",2019,0,0,59,59
"59181",2020,0,18,108,126
"59182",2018,0,8,162,170
"59182",2019,0,0,101,101
"59182",2020,0,18,216,234
"59183",2018,0,8,162,170
"59183",2019,0,0,101,101
"59183",2020,0,18,216,234
"59184",2018,0,8,162,170
"59184",2020,0,18,216,234
"59185",2018,0,8,8,16
"59185",2020,0,18,216,234
"59186",2018,0,8,8,16
"59186",2019,0,0,59,59
"59186",2020,0,18,108,126
"59187",2018,0,8,8,16
"59187",2019,0,0,59,59
"59187",2020,0,18,108,126
"59188",2018,0,8,8,16
"59188",2019,0,0,59,59
"59188",2020,0,18,108,126
"59189",2018,0,8,162,170
"59189",2020,0,18,108,126
"59190",2018,0,8,8,16
"59190",2020,0,18,108,126
"59191",2018,0,8,8,16
"59191",2020,0,18,108,126
"59192",2018,0,8,8,16
"59192",2020,0,18,108,126
"59193",2018,0,8,8,16
"59193",2020,0,18,134,152
"59194",2018,0,8,8,16
"59194",2020,0,18,108,126
"59195",2018,0,8,8,16
"59195",2020,0,18,134,152
"59196",2018,0,8,8,16
"59196",2020,0,18,134,152
"59197",2018,0,8,8,16
"59197",2020,0,18,134,152
"59198",2018,0,8,8,16
"59198",2019,0,0,59,59
"59198",2020,0,18,108,126
"59199",2018,0,8,8,16
"59199",2020,0,18,108,126
"59200",2018,0,8,162,170
"59200",2020,0,18,108,126
"59201",2018,0,8,8,16
"59201",2020,0,18,134,152
"59202",2018,0,8,162,170
"59202",2020,0,18,216,234
"59203",2018,0,8,8,16
"59203",2020,0,18,108,126
"59204",2018,0,8,8,16
"59204",2020,0,18,108,126
"59205",2018,0,8,8,16
"59205",2020,0,18,108,126
"59206",2018,0,8,8,16
"59206",2020,0,18,108,126
"59207",2018,0,8,8,16
"59207",2020,0,18,108,126
"59208",2018,0,8,8,16
"59208",2020,0,18,134,152
"59209",2018,0,8,8,16
"59209",2020,0,18,108,126
"59210",2018,0,8,162,170
"59210",2020,0,18,108,126
"59211",2018,0,8,8,16
"59211",2020,0,18,108,126
"59212",2018,0,8,162,170
"59212",2020,0,18,216,234
"59213",2018,0,8,8,16
"59213",2020,0,18,108,126
"59214",2018,0,8,8,16
"59214",2020,0,18,108,126
"59215",2018,0,8,8,16
"59215",2020,0,18,108,126
"59216",2018,0,8,8,16
"59216",2020,0,18,108,126
"59217",2018,0,8,8,16
"59217",2020,0,18,108,126
"59218",2018,0,8,8,16
"59218",2019,0,0,59,59
"59218",2020,0,18,108,126
"59219",2018,0,8,8,16
"59219",2020,0,18,108,126
"59220",2018,0,8,8,16
"59220",2020,0,18,134,152
"59221",2018,0,8,8,16
"59221",2020,0,18,108,126
"59222",2018,0,8,8,16
"59222",2020,0,18,216,234
"59223",2018,0,8,8,16
"59223",2019,0,0,59,59
"59223",2020,0,18,108,126
"59224",2018,0,8,8,16
"59224",2020,0,18,108,126
"59225",2018,0,8,8,16
"59225",2020,0,18,108,126
"59226",2018,0,8,8,16
"59226",2019,0,0,59,59
"59226",2020,0,18,108,126
"59227",2018,0,8,8,16
"59227",2020,0,18,216,234
"59228",2018,0,8,8,16
"59228",2020,0,18,108,126
"59229",2018,0,8,8,16
"59229",2019,0,0,59,59
"59229",2020,0,18,108,126
"59230",2018,0,8,8,16
"59230",2019,0,0,59,59
"59230",2020,0,18,108,126
"59231",2018,0,8,8,16
"59231",2019,0,0,59,59
"59231",2020,0,18,108,126
"59232",2018,0,8,8,16
"59232",2020,0,18,108,126
"59233",2018,0,8,8,16
"59233",2019,0,0,59,59
"59233",2020,0,18,108,126
"59234",2018,0,8,8,16
"59234",2020,0,18,134,152
"59236",2018,0,8,8,16
"59236",2020,0,18,108,126
"59237",2018,0,8,162,170
"59237",2020,0,18,108,126
"59238",2018,0,8,8,16
"59238",2020,0,18,108,126
"59239",2018,0,8,8,16
"59239",2020,0,18,216,234
"59240",2018,0,8,8,16
"59240",2019,0,0,59,59
"59240",2020,0,18,108,126
"59241",2018,0,8,8,16
"59241",2019,0,0,59,59
"59241",2020,0,18,108,126
"59242",2018,0,8,8,16
"59242",2020,0,18,108,126
"59243",2018,0,8,8,16
"59243",2020,0,18,108,126
"59244",2018,0,8,8,16
"59244",2020,0,18,108,126
"59246",2018,0,8,8,16
"59246",2020,0,18,108,126
"59247",2018,0,8,8,16
"59247",2020,0,18,134,152
"59249",2018,0,8,8,16
"59249",2019,0,0,59,59
"59249",2020,0,18,108,126
"59250",2018,0,8,8,16
"59250",2020,0,18,134,152
"59251",2018,0,8,8,16
"59251",2020,0,18,108,126
"59252",2018,0,8,8,16
"59252",2020,0,18,134,152
"59253",2018,0,8,8,16
"59253",2020,0,18,108,126
"59254",2018,0,8,8,16
"59254",2020,0,18,108,126
"59255",2018,0,8,8,16
"59255",2020,0,18,108,126
"59256",2018,0,8,8,16
"59256",2020,0,18,134,152
"59257",2018,0,8,8,16
"59257",2020,0,18,134,152
"59258",2018,0,8,8,16
"59258",2020,0,18,134,152
"59259",2018,0,8,8,16
"59259",2020,0,18,108,126
"59260",2018,0,8,162,170
"59260",2019,0,0,101,101
"59260",2020,0,18,216,234
"59261",2018,0,8,8,16
"59261",2019,0,0,59,59
"59261",2020,0,18,108,126
"59262",2018,0,8,162,170
"59262",2020,0,18,108,126
"59263",2018,0,8,8,16
"59263",2020,0,18,108,126
"59264",2018,0,8,8,16
"59264",2020,0,18,108,126
"59265",2018,0,8,8,16
"59265",2020,0,18,108,126
"59266",2018,0,8,8,16
"59266",2020,0,18,134,152
"59267",2018,0,8,8,16
"59267",2020,0,18,108,126
"59268",2018,0,8,162,170
"59268",2020,0,18,216,234
"59269",2018,0,8,8,16
"59269",2020,0,18,108,126
"59270",2018,0,8,8,16
"59270",2019,0,0,59,59
"59270",2020,0,18,108,126
"59271",2018,0,8,162,170
"59271",2019,0,0,101,101
"59271",2020,0,18,216,234
"59272",2018,0,8,162,170
"59272",2019,0,0,101,101
"59272",2020,0,18,216,234
"59273",2018,0,8,162,170
"59273",2019,0,0,101,101
"59273",2020,0,18,216,234
"59274",2018,0,8,8,16
"59274",2019,0,0,59,59
"59274",2020,0,18,108,126
"59275",2018,0,8,8,16
"59275",2020,0,18,134,152
"59276",2018,0,8,8,16
"59276",2020,0,18,216,234
"59277",2018,0,8,8,16
"59277",2020,0,18,108,126
"59278",2018,0,8,8,16
"59278",2020,0,18,134,152
"59279",2018,0,8,8,16
"59279",2020,0,18,134,152
"59280",2018,0,8,8,16
"59280",2020,0,18,108,126
"59281",2018,0,8,8,16
"59281",2020,0,18,134,152
"59282",2018,0,8,162,170
"59282",2020,0,18,108,126
"59283",2018,0,8,8,16
"59283",2020,0,18,108,126
"59284",2018,0,8,8,16
"59284",2020,0,18,216,234
"59285",2018,0,8,8,16
"59285",2020,0,18,108,126
"59286",2018,0,8,8,16
"59286",2020,0,18,134,152
"59287",2018,0,8,8,16
"59287",2020,0,18,108,126
"59288",2018,0,8,8,16
"59288",2020,0,18,108,126
"59289",2018,0,8,8,16
"59289",2020,0,18,108,126
"59290",2018,0,8,8,16
"59290",2019,0,0,59,59
"59290",2020,0,18,108,126
"59291",2018,0,8,8,16
"59291",2019,0,0,59,59
"59291",2020,0,18,108,126
"59292",2018,0,8,8,16
"59292",2020,0,18,108,126
"59293",2018,0,8,162,170
"59293",2020,0,18,216,234
"59294",2018,0,8,8,16
"59294",2020,0,18,108,126
"59295",2018,0,8,162,170
"59295",2020,0,18,216,234
"59296",2018,0,8,8,16
"59296",2020,0,18,108,126
"59297",2018,0,8,8,16
"59297",2020,0,18,108,126
"59299",2018,0,8,8,16
"59299",2020,0,18,134,152
"59300",2018,0,8,8,16
"59300",2020,0,18,108,126
"59301",2018,0,8,8,16
"59301",2020,0,18,108,126
"59302",2018,0,8,8,16
"59302",2020,0,18,108,126
"59303",2018,0,8,8,16
"59303",2020,0,18,134,152
"59304",2018,0,8,8,16
"59304",2020,0,18,134,152
"59305",2018,0,8,162,170
"59305",2020,0,18,108,126
"59306",2018,0,8,8,16
"59306",2019,0,0,59,59
"59306",2020,0,18,108,126
"59307",2018,0,8,162,170
"59307",2019,0,0,101,101
"59307",2020,0,18,216,234
"59308",2018,0,8,162,170
"59308",2020,0,18,108,126
"59309",2018,0,8,162,170
"59309",2020,0,18,108,126
"59310",2018,0,8,8,16
"59310",2020,0,18,108,126
"59311",2018,0,8,8,16
"59311",2020,0,18,108,126
"59312",2018,0,8,8,16
"59312",2020,0,18,108,126
"59313",2018,0,8,8,16
"59313",2020,0,18,108,126
"59314",2018,0,8,8,16
"59314",2020,0,18,108,126
"59315",2018,0,8,8,16
"59315",2020,0,18,108,126
"59316",2018,0,8,8,16
"59316",2020,0,18,134,152
"59317",2018,0,8,162,170
"59317",2020,0,18,216,234
"59318",2018,0,8,162,170
"59318",2020,0,18,108,126
"59319",2018,0,8,162,170
"59319",2019,0,0,101,101
"59319",2020,0,18,216,234
"59320",2018,0,8,8,16
"59320",2020,0,18,134,152
"59321",2018,0,8,8,16
"59321",2020,0,18,108,126
"59322",2018,0,8,8,16
"59322",2020,0,18,108,126
"59323",2018,0,8,8,16
"59323",2020,0,18,108,126
"59324",2018,0,8,8,16
"59324",2019,0,0,59,59
"59324",2020,0,18,108,126
"59325",2018,0,8,8,16
"59325",2020,0,18,108,126
"59326",2018,0,8,162,170
"59326",2020,0,18,108,126
"59327",2018,0,8,8,16
"59327",2020,0,18,216,234
"59328",2018,0,8,8,16
"59328",2020,0,18,134,152
"59329",2018,0,8,8,16
"59329",2020,0,18,108,126
"59330",2018,0,8,8,16
"59330",2020,0,18,216,234
"59331",2018,0,8,8,16
"59331",2020,0,18,108,126
"59332",2018,0,8,8,16
"59332",2020,0,18,134,152
"59333",2018,0,8,8,16
"59333",2019,0,0,59,59
"59333",2020,0,18,108,126
"59334",2018,0,8,8,16
"59334",2020,0,18,108,126
"59335",2018,0,8,8,16
"59335",2020,0,18,216,234
"59336",2018,0,8,8,16
"59336",2020,0,18,108,126
"59337",2018,0,8,162,170
"59337",2020,0,18,108,126
"59338",2018,0,8,162,170
"59338",2020,0,18,108,126
"59339",2018,0,8,8,16
"59339",2020,0,18,134,152
"59340",2018,0,8,162,170
"59340",2019,0,0,101,101
"59340",2020,0,18,216,234
"59341",2018,0,8,8,16
"59341",2020,0,18,108,126
"59342",2018,0,8,8,16
"59342",2019,0,0,59,59
"59342",2020,0,18,108,126
"59343",2018,0,8,8,16
"59343",2020,0,18,134,152
"59344",2018,0,8,8,16
"59344",2019,0,0,59,59
"59344",2020,0,18,108,126
"59345",2018,0,8,8,16
"59345",2020,0,18,216,234
"59346",2018,0,8,8,16
"59346",2020,0,18,134,152
"59347",2018,0,8,8,16
"59347",2019,0,0,59,59
"59347",2020,0,18,108,126
"59348",2018,0,8,8,16
"59348",2020,0,18,108,126
"59349",2018,0,8,8,16
"59349",2020,0,18,108,126
"59350",2018,0,8,8,16
"59350",2020,0,18,134,152
"59351",2018,0,8,8,16
"59351",2019,0,0,59,59
"59351",2020,0,18,108,126
"59352",2018,0,8,8,16
"59352",2020,0,18,134,152
"59353",2018,0,8,8,16
"59353",2020,0,18,108,126
"59354",2018,0,8,8,16
"59354",2020,0,18,216,234
"59356",2018,0,8,8,16
"59356",2020,0,18,134,152
"59357",2018,0,8,8,16
"59357",2020,0,18,108,126
"59358",2018,0,8,162,170
"59358",2019,0,0,101,101
"59358",2020,0,18,216,234
"59359",2018,0,8,162,170
"59359",2019,0,0,101,101
"59359",2020,0,18,216,234
"59360",2018,0,8,8,16
"59360",2020,0,18,134,152
"59361",2018,0,8,8,16
"59361",2020,0,18,108,126
"59363",2018,0,8,8,16
"59363",2020,0,18,108,126
"59364",2018,0,8,8,16
"59364",2020,0,18,134,152
"59365",2018,0,8,8,16
"59365",2019,0,0,59,59
"59365",2020,0,18,108,126
"59366",2018,0,8,162,170
"59366",2020,0,18,216,234
"59367",2018,0,8,8,16
"59367",2020,0,18,134,152
"59368",2018,0,8,8,16
"59368",2020,0,18,134,152
"59369",2018,0,8,8,16
"59369",2020,0,18,108,126
"59370",2018,0,8,8,16
"59370",2020,0,18,108,126
"59371",2018,0,8,8,16
"59371",2020,0,18,134,152
"59372",2018,0,8,8,16
"59372",2020,0,18,108,126
"59374",2018,0,8,8,16
"59374",2019,0,0,59,59
"59374",2020,0,18,108,126
"59375",2018,0,8,8,16
"59375",2020,0,18,216,234
"59377",2018,0,8,8,16
"59377",2020,0,18,108,126
"59378",2018,0,8,8,16
"59378",2020,0,18,134,152
"59379",2018,0,8,8,16
"59379",2020,0,18,108,126
"59381",2018,0,8,8,16
"59381",2020,0,18,108,126
"59382",2018,0,8,8,16
"59382",2020,0,18,108,126
"59383",2018,0,8,8,16
"59383",2020,0,18,108,126
"59384",2018,0,8,8,16
"59384",2019,0,0,59,59
"59384",2020,0,18,108,126
"59385",2018,0,8,8,16
"59385",2020,0,18,108,126
"59386",2018,0,8,8,16
"59386",2020,0,18,134,152
"59387",2018,0,8,8,16
"59387",2020,0,18,108,126
"59388",2018,0,8,8,16
"59388",2020,0,18,134,152
"59389",2018,0,8,8,16
"59389",2020,0,18,108,126
"59390",2018,0,8,8,16
"59390",2020,0,18,216,234
"59391",2018,0,8,8,16
"59391",2020,0,18,108,126
"59392",2018,0,8,8,16
"59392",2020,0,18,108,126
"59393",2018,0,8,8,16
"59393",2020,0,18,216,234
"59394",2018,0,8,8,16
"59394",2020,0,18,108,126
"59395",2018,0,8,8,16
"59395",2020,0,18,108,126
"59396",2018,0,8,8,16
"59396",2020,0,18,108,126
"59397",2018,0,8,162,170
"59397",2020,0,18,108,126
"59398",2018,0,8,8,16
"59398",2020,0,18,134,152
"59399",2018,0,8,162,170
"59399",2020,0,18,216,234
"59400",2018,0,8,162,170
"59400",2020,0,18,216,234
"59401",2018,0,8,162,170
"59401",2020,0,18,108,126
"59402",2018,0,8,162,170
"59402",2020,0,18,108,126
"59403",2018,0,8,8,16
"59403",2020,0,18,216,234
"59405",2018,0,8,8,16
"59405",2020,0,18,108,126
"59406",2018,0,8,8,16
"59406",2019,0,0,59,59
"59406",2020,0,18,108,126
"59407",2018,0,8,8,16
"59407",2020,0,18,108,126
"59408",2018,0,8,8,16
"59408",2020,0,18,134,152
"59409",2018,0,8,8,16
"59409",2020,0,18,108,126
"59410",2018,0,8,8,16
"59410",2020,0,18,134,152
"59411",2018,0,8,8,16
"59411",2020,0,18,134,152
"59412",2018,0,8,8,16
"59412",2020,0,18,108,126
"59413",2018,0,8,8,16
"59413",2020,0,18,108,126
"59414",2018,0,8,8,16
"59414",2020,0,18,216,234
"59415",2018,0,8,8,16
"59415",2020,0,18,108,126
"59416",2018,0,8,162,170
"59416",2020,0,18,216,234
"59418",2018,0,8,8,16
"59418",2020,0,18,108,126
"59419",2018,0,8,8,16
"59419",2020,0,18,134,152
"59420",2018,0,8,8,16
"59420",2019,0,0,59,59
"59420",2020,0,18,108,126
"59421",2018,0,8,8,16
"59421",2020,0,18,134,152
"59422",2018,0,8,8,16
"59422",2020,0,18,108,126
"59423",2018,0,8,162,170
"59423",2020,0,18,216,234
"59424",2018,0,8,8,16
"59424",2019,0,0,59,59
"59424",2020,0,18,108,126
"59425",2018,0,8,8,16
"59425",2020,0,18,108,126
"59426",2018,0,8,8,16
"59426",2020,0,18,134,152
"59427",2018,0,8,8,16
"59427",2020,0,18,134,152
"59428",2018,0,8,8,16
"59428",2020,0,18,108,126
"59429",2018,0,8,8,16
"59429",2020,0,18,108,126
"59430",2018,0,8,8,16
"59430",2020,0,18,108,126
"59431",2018,0,8,162,170
"59431",2020,0,18,216,234
"59432",2018,0,8,8,16
"59432",2020,0,18,108,126
"59433",2018,0,8,162,170
"59433",2020,0,18,108,126
"59434",2018,0,8,8,16
"59434",2020,0,18,216,234
"59435",2018,0,8,8,16
"59435",2020,0,18,134,152
"59436",2018,0,8,162,170
"59436",2020,0,18,108,126
"59437",2018,0,8,8,16
"59437",2020,0,18,134,152
"59438",2018,0,8,8,16
"59438",2020,0,18,108,126
"59439",2018,0,8,8,16
"59439",2019,0,0,59,59
"59439",2020,0,18,108,126
"59440",2018,0,8,8,16
"59440",2020,0,18,108,126
"59441",2018,0,8,8,16
"59441",2020,0,18,108,126
"59442",2018,0,8,8,16
"59442",2019,0,0,59,59
"59442",2020,0,18,108,126
"59443",2018,0,8,162,170
"59443",2020,0,18,108,126
"59444",2018,0,8,8,16
"59444",2020,0,18,108,126
"59445",2018,0,8,8,16
"59445",2019,0,0,59,59
"59445",2020,0,18,108,126
"59446",2018,0,8,8,16
"59446",2020,0,18,108,126
"59447",2018,0,8,8,16
"59447",2020,0,18,108,126
"59448",2018,0,8,162,170
"59448",2020,0,18,108,126
"59449",2018,0,8,8,16
"59449",2020,0,18,216,234
"59450",2018,0,8,8,16
"59450",2020,0,18,108,126
"59451",2018,0,8,8,16
"59451",2020,0,18,108,126
"59452",2018,0,8,8,16
"59452",2020,0,18,134,152
"59453",2018,0,8,162,170
"59453",2020,0,18,108,126
"59454",2018,0,8,162,170
"59454",2020,0,18,108,126
"59455",2018,0,8,8,16
"59455",2020,0,18,108,126
"59456",2018,0,8,8,16
"59456",2020,0,18,216,234
"59457",2018,0,8,8,16
"59457",2020,0,18,134,152
"59458",2018,0,8,8,16
"59458",2020,0,18,134,152
"59459",2018,0,8,8,16
"59459",2020,0,18,108,126
"59461",2018,0,8,8,16
"59461",2019,0,0,59,59
"59461",2020,0,18,108,126
"59462",2018,0,8,8,16
"59462",2020,0,18,134,152
"59463",2018,0,8,162,170
"59463",2020,0,18,108,126
"59464",2018,0,8,8,16
"59464",2020,0,18,108,126
"59465",2018,0,8,8,16
"59465",2020,0,18,108,126
"59466",2018,0,8,8,16
"59466",2020,0,18,134,152
"59467",2018,0,8,8,16
"59467",2019,0,0,59,59
"59467",2020,0,18,108,126
"59468",2018,0,8,8,16
"59468",2020,0,18,108,126
"59469",2018,0,8,162,170
"59469",2020,0,18,216,234
"59470",2018,0,8,8,16
"59470",2020,0,18,134,152
"59471",2018,0,8,8,16
"59471",2020,0,18,108,126
"59472",2018,0,8,8,16
"59472",2020,0,18,108,126
"59473",2018,0,8,8,16
"59473",2020,0,18,108,126
"59474",2018,0,8,8,16
"59474",2019,0,0,59,59
"59474",2020,0,18,108,126
"59475",2018,0,8,8,16
"59475",2020,0,18,108,126
"59476",2018,0,8,8,16
"59476",2020,0,18,108,126
"59477",2018,0,8,8,16
"59477",2020,0,18,134,152
"59478",2018,0,8,162,170
"59478",2020,0,18,108,126
"59479",2018,0,8,8,16
"59479",2020,0,18,108,126
"59480",2018,0,8,8,16
"59480",2020,0,18,108,126
"59481",2018,0,8,8,16
"59481",2020,0,18,108,126
"59482",2018,0,8,8,16
"59482",2020,0,18,134,152
"59483",2018,0,8,8,16
"59483",2019,0,0,59,59
"59483",2020,0,18,108,126
"59484",2018,0,8,8,16
"59484",2020,0,18,108,126
"59485",2018,0,8,8,16
"59485",2020,0,18,108,126
"59486",2018,0,8,8,16
"59486",2020,0,18,216,234
"59487",2018,0,8,8,16
"59487",2020,0,18,134,152
"59488",2018,0,8,8,16
"59488",2020,0,18,108,126
"59489",2018,0,8,8,16
"59489",2020,0,18,216,234
"59490",2018,0,8,8,16
"59490",2019,0,0,59,59
"59490",2020,0,18,108,126
"59491",2018,0,8,8,16
"59491",2020,0,18,108,126
"59492",2018,0,8,8,16
"59492",2020,0,18,108,126
"59493",2018,0,8,8,16
"59493",2019,0,0,59,59
"59493",2020,0,18,108,126
"59494",2018,0,8,8,16
"59494",2020,0,18,108,126
"59495",2018,0,8,8,16
"59495",2019,0,0,59,59
"59495",2020,0,18,108,126
"59496",2018,0,8,8,16
"59496",2019,0,0,59,59
"59496",2020,0,18,108,126
"59497",2018,0,8,162,170
"59497",2020,0,18,108,126
"59498",2018,0,8,8,16
"59498",2020,0,18,108,126
"59499",2018,0,8,162,170
"59499",2020,0,18,108,126
"59500",2018,0,8,8,16
"59500",2020,0,18,108,126
"59501",2018,0,8,8,16
"59501",2020,0,18,216,234
"59502",2018,0,8,8,16
"59502",2020,0,18,108,126
"59503",2018,0,8,8,16
"59503",2020,0,18,108,126
"59504",2018,0,8,8,16
"59504",2020,0,18,108,126
"59505",2018,0,8,8,16
"59505",2020,0,18,108,126
"59506",2018,0,8,8,16
"59506",2020,0,18,108,126
"59507",2018,0,8,8,16
"59507",2020,0,18,134,152
"59508",2018,0,8,8,16
"59508",2020,0,18,134,152
"59509",2018,0,8,8,16
"59509",2020,0,18,134,152
"59511",2018,0,8,8,16
"59511",2020,0,18,216,234
"59512",2018,0,8,8,16
"59512",2020,0,18,134,152
"59513",2018,0,8,8,16
"59513",2020,0,18,108,126
"59514",2018,0,8,8,16
"59514",2019,0,0,59,59
"59514",2020,0,18,108,126
"59515",2018,0,8,8,16
"59515",2020,0,18,108,126
"59516",2018,0,8,162,170
"59516",2020,0,18,108,126
"59517",2018,0,8,8,16
"59517",2020,0,18,108,126
"59518",2018,0,8,8,16
"59518",2020,0,18,108,126
"59519",2018,0,8,8,16
"59519",2020,0,18,216,234
"59520",2018,0,8,8,16
"59520",2020,0,18,108,126
"59521",2018,0,8,8,16
"59521",2020,0,18,108,126
"59522",2018,0,8,8,16
"59522",2020,0,18,134,152
"59523",2018,0,8,8,16
"59523",2020,0,18,134,152
"59524",2018,0,8,8,16
"59524",2020,0,18,134,152
"59525",2018,0,8,8,16
"59525",2019,0,0,59,59
"59525",2020,0,18,108,126
"59526",2018,0,8,8,16
"59526",2020,0,18,216,234
"59527",2018,0,8,8,16
"59527",2020,0,18,134,152
"59528",2018,0,8,8,16
"59528",2020,0,18,108,126
"59529",2018,0,8,8,16
"59529",2019,0,0,59,59
"59529",2020,0,18,108,126
"59530",2018,0,8,8,16
"59530",2020,0,18,108,126
"59531",2018,0,8,8,16
"59531",2020,0,18,108,126
"59532",2018,0,8,162,170
"59532",2019,0,0,101,101
"59532",2020,0,18,216,234
"59533",2018,0,8,8,16
"59533",2020,0,18,108,126
"59534",2018,0,8,8,16
"59534",2019,0,0,59,59
"59534",2020,0,18,108,126
"59535",2018,0,8,162,170
"59535",2020,0,18,108,126
"59536",2018,0,8,162,170
"59536",2020,0,18,108,126
"59537",2018,0,8,8,16
"59537",2020,0,18,108,126
"59538",2018,0,8,162,170
"59538",2020,0,18,108,126
"59539",2018,0,8,162,170
"59539",2019,0,0,101,101
"59539",2020,0,18,216,234
"59541",2018,0,8,8,16
"59541",2020,0,18,108,126
"59542",2018,0,8,8,16
"59542",2019,0,0,59,59
"59542",2020,0,18,108,126
"59543",2018,0,8,8,16
"59543",2019,0,0,59,59
"59543",2020,0,18,108,126
"59544",2018,0,8,8,16
"59544",2020,0,18,108,126
"59545",2018,0,8,8,16
"59545",2020,0,18,108,126
"59546",2018,0,8,162,170
"59546",2020,0,18,108,126
"59547",2018,0,8,8,16
"59547",2020,0,18,108,126
"59548",2018,0,8,8,16
"59548",2020,0,18,108,126
"59549",2018,0,8,8,16
"59549",2020,0,18,108,126
"59550",2018,0,8,8,16
"59550",2020,0,18,134,152
"59551",2018,0,8,8,16
"59551",2020,0,18,216,234
"59552",2018,0,8,8,16
"59552",2020,0,18,108,126
"59553",2018,0,8,8,16
"59553",2020,0,18,134,152
"59554",2018,0,8,8,16
"59554",2020,0,18,216,234
"59555",2018,0,8,8,16
"59555",2019,0,0,59,59
"59555",2020,0,18,108,126
"59556",2018,0,8,8,16
"59556",2019,0,0,59,59
"59556",2020,0,18,108,126
"59557",2018,0,8,8,16
"59557",2020,0,18,108,126
"59558",2018,0,8,8,16
"59558",2020,0,18,108,126
"59559",2018,0,8,8,16
"59559",2020,0,18,108,126
"59560",2018,0,8,8,16
"59560",2020,0,18,134,152
"59562",2018,0,8,8,16
"59562",2019,0,0,59,59
"59562",2020,0,18,108,126
"59563",2018,0,8,8,16
"59563",2019,0,0,59,59
"59563",2020,0,18,108,126
"59564",2018,0,8,8,16
"59564",2020,0,18,108,126
"59565",2018,0,8,8,16
"59565",2020,0,18,108,126
"59566",2018,0,8,8,16
"59566",2020,0,18,134,152
"59567",2018,0,8,8,16
"59567",2020,0,18,108,126
"59568",2018,0,8,162,170
"59568",2020,0,18,216,234
"59569",2018,0,8,8,16
"59569",2020,0,18,108,126
"59570",2018,0,8,162,170
"59570",2020,0,18,108,126
"59571",2018,0,8,8,16
"59571",2020,0,18,108,126
"59572",2018,0,8,8,16
"59572",2019,0,0,59,59
"59572",2020,0,18,108,126
"59573",2018,0,8,8,16
"59573",2019,0,0,59,59
"59573",2020,0,18,108,126
"59574",2018,0,8,8,16
"59574",2020,0,18,216,234
"59575",2018,0,8,8,16
"59575",2020,0,18,108,126
"59576",2018,0,8,162,170
"59576",2019,0,0,101,101
"59576",2020,0,18,216,234
"59577",2018,0,8,162,170
"59577",2020,0,18,108,126
"59578",2018,0,8,162,170
"59578",2020,0,18,216,234
"59579",2018,0,8,162,170
"59579",2019,0,0,101,101
"59579",2020,0,18,216,234
"59580",2018,0,8,162,170
"59580",2020,0,18,108,126
"59581",2018,0,8,162,170
"59581",2020,0,18,216,234
"59582",2018,0,8,162,170
"59582",2020,0,18,216,234
"59583",2018,0,8,8,16
"59583",2019,0,0,59,59
"59583",2020,0,18,108,126
"59584",2018,0,8,8,16
"59584",2020,0,18,108,126
"59585",2018,0,8,8,16
"59585",2020,0,18,134,152
"59586",2018,0,8,8,16
"59586",2020,0,18,134,152
"59587",2018,0,8,162,170
"59587",2020,0,18,108,126
"59588",2018,0,8,162,170
"59588",2019,0,0,101,101
"59588",2020,0,18,216,234
"59589",2018,0,8,8,16
"59589",2020,0,18,108,126
"59590",2018,0,8,162,170
"59590",2020,0,18,216,234
"59591",2018,0,8,8,16
"59591",2020,0,18,108,126
"59592",2018,0,8,8,16
"59592",2020,0,18,134,152
"59593",2018,0,8,8,16
"59593",2020,0,18,108,126
"59594",2018,0,8,8,16
"59594",2020,0,18,216,234
"59595",2018,0,8,8,16
"59595",2020,0,18,108,126
"59596",2018,0,8,8,16
"59596",2020,0,18,216,234
"59597",2018,0,8,8,16
"59597",2020,0,18,108,126
"59598",2018,0,8,8,16
"59598",2020,0,18,134,152
"59599",2018,0,8,8,16
"59599",2020,0,18,134,152
"59600",2018,0,8,8,16
"59600",2020,0,18,134,152
"59601",2018,0,8,8,16
"59601",2019,0,0,59,59
"59601",2020,0,18,108,126
"59602",2018,0,8,8,16
"59602",2020,0,18,134,152
"59603",2018,0,8,8,16
"59603",2020,0,18,108,126
"59604",2018,0,8,8,16
"59604",2020,0,18,108,126
"59605",2018,0,8,162,170
"59605",2019,0,0,101,101
"59605",2020,0,18,216,234
"59606",2018,0,8,8,16
"59606",2020,0,18,108,126
"59607",2018,0,8,8,16
"59607",2020,0,18,108,126
"59608",2018,0,8,8,16
"59608",2020,0,18,108,126
"59609",2018,0,8,8,16
"59609",2020,0,18,134,152
"59610",2018,0,8,8,16
"59610",2020,0,18,108,126
"59611",2018,0,8,8,16
"59611",2020,0,18,134,152
"59612",2018,0,8,8,16
"59612",2020,0,18,108,126
"59613",2018,0,8,8,16
"59613",2020,0,18,108,126
"59614",2018,0,8,8,16
"59614",2020,0,18,108,126
"59615",2018,0,8,162,170
"59615",2020,0,18,216,234
"59616",2018,0,8,8,16
"59616",2020,0,18,108,126
"59617",2018,0,8,8,16
"59617",2020,0,18,108,126
"59618",2018,0,8,8,16
"59618",2020,0,18,108,126
"59619",2018,0,8,8,16
"59619",2020,0,18,108,126
"59620",2018,0,8,8,16
"59620",2020,0,18,108,126
"59622",2018,0,8,8,16
"59622",2020,0,18,108,126
"59623",2018,0,8,8,16
"59623",2020,0,18,108,126
"59624",2018,0,8,8,16
"59624",2020,0,18,108,126
"59625",2018,0,8,8,16
"59625",2020,0,18,108,126
"59626",2018,0,8,8,16
"59626",2020,0,18,108,126
"59627",2018,0,8,8,16
"59627",2020,0,18,108,126
"59628",2018,0,8,162,170
"59628",2020,0,18,108,126
"59629",2018,0,8,8,16
"59629",2020,0,18,216,234
"59630",2018,0,8,8,16
"59630",2020,0,18,134,152
"59631",2018,0,8,8,16
"59631",2020,0,18,108,126
"59632",2018,0,8,8,16
"59632",2020,0,18,108,126
"59633",2018,0,8,8,16
"59633",2019,0,0,59,59
"59633",2020,0,18,108,126
"59634",2018,0,8,162,170
"59634",2020,0,18,216,234
"59635",2018,0,8,8,16
"59635",2020,0,18,108,126
"59636",2018,0,8,8,16
"59636",2020,0,18,134,152
"59637",2018,0,8,8,16
"59637",2020,0,18,216,234
"59638",2018,0,8,8,16
"59638",2020,0,18,134,152
"59639",2018,0,8,8,16
"59639",2020,0,18,108,126
"59640",2018,0,8,8,16
"59640",2020,0,18,108,126
"59641",2018,0,8,162,170
"59641",2020,0,18,108,126
"59642",2018,0,8,8,16
"59642",2020,0,18,216,234
"59643",2018,0,8,8,16
"59643",2020,0,18,134,152
"59645",2018,0,8,8,16
"59645",2020,0,18,108,126
"59646",2018,0,8,8,16
"59646",2020,0,18,134,152
"59647",2018,0,8,162,170
"59647",2019,0,0,101,101
"59647",2020,0,18,216,234
"59648",2018,0,8,8,16
"59648",2020,0,18,134,152
"59649",2018,0,8,8,16
"59649",2019,0,0,59,59
"59649",2020,0,18,108,126
"59650",2018,0,8,8,16
"59650",2020,0,18,134,152
"59651",2018,0,8,8,16
"59651",2020,0,18,108,126
"59652",2018,0,8,8,16
"59652",2020,0,18,108,126
"59653",2018,0,8,8,16
"59653",2020,0,18,134,152
"59654",2018,0,8,8,16
"59654",2020,0,18,216,234
"59655",2018,0,8,162,170
"59655",2020,0,18,108,126
"59656",2018,0,8,8,16
"59656",2020,0,18,134,152
"59657",2018,0,8,162,170
"59657",2020,0,18,108,126
"59658",2018,0,8,8,16
"59658",2020,0,18,134,152
"59659",2018,0,8,8,16
"59659",2019,0,0,59,59
"59659",2020,0,18,108,126
"59660",2018,0,8,8,16
"59660",2020,0,18,134,152
"59661",2018,0,8,8,16
"59661",2019,0,0,59,59
"59661",2020,0,18,108,126
"59662",2018,0,8,162,170
"59662",2020,0,18,108,126
"59663",2018,0,8,162,170
"59663",2020,0,18,108,126
"59664",2018,0,8,162,170
"59664",2020,0,18,108,126
"59665",2018,0,8,162,170
"59665",2020,0,18,108,126
"59666",2018,0,8,162,170
"59666",2020,0,18,108,126
"59667",2018,0,8,162,170
"59667",2020,0,18,108,126
"59668",2018,0,8,162,170
"59668",2019,0,0,101,101
"59668",2020,0,18,216,234
"59669",2018,0,8,162,170
"59669",2020,0,18,108,126
"59670",2018,0,8,8,16
"59670",2020,0,18,134,152
"60001",2017,0,0,37,37
"60001",2019,0,0,65,65
"60001",2020,0,0,121,121
"60002",2015,0,0,84,84
"60002",2017,0,0,96,96
"60002",2019,0,0,28,28
"60003",2015,0,0,84,84
"60003",2017,0,0,133,133
"60003",2019,0,0,198,198
"60003",2020,0,0,240,240
"60004",2015,0,0,84,84
"60004",2017,0,0,96,96
"60004",2019,0,0,28,28
"60005",2015,0,0,33,33
"60005",2017,0,0,56,56
"60005",2019,0,0,49,49
"60005",2020,0,0,59,59
"60006",2015,0,0,15,15
"60006",2019,0,0,69,69
"60006",2020,0,0,13,13
"60007",2015,0,0,84,84
"60007",2017,0,0,133,133
"60007",2019,0,0,198,198
"60007",2020,0,0,240,240
"60008",2015,0,0,56,56
"60008",2017,0,0,83,83
"60008",2019,0,0,198,198
"60008",2020,0,0,240,240
"60009",2015,0,0,84,84
"60009",2017,0,0,96,96
"60009",2019,0,0,28,28
"60010",2015,0,0,15,15
"60010",2017,0,0,114,114
"60010",2019,0,0,125,125
"60010",2020,0,0,32,32
"60011",2015,0,0,28,28
"60011",2017,0,0,37,37
"60011",2019,0,0,25,25
"60011",2020,0,0,14,14
"60012",2017,0,0,46,46
"60013",2015,0,0,56,56
"60013",2017,0,0,83,83
"60013",2019,0,0,162,162
"60013",2020,0,0,187,187
"60014",2015,0,0,56,56
"60014",2017,0,0,37,37
"60014",2018,0,0,37,37
"60014",2019,0,0,42,42
"60015",2015,0,0,84,84
"60015",2017,0,0,96,96
"60015",2019,0,0,28,28
"60016",2015,0,0,84,84
"60016",2017,0,0,133,133
"60016",2019,0,0,198,198
"60016",2020,0,0,240,240
"60017",2015,0,0,56,56
"60017",2017,0,0,114,114
"60017",2019,0,0,97,97
"60017",2020,0,0,240,240
"60019",2015,0,0,15,15
"60019",2017,0,0,56,56
"60019",2018,0,0,37,37
"60019",2019,0,0,42,42
"60020",2015,0,0,33,33
"60020",2017,0,0,56,56
"60020",2019,0,0,49,49
"60020",2020,0,0,59,59
"60021",2015,0,0,15,15
"60021",2019,0,0,69,69
"60021",2020,0,0,13,13
"60022",2015,0,0,15,15
"60022",2017,0,0,19,19
"60022",2018,0,0,46,46
"60022",2019,0,0,162,162
"60022",2020,0,0,187,187
"60023",2015,0,0,15,15
"60023",2019,0,0,69,69
"60023",2020,0,0,13,13
"60024",2015,0,0,15,15
"60024",2017,0,0,37,37
"60024",2018,0,0,37,37
"60024",2019,0,0,42,42
"60025",2015,0,0,15,15
"60025",2019,0,0,69,69
"60025",2020,0,0,13,13
"60026",2015,0,0,84,84
"60026",2017,0,0,133,133
"60026",2019,0,0,198,198
"60026",2020,0,0,240,240
"60027",2015,0,0,20,20
"60027",2017,0,0,19,19
"60027",2018,0,0,136,136
"60027",2019,0,0,198,198
"60027",2020,0,0,233,233
"60028",2015,0,0,15,15
"60028",2017,0,0,19,19
"60028",2018,0,0,46,46
"60028",2019,0,0,162,162
"60028",2020,0,0,187,187
"60029",2015,0,0,84,84
"60029",2017,0,0,133,133
"60029",2019,0,0,153,153
"60029",2020,0,0,32,32
"60030",2015,0,0,84,84
"60030",2017,0,0,133,133
"60030",2019,0,0,153,153
"60030",2020,0,0,32,32
"60031",2015,0,0,33,33
"60031",2017,0,0,56,56
"60031",2019,0,0,49,49
"60031",2020,0,0,59,59
"60032",2015,0,0,15,15
"60032",2019,0,0,69,69
"60032",2020,0,0,13,13
"60033",2017,0,0,19,19
"60033",2018,0,0,46,46
"60033",2019,0,0,198,198
"60033",2020,0,0,174,174
"60034",2015,0,0,56,56
"60034",2017,0,0,83,83
"60034",2019,0,0,198,198
"60034",2020,0,0,240,240
"60035",2015,0,0,28,28
"60035",2017,0,0,37,37
"60035",2019,0,0,56,56
"60035",2020,0,0,14,14
"60036",2015,0,0,56,56
"60036",2017,0,0,37,37
"60036",2018,0,0,37,37
"60036",2019,0,0,42,42
"60037",2015,0,0,28,28
"60037",2017,0,0,37,37
"60037",2019,0,0,25,25
"60037",2020,0,0,14,14
"60039",2017,0,0,77,77
"60039",2019,0,0,83,83
"60039",2020,0,0,32,32
"60040",2015,0,0,56,56
"60040",2017,0,0,37,37
"60040",2018,0,0,37,37
"60040",2019,0,0,42,42
"60041",2015,0,0,84,84
"60041",2017,0,0,96,96
"60041",2019,0,0,28,28
"60042",2015,0,0,56,56
"60042",2017,0,0,83,83
"60042",2019,0,0,162,162
"60042",2020,0,0,187,187
"60043",2015,0,0,15,15
"60043",2019,0,0,69,69
"60043",2020,0,0,13,13
"60044",2015,0,0,84,84
"60044",2017,0,0,96,96
"60044",2019,0,0,28,28
"60045",2017,0,0,19,19
"60045",2018,0,0,46,46
"60045",2019,0,0,198,198
"60045",2020,0,0,174,174
"60046",2015,0,0,33,33
"60046",2017,0,0,56,56
"60046",2019,0,0,49,49
"60046",2020,0,0,59,59
"60047",2017,0,0,19,19
"60047",2018,0,0,46,46
"60047",2019,0,0,198,198
"60047",2020,0,0,174,174
"60048",2015,0,0,15,15
"60048",2017,0,0,37,37
"60048",2018,0,0,37,37
"60048",2019,0,0,42,42
"60049",2015,0,0,84,84
"60049",2017,0,0,133,133
"60049",2019,0,0,153,153
"60049",2020,0,0,32,32
"60050",2015,0,0,15,15
"60050",2019,0,0,69,69
"60050",2020,0,0,13,13
"60051",2017,0,0,46,46
"60052",2015,0,0,28,28
"60052",2017,0,0,37,37
"60052",2019,0,0,25,25
"60052",2020,0,0,14,14
"60053",2015,0,0,28,28
"60053",2017,0,0,37,37
"60053",2019,0,0,56,56
"60053",2020,0,0,14,14
"60054",2015,0,0,84,84
"60054",2017,0,0,133,133
"60054",2019,0,0,153,153
"60054",2020,0,0,32,32
"60055",2015,0,0,28,28
"60055",2017,0,0,37,37
"60055",2019,0,0,25,25
"60055",2020,0,0,14,14
"60056",2015,0,0,15,15
"60056",2019,0,0,69,69
"60056",2020,0,0,13,13
"60057",2015,0,0,84,84
"60057",2017,0,0,96,96
"60057",2019,0,0,28,28
"60058",2017,0,0,77,77
"60058",2019,0,0,83,83
"60058",2020,0,0,32,32
"60059",2015,0,0,28,28
"60059",2017,0,0,37,37
"60059",2019,0,0,25,25
"60059",2020,0,0,14,14
"60060",2017,0,0,46,46
"60061",2015,0,0,15,15
"60061",2017,0,0,56,56
"60061",2018,0,0,37,37
"60061",2019,0,0,42,42
"60062",2015,0,0,28,28
"60062",2017,0,0,37,37
"60062",2019,0,0,56,56
"60062",2020,0,0,14,14
"60063",2015,0,0,84,84
"60063",2017,0,0,133,133
"60063",2019,0,0,153,153
"60063",2020,0,0,32,32
"60064",2015,0,0,15,15
"60064",2019,0,0,69,69
"60064",2020,0,0,13,13
"60065",2015,0,0,84,84
"60065",2017,0,0,96,96
"60065",2019,0,0,28,28
"60066",2015,0,0,20,20
"60066",2017,0,0,19,19
"60066",2018,0,0,136,136
"60066",2019,0,0,167,167
"60066",2020,0,0,59,59
"60067",2015,0,0,20,20
"60067",2017,0,0,19,19
"60067",2018,0,0,136,136
"60067",2019,0,0,167,167
"60067",2020,0,0,59,59
"60068",2015,0,0,20,20
"60068",2017,0,0,19,19
"60068",2018,0,0,136,136
"60068",2019,0,0,131,131
"60068",2020,0,0,27,27
"60069",2015,0,0,33,33
"60069",2017,0,0,56,56
"60069",2019,0,0,49,49
"60069",2020,0,0,59,59
"60070",2015,0,0,15,15
"60070",2017,0,0,37,37
"60070",2018,0,0,37,37
"60070",2019,0,0,42,42
"60071",2017,0,0,56,56
"60071",2018,0,0,99,99
"60071",2019,0,0,62,62
"60071",2020,0,0,80,80
"60072",2015,0,0,15,15
"60072",2019,0,0,69,69
"60072",2020,0,0,13,13
"60073",2015,0,0,84,84
"60073",2017,0,0,96,96
"60073",2019,0,0,28,28
"60074",2015,0,0,84,84
"60074",2017,0,0,96,96
"60074",2019,0,0,97,97
"60074",2020,0,0,13,13
"60075",2017,0,0,77,77
"60075",2019,0,0,83,83
"60075",2020,0,0,32,32
"60076",2015,0,0,84,84
"60076",2017,0,0,37,37
"60076",2019,0,0,93,93
"60076",2020,0,0,121,121
"60077",2015,0,0,84,84
"60077",2017,0,0,96,96
"60077",2019,0,0,28,28
"60078",2015,0,0,15,15
"60078",2017,0,0,37,37
"60078",2018,0,0,37,37
"60078",2019,0,0,42,42
"60079",2015,0,0,20,20
"60079",2017,0,0,56,56
"60079",2018,0,0,136,136
"60079",2019,0,0,119,119
"60079",2020,0,0,233,233
"60081",2015,0,0,84,84
"60081",2017,0,0,96,96
"60081",2019,0,0,28,28
"60082",2017,0,0,77,77
"60082",2019,0,0,83,83
"60082",2020,0,0,32,32
"60083",2015,0,0,20,20
"60083",2017,0,0,19,19
"60083",2018,0,0,136,136
"60083",2019,0,0,167,167
"60083",2020,0,0,59,59
"60084",2015,0,0,84,84
"60084",2017,0,0,96,96
"60084",2019,0,0,28,28
"60085",2015,0,0,56,56
"60085",2017,0,0,114,114
"60085",2019,0,0,97,97
"60085",2020,0,0,240,240
"60086",2015,0,0,15,15
"60086",2017,0,0,19,19
"60086",2018,0,0,46,46
"60086",2019,0,0,162,162
"60086",2020,0,0,187,187
"60087",2017,0,0,19,19
"60087",2018,0,0,46,46
"60087",2019,0,0,198,198
"60087",2020,0,0,174,174
"60088",2017,0,0,46,46
"60089",2015,0,0,15,15
"60089",2017,0,0,114,114
"60089",2019,0,0,125,125
"60089",2020,0,0,32,32
"60090",2015,0,0,15,15
"60090",2017,0,0,114,114
"60090",2019,0,0,125,125
"60090",2020,0,0,32,32
"60091",2015,0,0,33,33
"60091",2017,0,0,56,56
"60091",2019,0,0,49,49
"60091",2020,0,0,59,59
"60092",2015,0,0,33,33
"60092",2017,0,0,56,56
"60092",2019,0,0,49,49
"60092",2020,0,0,59,59
"60093",2017,0,0,56,56
"60093",2018,0,0,99,99
"60093",2019,0,0,62,62
"60093",2020,0,0,80,80
"60094",2015,0,0,33,33
"60094",2017,0,0,56,56
"60094",2019,0,0,49,49
"60094",2020,0,0,59,59
"60095",2015,0,0,15,15
"60095",2017,0,0,114,114
"60095",2019,0,0,125,125
"60095",2020,0,0,32,32
"60097",2015,0,0,15,15
"60097",2017,0,0,114,114
"60097",2019,0,0,125,125
"60097",2020,0,0,32,32
"60098",2015,0,0,84,84
"60098",2017,0,0,37,37
"60098",2019,0,0,93,93
"60098",2020,0,0,121,121
"60099",2015,0,0,15,15
"60099",2017,0,0,56,56
"60099",2018,0,0,37,37
"60099",2019,0,0,42,42
"60100",2017,0,0,19,19
"60100",2018,0,0,46,46
"60100",2019,0,0,198,198
"60100",2020,0,0,174,174
"60101",2015,0,0,33,33
"60101",2017,0,0,56,56
"60101",2019,0,0,49,49
"60101",2020,0,0,59,59
"60102",2015,0,0,15,15
"60102",2019,0,0,69,69
"60102",2020,0,0,13,13
"60103",2015,0,0,84,84
"60103",2017,0,0,133,133
"60103",2019,0,0,198,198
"60103",2020,0,0,240,240
"60104",2017,0,0,77,77
"60104",2019,0,0,83,83
"60104",2020,0,0,32,32
"60105",2015,0,0,15,15
"60105",2019,0,0,69,69
"60105",2020,0,0,13,13
"60106",2015,0,0,56,56
"60106",2017,0,0,83,83
"60106",2019,0,0,198,198
"60106",2020,0,0,240,240
"60107",2015,0,0,56,56
"60107",2017,0,0,83,83
"60107",2019,0,0,198,198
"60107",2020,0,0,240,240
"60108",2015,0,0,84,84
"60108",2017,0,0,96,96
"60108",2019,0,0,28,28
"60109",2015,0,0,84,84
"60109",2017,0,0,96,96
"60109",2019,0,0,28,28
"60110",2015,0,0,84,84
"60110",2017,0,0,96,96
"60110",2019,0,0,28,28
"60111",2017,0,0,77,77
"60111",2019,0,0,83,83
"60111",2020,0,0,32,32
"60112",2015,0,0,56,56
"60112",2017,0,0,37,37
"60112",2018,0,0,37,37
"60112",2019,0,0,25,25
"60113",2015,0,0,56,56
"60113",2017,0,0,83,83
"60113",2019,0,0,198,198
"60113",2020,0,0,240,240
"60114",2015,0,0,84,84
"60114",2017,0,0,133,133
"60114",2019,0,0,153,153
"60114",2020,0,0,32,32
"60115",2015,0,0,56,56
"60115",2017,0,0,83,83
"60115",2019,0,0,198,198
"60115",2020,0,0,240,240
"60116",2015,0,0,84,84
"60116",2017,0,0,133,133
"60116",2019,0,0,198,198
"60116",2020,0,0,240,240
"60117",2015,0,0,28,28
"60117",2017,0,0,37,37
"60117",2019,0,0,25,25
"60117",2020,0,0,14,14
"60118",2015,0,0,15,15
"60118",2019,0,0,69,69
"60118",2020,0,0,13,13
"60119",2015,0,0,15,15
"60119",2017,0,0,56,56
"60119",2018,0,0,99,99
"60119",2019,0,0,62,62
"60119",2020,0,0,27,27
"60120",2015,0,0,84,84
"60120",2017,0,0,133,133
"60120",2019,0,0,198,198
"60120",2020,0,0,240,240
"60121",2015,0,0,28,28
"60121",2017,0,0,37,37
"60121",2019,0,0,25,25
"60121",2020,0,0,14,14
"60122",2015,0,0,84,84
"60122",2017,0,0,96,96
"60122",2019,0,0,28,28
"60123",2015,0,0,56,56
"60123",2017,0,0,114,114
"60123",2019,0,0,97,97
"60123",2020,0,0,240,240
"60124",2015,0,0,28,28
"60124",2017,0,0,37,37
"60124",2019,0,0,56,56
"60124",2020,0,0,14,14
"60125",2015,0,0,15,15
"60125",2019,0,0,69,69
"60125",2020,0,0,13,13
"60126",2015,0,0,28,28
"60126",2017,0,0,37,37
"60126",2019,0,0,25,25
"60126",2020,0,0,14,14
"60127",2015,0,0,28,28
"60127",2017,0,0,37,37
"60127",2019,0,0,25,25
"60127",2020,0,0,14,14
"60128",2015,0,0,84,84
"60128",2017,0,0,96,96
"60128",2019,0,0,28,28
"60129",2015,0,0,15,15
"60129",2019,0,0,69,69
"60129",2020,0,0,13,13
"60130",2015,0,0,56,56
"60130",2017,0,0,83,83
"60130",2019,0,0,162,162
"60130",2020,0,0,187,187
"60131",2017,0,0,46,46
"60132",2015,0,0,28,28
"60132",2017,0,0,37,37
"60132",2019,0,0,25,25
"60132",2020,0,0,14,14
"60133",2015,0,0,56,56
"60133",2017,0,0,114,114
"60133",2019,0,0,97,97
"60133",2020,0,0,240,240
"60134",2015,0,0,84,84
"60134",2017,0,0,133,133
"60134",2019,0,0,198,198
"60134",2020,0,0,240,240
"60135",2015,0,0,84,84
"60135",2017,0,0,96,96
"60135",2019,0,0,28,28
"60136",2017,0,0,46,46
"60137",2015,0,0,56,56
"60137",2017,0,0,37,37
"60137",2018,0,0,37,37
"60137",2019,0,0,42,42
"60138",2015,0,0,15,15
"60138",2017,0,0,19,19
"60138",2018,0,0,46,46
"60138",2019,0,0,162,162
"60138",2020,0,0,187,187
"60139",2015,0,0,15,15
"60139",2017,0,0,46,46
"60139",2019,0,0,69,69
"60139",2020,0,0,13,13
"60140",2015,0,0,15,15
"60140",2017,0,0,114,114
"60140",2019,0,0,125,125
"60140",2020,0,0,32,32
"60141",2015,0,0,15,15
"60141",2017,0,0,19,19
"60141",2018,0,0,46,46
"60141",2019,0,0,162,162
"60141",2020,0,0,187,187
"60142",2017,0,0,19,19
"60142",2018,0,0,46,46
"60142",2019,0,0,198,198
"60142",2020,0,0,174,174
"60143",2015,0,0,15,15
"60143",2017,0,0,114,114
"60143",2019,0,0,125,125
"60143",2020,0,0,32,32
"60144",2015,0,0,15,15
"60144",2017,0,0,114,114
"60144",2019,0,0,125,125
"60144",2020,0,0,32,32
"60145",2015,0,0,15,15
"60145",2019,0,0,69,69
"60145",2020,0,0,13,13
"60146",2017,0,0,77,77
"60146",2019,0,0,83,83
"60146",2020,0,0,32,32
"60147",2015,0,0,28,28
"60147",2017,0,0,37,37
"60147",2019,0,0,25,25
"60147",2020,0,0,14,14
"60148",2015,0,0,33,33
"60148",2017,0,0,56,56
"60148",2018,0,0,46,46
"60148",2019,0,0,119,119
"60148",2020,0,0,233,233
"60149",2015,0,0,15,15
"60149",2019,0,0,69,69
"60149",2020,0,0,13,13
"60150",2015,0,0,28,28
"60150",2017,0,0,37,37
"60150",2019,0,0,25,25
"60150",2020,0,0,14,14
"60151",2015,0,0,15,15
"60151",2017,0,0,37,37
"60151",2018,0,0,37,37
"60151",2019,0,0,42,42
"60152",2015,0,0,15,15
"60152",2017,0,0,37,37
"60152",2018,0,0,37,37
"60152",2019,0,0,42,42
"60153",2017,0,0,46,46
"60154",2015,0,0,15,15
"60154",2019,0,0,69,69
"60154",2020,0,0,13,13
"60155",2015,0,0,84,84
"60155",2017,0,0,96,96
"60155",2019,0,0,97,97
"60155",2020,0,0,13,13
"60156",2015,0,0,15,15
"60156",2017,0,0,37,37
"60156",2018,0,0,37,37
"60156",2019,0,0,42,42
"60157",2015,0,0,56,56
"60157",2017,0,0,83,83
"60157",2019,0,0,198,198
"60157",2020,0,0,240,240
"60158",2015,0,0,15,15
"60158",2017,0,0,37,37
"60158",2018,0,0,37,37
"60158",2019,0,0,25,25
"60159",2015,0,0,15,15
"60159",2017,0,0,37,37
"60159",2018,0,0,37,37
"60159",2019,0,0,42,42
"60160",2017,0,0,56,56
"60160",2018,0,0,99,99
"60160",2019,0,0,62,62
"60160",2020,0,0,80,80
"60161",2017,0,0,46,46
"60162",2015,0,0,15,15
"60162",2017,0,0,114,114
"60162",2019,0,0,125,125
"60162",2020,0,0,32,32
"60163",2017,0,0,77,77
"60163",2019,0,0,83,83
"60163",2020,0,0,32,32
"60164",2015,0,0,84,84
"60164",2017,0,0,133,133
"60164",2019,0,0,153,153
"60164",2020,0,0,32,32
"60165",2015,0,0,84,84
"60165",2017,0,0,96,96
"60165",2019,0,0,28,28
"60166",2015,0,0,15,15
"60166",2017,0,0,37,37
"60166",2018,0,0,37,37
"60166",2019,0,0,42,42
"60167",2015,0,0,15,15
"60167",2019,0,0,69,69
"60167",2020,0,0,13,13
"60168",2015,0,0,15,15
"60168",2017,0,0,37,37
"60168",2018,0,0,37,37
"60168",2019,0,0,25,25
"60169",2015,0,0,15,15
"60169",2017,0,0,114,114
"60169",2019,0,0,125,125
"60169",2020,0,0,32,32
"60170",2017,0,0,19,19
"60170",2018,0,0,46,46
"60170",2019,0,0,198,198
"60170",2020,0,0,174,174
"60171",2015,0,0,15,15
"60171",2019,0,0,69,69
"60171",2020,0,0,13,13
"60172",2017,0,0,19,19
"60172",2018,0,0,46,46
"60172",2019,0,0,198,198
"60172",2020,0,0,174,174
"60173",2015,0,0,84,84
"60173",2017,0,0,96,96
"60173",2019,0,0,97,97
"60173",2020,0,0,13,13
"60174",2017,0,0,56,56
"60174",2018,0,0,99,99
"60174",2019,0,0,25,25
"60174",2020,0,0,80,80
"60175",2015,0,0,84,84
"60175",2017,0,0,56,56
"60175",2018,0,0,46,46
"60175",2019,0,0,162,162
"60175",2020,0,0,187,187
"60176",2015,0,0,20,20
"60176",2017,0,0,56,56
"60176",2018,0,0,136,136
"60176",2019,0,0,88,88
"60176",2020,0,0,59,59
"60177",2015,0,0,15,15
"60177",2017,0,0,37,37
"60177",2018,0,0,37,37
"60177",2019,0,0,42,42
"60178",2015,0,0,84,84
"60178",2017,0,0,96,96
"60178",2019,0,0,28,28
"60179",2015,0,0,15,15
"60179",2017,0,0,37,37
"60179",2018,0,0,37,37
"60179",2019,0,0,25,25
"60180",2015,0,0,84,84
"60180",2017,0,0,96,96
"60180",2019,0,0,28,28
"60181",2015,0,0,28,28
"60181",2017,0,0,37,37
"60181",2019,0,0,25,25
"60181",2020,0,0,14,14
"60182",2017,0,0,77,77
"60182",2019,0,0,83,83
"60182",2020,0,0,32,32
"60183",2017,0,0,77,77
"60183",2019,0,0,83,83
"60183",2020,0,0,32,32
"60184",2015,0,0,15,15
"60184",2019,0,0,69,69
"60184",2020,0,0,13,13
"60185",2015,0,0,15,15
"60185",2017,0,0,46,46
"60185",2019,0,0,69,69
"60185",2020,0,0,13,13
"60186",2015,0,0,56,56
"60186",2017,0,0,37,37
"60186",2018,0,0,37,37
"60186",2019,0,0,42,42
"60187",2015,0,0,84,84
"60187",2017,0,0,133,133
"60187",2019,0,0,153,153
"60187",2020,0,0,32,32
"60188",2015,0,0,15,15
"60188",2019,0,0,69,69
"60188",2020,0,0,13,13
"60189",2015,0,0,15,15
"60189",2019,0,0,69,69
"60189",2020,0,0,13,13
"60190",2015,0,0,33,33
"60190",2017,0,0,56,56
"60190",2019,0,0,49,49
"60190",2020,0,0,59,59
"60191",2015,0,0,15,15
"60191",2017,0,0,56,56
"60191",2018,0,0,37,37
"60191",2019,0,0,25,25
"60192",2015,0,0,28,28
"60192",2017,0,0,37,37
"60192",2019,0,0,25,25
"60192",2020,0,0,14,14
"60193",2017,0,0,46,46
"60194",2017,0,0,46,46
"60195",2015,0,0,15,15
"60195",2017,0,0,114,114
"60195",2019,0,0,125,125
"60195",2020,0,0,32,32
"60196",2015,0,0,84,84
"60196",2017,0,0,133,133
"60196",2019,0,0,153,153
"60196",2020,0,0,32,32
"60197",2015,0,0,84,84
"60197",2017,0,0,96,96
"60197",2019,0,0,28,28
"60198",2015,0,0,28,28
"60198",2017,0,0,37,37
"60198",2019,0,0,25,25
"60198",2020,0,0,14,14
"60199",2015,0,0,56,56
"60199",2017,0,0,83,83
"60199",2019,0,0,198,198
"60199",2020,0,0,240,240
"60200",2017,0,0,77,77
"60200",2019,0,0,83,83
"60200",2020,0,0,32,32
"60201",2017,0,0,77,77
"60201",2019,0,0,83,83
"60201",2020,0,0,32,32
"60203",2015,0,0,20,20
"60203",2017,0,0,19,19
"60203",2018,0,0,136,136
"60203",2019,0,0,198,198
"60203",2020,0,0,233,233
"60204",2015,0,0,28,28
"60204",2017,0,0,37,37
"60204",2019,0,0,25,25
"60204",2020,0,0,14,14
"60205",2017,0,0,46,46
"60206",2015,0,0,28,28
"60206",2017,0,0,37,37
"60206",2019,0,0,25,25
"60206",2020,0,0,14,14
"60207",2015,0,0,20,20
"60207",2017,0,0,19,19
"60207",2018,0,0,136,136
"60207",2019,0,0,167,167
"60207",2020,0,0,59,59
"60208",2015,0,0,15,15
"60208",2017,0,0,114,114
"60208",2019,0,0,125,125
"60208",2020,0,0,32,32
"60209",2015,0,0,15,15
"60209",2017,0,0,114,114
"60209",2019,0,0,125,125
"60209",2020,0,0,32,32
"60210",2015,0,0,56,56
"60210",2017,0,0,37,37
"60210",2018,0,0,37,37
"60210",2019,0,0,42,42
"60211",2015,0,0,15,15
"60211",2017,0,0,114,114
"60211",2019,0,0,125,125
"60211",2020,0,0,32,32
"60212",2015,0,0,84,84
"60212",2017,0,0,96,96
"60212",2019,0,0,97,97
"60212",2020,0,0,13,13
"60213",2015,0,0,33,33
"60213",2017,0,0,56,56
"60213",2018,0,0,46,46
"60213",2019,0,0,119,119
"60213",2020,0,0,233,233
"60214",2015,0,0,84,84
"60214",2017,0,0,96,96
"60214",2019,0,0,28,28
"60215",2015,0,0,56,56
"60215",2017,0,0,83,83
"60215",2019,0,0,198,198
"60215",2020,0,0,240,240
"60216",2015,0,0,56,56
"60216",2017,0,0,37,37
"60216",2018,0,0,37,37
"60216",2019,0,0,42,42
"60217",2015,0,0,84,84
"60217",2017,0,0,133,133
"60217",2019,0,0,153,153
"60217",2020,0,0,32,32
"60218",2017,0,0,46,46
"60219",2017,0,0,37,37
"60219",2019,0,0,65,65
"60219",2020,0,0,121,121
"60220",2015,0,0,84,84
"60220",2017,0,0,133,133
"60220",2019,0,0,153,153
"60220",2020,0,0,32,32
"60221",2017,0,0,77,77
"60221",2019,0,0,83,83
"60221",2020,0,0,32,32
"60222",2015,0,0,84,84
"60222",2017,0,0,133,133
"60222",2019,0,0,198,198
"60222",2020,0,0,240,240
"60223",2015,0,0,15,15
"60223",2017,0,0,37,37
"60223",2018,0,0,37,37
"60223",2019,0,0,42,42
"60224",2015,0,0,33,33
"60224",2017,0,0,56,56
"60224",2019,0,0,49,49
"60224",2020,0,0,59,59
"60225",2015,0,0,84,84
"60225",2017,0,0,133,133
"60225",2019,0,0,198,198
"60225",2020,0,0,240,240
"60226",2015,0,0,33,33
"60226",2017,0,0,56,56
"60226",2018,0,0,46,46
"60226",2019,0,0,119,119
"60226",2020,0,0,233,233
"60227",2015,0,0,28,28
"60227",2017,0,0,37,37
"60227",2019,0,0,25,25
"60227",2020,0,0,14,14
"60228",2015,0,0,15,15
"60228",2017,0,0,114,114
"60228",2019,0,0,125,125
"60228",2020,0,0,32,32
"60229",2015,0,0,15,15
"60229",2019,0,0,69,69
"60229",2020,0,0,13,13
"60230",2015,0,0,84,84
"60230",2017,0,0,133,133
"60230",2019,0,0,198,198
"60230",2020,0,0,240,240
"60231",2015,0,0,20,20
"60231",2017,0,0,19,19
"60231",2018,0,0,136,136
"60231",2019,0,0,167,167
"60231",2020,0,0,59,59
"60232",2015,0,0,15,15
"60232",2017,0,0,37,37
"60232",2018,0,0,37,37
"60232",2019,0,0,25,25
"60233",2015,0,0,84,84
"60233",2017,0,0,96,96
"60233",2019,0,0,28,28
"60234",2015,0,0,56,56
"60234",2017,0,0,83,83
"60234",2019,0,0,198,198
"60234",2020,0,0,240,240
"60235",2015,0,0,15,15
"60235",2017,0,0,114,114
"60235",2019,0,0,125,125
"60235",2020,0,0,32,32
"60236",2015,0,0,28,28
"60236",2017,0,0,37,37
"60236",2019,0,0,56,56
"60236",2020,0,0,14,14
"60237",2017,0,0,77,77
"60237",2019,0,0,83,83
"60237",2020,0,0,32,32
"60238",2015,0,0,15,15
"60238",2017,0,0,19,19
"60238",2018,0,0,46,46
"60238",2019,0,0,162,162
"60238",2020,0,0,187,187
"60239",2015,0,0,15,15
"60239",2017,0,0,114,114
"60239",2019,0,0,125,125
"60239",2020,0,0,32,32
"60240",2017,0,0,46,46
"60241",2017,0,0,19,19
"60241",2018,0,0,46,46
"60241",2019,0,0,198,198
"60241",2020,0,0,174,174
"60242",2015,0,0,84,84
"60242",2017,0,0,96,96
"60242",2019,0,0,28,28
"60243",2015,0,0,84,84
"60243",2017,0,0,96,96
"60243",2019,0,0,28,28
"60244",2015,0,0,84,84
"60244",2017,0,0,133,133
"60244",2019,0,0,153,153
"60244",2020,0,0,32,32
"60245",2015,0,0,84,84
"60245",2017,0,0,37,37
"60245",2019,0,0,93,93
"60245",2020,0,0,121,121
"60247",2015,0,0,56,56
"60247",2017,0,0,37,37
"60247",2018,0,0,37,37
"60247",2019,0,0,42,42
"60248",2017,0,0,37,37
"60248",2019,0,0,65,65
"60248",2020,0,0,121,121
"60249",2015,0,0,84,84
"60249",2017,0,0,96,96
"60249",2019,0,0,28,28
"60250",2015,0,0,84,84
"60250",2017,0,0,96,96
"60250",2019,0,0,28,28
"60251",2015,0,0,84,84
"60251",2017,0,0,133,133
"60251",2019,0,0,198,198
"60251",2020,0,0,240,240
"60252",2015,0,0,56,56
"60252",2017,0,0,83,83
"60252",2019,0,0,198,198
"60252",2020,0,0,240,240
"60253",2015,0,0,84,84
"60253",2017,0,0,133,133
"60253",2019,0,0,97,97
"60253",2020,0,0,240,240
"60254",2015,0,0,15,15
"60254",2017,0,0,37,37
"60254",2018,0,0,37,37
"60254",2019,0,0,42,42
"60255",2015,0,0,28,28
"60255",2017,0,0,37,37
"60255",2019,0,0,56,56
"60255",2020,0,0,14,14
"60256",2015,0,0,15,15
"60256",2017,0,0,114,114
"60256",2019,0,0,125,125
"60256",2020,0,0,32,32
"60257",2015,0,0,15,15
"60257",2017,0,0,114,114
"60257",2019,0,0,125,125
"60257",2020,0,0,32,32
"60258",2015,0,0,28,28
"60258",2017,0,0,37,37
"60258",2019,0,0,25,25
"60258",2020,0,0,14,14
"60259",2015,0,0,15,15
"60259",2017,0,0,46,46
"60259",2019,0,0,69,69
"60259",2020,0,0,13,13
"60260",2015,0,0,20,20
"60260",2017,0,0,19,19
"60260",2018,0,0,136,136
"60260",2019,0,0,167,167
"60260",2020,0,0,59,59
"60261",2015,0,0,20,20
"60261",2017,0,0,19,19
"60261",2018,0,0,136,136
"60261",2019,0,0,198,198
"60261",2020,0,0,233,233
"60262",2017,0,0,77,77
"60262",2019,0,0,83,83
"60262",2020,0,0,32,32
"60263",2015,0,0,28,28
"60263",2017,0,0,37,37
"60263",2019,0,0,56,56
"60263",2020,0,0,14,14
"60264",2015,0,0,84,84
"60264",2017,0,0,96,96
"60264",2019,0,0,28,28
"60265",2015,0,0,56,56
"60265",2017,0,0,114,114
"60265",2019,0,0,97,97
"60265",2020,0,0,240,240
"60267",2017,0,0,46,46
"60268",2015,0,0,56,56
"60268",2017,0,0,114,114
"60268",2019,0,0,97,97
"60268",2020,0,0,240,240
"60269",2015,0,0,84,84
"60269",2017,0,0,96,96
"60269",2019,0,0,28,28
"60270",2015,0,0,28,28
"60270",2017,0,0,37,37
"60270",2019,0,0,25,25
"60270",2020,0,0,14,14
"60271",2015,0,0,84,84
"60271",2017,0,0,96,96
"60271",2019,0,0,28,28
"60272",2015,0,0,20,20
"60272",2017,0,0,19,19
"60272",2018,0,0,136,136
"60272",2019,0,0,167,167
"60272",2020,0,0,59,59
"60273",2015,0,0,15,15
"60273",2017,0,0,37,37
"60273",2018,0,0,37,37
"60273",2019,0,0,42,42
"60274",2015,0,0,20,20
"60274",2017,0,0,19,19
"60274",2018,0,0,136,136
"60274",2019,0,0,167,167
"60274",2020,0,0,59,59
"60275",2015,0,0,84,84
"60275",2017,0,0,96,96
"60275",2019,0,0,28,28
"60276",2015,0,0,15,15
"60276",2017,0,0,37,37
"60276",2018,0,0,37,37
"60276",2019,0,0,25,25
"60277",2015,0,0,84,84
"60277",2017,0,0,96,96
"60277",2019,0,0,28,28
"60278",2015,0,0,28,28
"60278",2017,0,0,37,37
"60278",2019,0,0,56,56
"60278",2020,0,0,14,14
"60279",2015,0,0,20,20
"60279",2017,0,0,56,56
"60279",2018,0,0,136,136
"60279",2019,0,0,88,88
"60279",2020,0,0,59,59
"60280",2017,0,0,37,37
"60280",2019,0,0,65,65
"60280",2020,0,0,121,121
"60281",2015,0,0,15,15
"60281",2017,0,0,56,56
"60281",2018,0,0,37,37
"60281",2019,0,0,42,42
"60282",2015,0,0,15,15
"60282",2017,0,0,19,19
"60282",2018,0,0,46,46
"60282",2019,0,0,162,162
"60282",2020,0,0,187,187
"60283",2017,0,0,77,77
"60283",2019,0,0,83,83
"60283",2020,0,0,32,32
"60284",2015,0,0,15,15
"60284",2017,0,0,37,37
"60284",2018,0,0,37,37
"60284",2019,0,0,42,42
"60285",2015,0,0,15,15
"60285",2017,0,0,37,37
"60285",2018,0,0,37,37
"60285",2019,0,0,42,42
"60286",2015,0,0,84,84
"60286",2017,0,0,96,96
"60286",2019,0,0,28,28
"60287",2015,0,0,28,28
"60287",2017,0,0,37,37
"60287",2019,0,0,25,25
"60287",2020,0,0,14,14
"60288",2015,0,0,84,84
"60288",2017,0,0,96,96
"60288",2019,0,0,28,28
"60289",2015,0,0,84,84
"60289",2017,0,0,96,96
"60289",2019,0,0,28,28
"60290",2015,0,0,84,84
"60290",2017,0,0,96,96
"60290",2019,0,0,28,28
"60291",2015,0,0,28,28
"60291",2017,0,0,37,37
"60291",2019,0,0,56,56
"60291",2020,0,0,14,14
"60292",2015,0,0,28,28
"60292",2017,0,0,37,37
"60292",2019,0,0,25,25
"60292",2020,0,0,14,14
"60293",2015,0,0,15,15
"60293",2017,0,0,114,114
"60293",2019,0,0,125,125
"60293",2020,0,0,32,32
"60294",2017,0,0,56,56
"60294",2018,0,0,99,99
"60294",2019,0,0,25,25
"60294",2020,0,0,80,80
"60295",2015,0,0,84,84
"60295",2017,0,0,96,96
"60295",2019,0,0,28,28
"60296",2015,0,0,84,84
"60296",2017,0,0,133,133
"60296",2019,0,0,153,153
"60296",2020,0,0,32,32
"60297",2015,0,0,84,84
"60297",2017,0,0,96,96
"60297",2019,0,0,28,28
"60298",2015,0,0,84,84
"60298",2017,0,0,96,96
"60298",2019,0,0,28,28
"60299",2017,0,0,77,77
"60299",2019,0,0,83,83
"60299",2020,0,0,32,32
"60301",2015,0,0,84,84
"60301",2017,0,0,96,96
"60301",2019,0,0,28,28
"60302",2015,0,0,84,84
"60302",2017,0,0,133,133
"60302",2019,0,0,198,198
"60302",2020,0,0,240,240
"60303",2015,0,0,84,84
"60303",2017,0,0,96,96
"60303",2019,0,0,28,28
"60304",2015,0,0,84,84
"60304",2017,0,0,96,96
"60304",2019,0,0,28,28
"60305",2015,0,0,15,15
"60305",2019,0,0,69,69
"60305",2020,0,0,13,13
"60306",2015,0,0,84,84
"60306",2017,0,0,133,133
"60306",2019,0,0,153,153
"60306",2020,0,0,32,32
"60307",2015,0,0,84,84
"60307",2017,0,0,96,96
"60307",2019,0,0,28,28
"60308",2015,0,0,15,15
"60308",2017,0,0,37,37
"60308",2018,0,0,37,37
"60308",2019,0,0,42,42
"60309",2015,0,0,15,15
"60309",2017,0,0,114,114
"60309",2019,0,0,125,125
"60309",2020,0,0,32,32
"60310",2015,0,0,84,84
"60310",2017,0,0,96,96
"60310",2019,0,0,28,28
"60311",2017,0,0,77,77
"60311",2019,0,0,83,83
"60311",2020,0,0,32,32
"60312",2015,0,0,84,84
"60312",2017,0,0,96,96
"60312",2019,0,0,28,28
"60313",2015,0,0,84,84
"60313",2017,0,0,96,96
"60313",2019,0,0,28,28
"60314",2015,0,0,84,84
"60314",2017,0,0,96,96
"60314",2019,0,0,28,28
"60315",2015,0,0,84,84
"60315",2017,0,0,96,96
"60315",2019,0,0,28,28
"60316",2015,0,0,84,84
"60316",2017,0,0,96,96
"60316",2019,0,0,28,28
"60317",2015,0,0,84,84
"60317",2017,0,0,96,96
"60317",2019,0,0,28,28
"60318",2015,0,0,15,15
"60318",2019,0,0,69,69
"60318",2020,0,0,13,13
"60319",2015,0,0,84,84
"60319",2017,0,0,133,133
"60319",2019,0,0,153,153
"60319",2020,0,0,32,32
"60320",2015,0,0,33,33
"60320",2017,0,0,56,56
"60320",2019,0,0,49,49
"60320",2020,0,0,59,59
"60321",2015,0,0,15,15
"60321",2017,0,0,114,114
"60321",2019,0,0,125,125
"60321",2020,0,0,32,32
"60322",2015,0,0,15,15
"60322",2017,0,0,114,114
"60322",2019,0,0,125,125
"60322",2020,0,0,32,32
"60323",2015,0,0,15,15
"60323",2017,0,0,37,37
"60323",2018,0,0,37,37
"60323",2019,0,0,42,42
"60324",2015,0,0,15,15
"60324",2019,0,0,69,69
"60324",2020,0,0,13,13
"60325",2015,0,0,15,15
"60325",2019,0,0,69,69
"60325",2020,0,0,13,13
"60326",2015,0,0,15,15
"60326",2017,0,0,37,37
"60326",2018,0,0,37,37
"60326",2019,0,0,42,42
"60327",2015,0,0,15,15
"60327",2017,0,0,114,114
"60327",2019,0,0,125,125
"60327",2020,0,0,32,32
"60328",2015,0,0,84,84
"60328",2017,0,0,96,96
"60328",2019,0,0,28,28
"60329",2017,0,0,56,56
"60329",2018,0,0,99,99
"60329",2019,0,0,62,62
"60329",2020,0,0,80,80
"60330",2015,0,0,84,84
"60330",2017,0,0,96,96
"60330",2019,0,0,28,28
"60331",2015,0,0,15,15
"60331",2017,0,0,114,114
"60331",2019,0,0,125,125
"60331",2020,0,0,32,32
"60332",2015,0,0,56,56
"60332",2017,0,0,83,83
"60332",2019,0,0,162,162
"60332",2020,0,0,187,187
"60333",2015,0,0,84,84
"60333",2017,0,0,96,96
"60333",2019,0,0,28,28
"60334",2015,0,0,84,84
"60334",2017,0,0,96,96
"60334",2019,0,0,28,28
"60335",2015,0,0,84,84
"60335",2017,0,0,96,96
"60335",2019,0,0,28,28
"60336",2015,0,0,84,84
"60336",2017,0,0,133,133
"60336",2019,0,0,97,97
"60336",2020,0,0,240,240
"60337",2015,0,0,15,15
"60337",2017,0,0,37,37
"60337",2018,0,0,37,37
"60337",2019,0,0,42,42
"60338",2015,0,0,15,15
"60338",2019,0,0,69,69
"60338",2020,0,0,13,13
"60339",2015,0,0,84,84
"60339",2017,0,0,133,133
"60339",2019,0,0,198,198
"60339",2020,0,0,240,240
"60340",2015,0,0,28,28
"60340",2017,0,0,37,37
"60340",2019,0,0,25,25
"60340",2020,0,0,14,14
"60341",2015,0,0,33,33
"60341",2017,0,0,56,56
"60341",2018,0,0,46,46
"60341",2019,0,0,119,119
"60341",2020,0,0,233,233
"60342",2015,0,0,84,84
"60342",2017,0,0,133,133
"60342",2019,0,0,198,198
"60342",2020,0,0,240,240
"60343",2015,0,0,15,15
"60343",2017,0,0,114,114
"60343",2019,0,0,125,125
"60343",2020,0,0,32,32
"60344",2015,0,0,84,84
"60344",2017,0,0,133,133
"60344",2019,0,0,153,153
"60344",2020,0,0,32,32
"60345",2015,0,0,56,56
"60345",2017,0,0,83,83
"60345",2019,0,0,198,198
"60345",2020,0,0,240,240
"60346",2015,0,0,15,15
"60346",2017,0,0,19,19
"60346",2018,0,0,46,46
"60346",2019,0,0,162,162
"60346",2020,0,0,187,187
"60347",2017,0,0,37,37
"60347",2019,0,0,65,65
"60347",2020,0,0,121,121
"60348",2015,0,0,28,28
"60348",2017,0,0,37,37
"60348",2019,0,0,25,25
"60348",2020,0,0,14,14
"60350",2015,0,0,28,28
"60350",2017,0,0,37,37
"60350",2019,0,0,25,25
"60350",2020,0,0,14,14
"60351",2015,0,0,15,15
"60351",2017,0,0,56,56
"60351",2018,0,0,37,37
"60351",2019,0,0,25,25
"60352",2015,0,0,15,15
"60352",2017,0,0,114,114
"60352",2019,0,0,125,125
"60352",2020,0,0,32,32
"60353",2017,0,0,46,46
"60354",2017,0,0,46,46
"60355",2015,0,0,84,84
"60355",2017,0,0,96,96
"60355",2019,0,0,28,28
"60356",2015,0,0,15,15
"60356",2017,0,0,114,114
"60356",2019,0,0,125,125
"60356",2020,0,0,32,32
"60357",2015,0,0,15,15
"60357",2017,0,0,37,37
"60357",2018,0,0,37,37
"60357",2019,0,0,42,42
"60358",2015,0,0,20,20
"60358",2017,0,0,56,56
"60358",2018,0,0,136,136
"60358",2019,0,0,88,88
"60358",2020,0,0,59,59
"60359",2015,0,0,84,84
"60359",2017,0,0,96,96
"60359",2019,0,0,28,28
"60360",2015,0,0,56,56
"60360",2017,0,0,83,83
"60360",2019,0,0,162,162
"60360",2020,0,0,187,187
"60361",2015,0,0,15,15
"60361",2017,0,0,114,114
"60361",2019,0,0,125,125
"60361",2020,0,0,32,32
"60362",2015,0,0,28,28
"60362",2017,0,0,37,37
"60362",2019,0,0,56,56
"60362",2020,0,0,14,14
"60363",2015,0,0,15,15
"60363",2017,0,0,114,114
"60363",2019,0,0,125,125
"60363",2020,0,0,32,32
"60364",2015,0,0,56,56
"60364",2017,0,0,37,37
"60364",2018,0,0,37,37
"60364",2019,0,0,42,42
"60365",2015,0,0,84,84
"60365",2017,0,0,96,96
"60365",2019,0,0,28,28
"60366",2015,0,0,84,84
"60366",2017,0,0,133,133
"60366",2019,0,0,198,198
"60366",2020,0,0,240,240
"60367",2015,0,0,15,15
"60367",2017,0,0,114,114
"60367",2019,0,0,125,125
"60367",2020,0,0,32,32
"60368",2015,0,0,15,15
"60368",2017,0,0,37,37
"60368",2018,0,0,37,37
"60368",2019,0,0,42,42
"60369",2015,0,0,15,15
"60369",2019,0,0,69,69
"60369",2020,0,0,13,13
"60370",2015,0,0,15,15
"60370",2017,0,0,114,114
"60370",2019,0,0,125,125
"60370",2020,0,0,32,32
"60371",2015,0,0,84,84
"60371",2017,0,0,96,96
"60371",2019,0,0,28,28
"60372",2015,0,0,84,84
"60372",2017,0,0,133,133
"60372",2019,0,0,198,198
"60372",2020,0,0,240,240
"60373",2015,0,0,28,28
"60373",2017,0,0,37,37
"60373",2019,0,0,25,25
"60373",2020,0,0,14,14
"60374",2015,0,0,56,56
"60374",2017,0,0,37,37
"60374",2018,0,0,37,37
"60374",2019,0,0,25,25
"60375",2015,0,0,56,56
"60375",2017,0,0,37,37
"60375",2018,0,0,37,37
"60375",2019,0,0,42,42
"60376",2015,0,0,84,84
"60376",2017,0,0,96,96
"60376",2019,0,0,28,28
"60377",2015,0,0,56,56
"60377",2017,0,0,114,114
"60377",2019,0,0,97,97
"60377",2020,0,0,240,240
"60378",2015,0,0,15,15
"60378",2017,0,0,56,56
"60378",2018,0,0,37,37
"60378",2019,0,0,42,42
"60379",2015,0,0,28,28
"60379",2017,0,0,37,37
"60379",2019,0,0,25,25
"60379",2020,0,0,14,14
"60380",2015,0,0,33,33
"60380",2017,0,0,56,56
"60380",2019,0,0,49,49
"60380",2020,0,0,59,59
"60381",2015,0,0,28,28
"60381",2017,0,0,37,37
"60381",2019,0,0,56,56
"60381",2020,0,0,14,14
"60382",2015,0,0,15,15
"60382",2017,0,0,37,37
"60382",2018,0,0,37,37
"60382",2019,0,0,42,42
"60383",2017,0,0,56,56
"60383",2018,0,0,99,99
"60383",2019,0,0,62,62
"60383",2020,0,0,80,80
"60385",2015,0,0,33,33
"60385",2017,0,0,56,56
"60385",2019,0,0,49,49
"60385",2020,0,0,59,59
"60386",2015,0,0,15,15
"60386",2017,0,0,56,56
"60386",2018,0,0,37,37
"60386",2019,0,0,42,42
"60387",2015,0,0,84,84
"60387",2017,0,0,96,96
"60387",2019,0,0,28,28
"60388",2015,0,0,84,84
"60388",2017,0,0,96,96
"60388",2019,0,0,28,28
"60389",2015,0,0,28,28
"60389",2017,0,0,37,37
"60389",2019,0,0,25,25
"60389",2020,0,0,14,14
"60390",2015,0,0,84,84
"60390",2017,0,0,133,133
"60390",2019,0,0,198,198
"60390",2020,0,0,240,240
"60391",2015,0,0,84,84
"60391",2017,0,0,96,96
"60391",2019,0,0,97,97
"60391",2020,0,0,13,13
"60392",2015,0,0,15,15
"60392",2017,0,0,56,56
"60392",2018,0,0,37,37
"60392",2019,0,0,42,42
"60393",2015,0,0,84,84
"60393",2017,0,0,96,96
"60393",2019,0,0,28,28
"60394",2015,0,0,15,15
"60394",2017,0,0,37,37
"60394",2018,0,0,37,37
"60394",2019,0,0,42,42
"60395",2015,0,0,15,15
"60395",2017,0,0,114,114
"60395",2019,0,0,125,125
"60395",2020,0,0,32,32
"60396",2015,0,0,15,15
"60396",2017,0,0,56,56
"60396",2018,0,0,37,37
"60396",2019,0,0,25,25
"60397",2017,0,0,46,46
"60398",2015,0,0,15,15
"60398",2017,0,0,46,46
"60398",2019,0,0,69,69
"60398",2020,0,0,13,13
"60399",2017,0,0,77,77
"60399",2019,0,0,83,83
"60399",2020,0,0,32,32
"60400",2015,0,0,56,56
"60400",2017,0,0,83,83
"60400",2019,0,0,198,198
"60400",2020,0,0,240,240
"60401",2015,0,0,15,15
"60401",2017,0,0,114,114
"60401",2019,0,0,125,125
"60401",2020,0,0,32,32
"60402",2015,0,0,15,15
"60402",2019,0,0,69,69
"60402",2020,0,0,13,13
"60403",2015,0,0,84,84
"60403",2017,0,0,96,96
"60403",2019,0,0,28,28
"60404",2015,0,0,56,56
"60404",2017,0,0,83,83
"60404",2019,0,0,162,162
"60404",2020,0,0,187,187
"60405",2015,0,0,84,84
"60405",2017,0,0,37,37
"60405",2019,0,0,93,93
"60405",2020,0,0,121,121
"60406",2015,0,0,15,15
"60406",2019,0,0,69,69
"60406",2020,0,0,13,13
"60407",2015,0,0,84,84
"60407",2017,0,0,37,37
"60407",2019,0,0,93,93
"60407",2020,0,0,121,121
"60408",2015,0,0,15,15
"60408",2017,0,0,37,37
"60408",2018,0,0,37,37
"60408",2019,0,0,42,42
"60409",2015,0,0,56,56
"60409",2017,0,0,83,83
"60409",2019,0,0,162,162
"60409",2020,0,0,187,187
"60410",2015,0,0,15,15
"60410",2019,0,0,69,69
"60410",2020,0,0,13,13
"60411",2015,0,0,15,15
"60411",2017,0,0,114,114
"60411",2019,0,0,125,125
"60411",2020,0,0,32,32
"60412",2015,0,0,15,15
"60412",2017,0,0,114,114
"60412",2019,0,0,125,125
"60412",2020,0,0,32,32
"60413",2015,0,0,33,33
"60413",2017,0,0,56,56
"60413",2018,0,0,46,46
"60413",2019,0,0,119,119
"60413",2020,0,0,233,233
"60414",2015,0,0,84,84
"60414",2017,0,0,133,133
"60414",2019,0,0,162,162
"60414",2020,0,0,187,187
"60415",2017,0,0,19,19
"60415",2018,0,0,46,46
"60415",2019,0,0,198,198
"60415",2020,0,0,174,174
"60416",2015,0,0,15,15
"60416",2017,0,0,37,37
"60416",2018,0,0,37,37
"60416",2019,0,0,25,25
"60418",2015,0,0,15,15
"60418",2017,0,0,37,37
"60418",2018,0,0,37,37
"60418",2019,0,0,42,42
"60420",2015,0,0,15,15
"60420",2017,0,0,114,114
"60420",2019,0,0,125,125
"60420",2020,0,0,32,32
"60421",2017,0,0,19,19
"60421",2018,0,0,46,46
"60421",2019,0,0,198,198
"60421",2020,0,0,174,174
"60422",2017,0,0,19,19
"60422",2018,0,0,46,46
"60422",2019,0,0,198,198
"60422",2020,0,0,174,174
"60423",2015,0,0,15,15
"60423",2019,0,0,69,69
"60423",2020,0,0,13,13
"60424",2015,0,0,15,15
"60424",2017,0,0,37,37
"60424",2018,0,0,37,37
"60424",2019,0,0,42,42
"60425",2015,0,0,56,56
"60425",2017,0,0,83,83
"60425",2019,0,0,198,198
"60425",2020,0,0,240,240
"60426",2015,0,0,84,84
"60426",2017,0,0,96,96
"60426",2019,0,0,28,28
"60427",2015,0,0,15,15
"60427",2017,0,0,114,114
"60427",2019,0,0,125,125
"60427",2020,0,0,32,32
"60428",2015,0,0,84,84
"60428",2017,0,0,96,96
"60428",2019,0,0,28,28
"60429",2015,0,0,15,15
"60429",2017,0,0,46,46
"60429",2019,0,0,69,69
"60429",2020,0,0,13,13
"60430",2015,0,0,20,20
"60430",2017,0,0,19,19
"60430",2018,0,0,136,136
"60430",2019,0,0,131,131
"60430",2020,0,0,27,27
"60431",2015,0,0,28,28
"60431",2017,0,0,37,37
"60431",2019,0,0,25,25
"60431",2020,0,0,14,14
"60432",2017,0,0,19,19
"60432",2018,0,0,46,46
"60432",2019,0,0,198,198
"60432",2020,0,0,174,174
"60433",2017,0,0,46,46
"60434",2015,0,0,15,15
"60434",2017,0,0,56,56
"60434",2018,0,0,37,37
"60434",2019,0,0,25,25
"60435",2015,0,0,84,84
"60435",2017,0,0,96,96
"60435",2019,0,0,28,28
"60436",2017,0,0,77,77
"60436",2019,0,0,83,83
"60436",2020,0,0,32,32
"60437",2015,0,0,84,84
"60437",2017,0,0,96,96
"60437",2019,0,0,28,28
"60438",2015,0,0,15,15
"60438",2019,0,0,69,69
"60438",2020,0,0,13,13
"60439",2015,0,0,84,84
"60439",2017,0,0,96,96
"60439",2019,0,0,28,28
"60440",2015,0,0,15,15
"60440",2017,0,0,37,37
"60440",2018,0,0,37,37
"60440",2019,0,0,42,42
"60441",2015,0,0,15,15
"60441",2017,0,0,37,37
"60441",2018,0,0,37,37
"60441",2019,0,0,42,42
"60442",2015,0,0,84,84
"60442",2017,0,0,133,133
"60442",2019,0,0,198,198
"60442",2020,0,0,240,240
"60443",2015,0,0,28,28
"60443",2017,0,0,37,37
"60443",2019,0,0,56,56
"60443",2020,0,0,14,14
"60444",2015,0,0,84,84
"60444",2017,0,0,96,96
"60444",2019,0,0,28,28
"60445",2015,0,0,15,15
"60445",2019,0,0,69,69
"60445",2020,0,0,13,13
"60446",2015,0,0,33,33
"60446",2017,0,0,56,56
"60446",2018,0,0,46,46
"60446",2019,0,0,119,119
"60446",2020,0,0,233,233
"60447",2015,0,0,20,20
"60447",2017,0,0,19,19
"60447",2018,0,0,136,136
"60447",2019,0,0,198,198
"60447",2020,0,0,233,233
"60448",2015,0,0,33,33
"60448",2017,0,0,56,56
"60448",2019,0,0,49,49
"60448",2020,0,0,59,59
"60449",2015,0,0,15,15
"60449",2017,0,0,56,56
"60449",2018,0,0,37,37
"60449",2019,0,0,42,42
"60450",2015,0,0,84,84
"60450",2017,0,0,96,96
"60450",2019,0,0,97,97
"60450",2020,0,0,13,13
"60451",2015,0,0,84,84
"60451",2017,0,0,133,133
"60451",2019,0,0,198,198
"60451",2020,0,0,240,240
"60452",2015,0,0,15,15
"60452",2017,0,0,114,114
"60452",2019,0,0,125,125
"60452",2020,0,0,32,32
"60454",2015,0,0,84,84
"60454",2017,0,0,133,133
"60454",2019,0,0,198,198
"60454",2020,0,0,240,240
"60456",2015,0,0,15,15
"60456",2017,0,0,37,37
"60456",2018,0,0,37,37
"60456",2019,0,0,42,42
"60457",2015,0,0,84,84
"60457",2017,0,0,133,133
"60457",2019,0,0,198,198
"60457",2020,0,0,240,240
"60458",2015,0,0,84,84
"60458",2017,0,0,96,96
"60458",2019,0,0,28,28
"60459",2017,0,0,56,56
"60459",2018,0,0,99,99
"60459",2019,0,0,62,62
"60459",2020,0,0,80,80
"60460",2015,0,0,84,84
"60460",2017,0,0,96,96
"60460",2019,0,0,28,28
"60461",2015,0,0,84,84
"60461",2017,0,0,96,96
"60461",2019,0,0,28,28
"60462",2015,0,0,84,84
"60462",2017,0,0,96,96
"60462",2019,0,0,28,28
"60463",2015,0,0,84,84
"60463",2017,0,0,133,133
"60463",2019,0,0,162,162
"60463",2020,0,0,187,187
"60464",2015,0,0,56,56
"60464",2017,0,0,83,83
"60464",2019,0,0,198,198
"60464",2020,0,0,240,240
"60465",2015,0,0,56,56
"60465",2017,0,0,114,114
"60465",2019,0,0,97,97
"60465",2020,0,0,240,240
"60466",2015,0,0,56,56
"60466",2017,0,0,37,37
"60466",2018,0,0,37,37
"60466",2019,0,0,42,42
"60468",2015,0,0,56,56
"60468",2017,0,0,83,83
"60468",2019,0,0,198,198
"60468",2020,0,0,240,240
"60469",2015,0,0,84,84
"60469",2017,0,0,96,96
"60469",2019,0,0,28,28
"60470",2015,0,0,56,56
"60470",2017,0,0,114,114
"60470",2019,0,0,97,97
"60470",2020,0,0,240,240
"60471",2015,0,0,28,28
"60471",2017,0,0,37,37
"60471",2019,0,0,25,25
"60471",2020,0,0,14,14
"60472",2017,0,0,46,46
"60473",2015,0,0,33,33
"60473",2017,0,0,56,56
"60473",2018,0,0,46,46
"60473",2019,0,0,119,119
"60473",2020,0,0,233,233
"60474",2015,0,0,28,28
"60474",2017,0,0,37,37
"60474",2019,0,0,56,56
"60474",2020,0,0,14,14
"60476",2015,0,0,84,84
"60476",2017,0,0,96,96
"60476",2019,0,0,28,28
"60477",2015,0,0,84,84
"60477",2017,0,0,133,133
"60477",2019,0,0,153,153
"60477",2020,0,0,32,32
"60478",2015,0,0,33,33
"60478",2017,0,0,56,56
"60478",2019,0,0,49,49
"60478",2020,0,0,59,59
"60479",2015,0,0,20,20
"60479",2017,0,0,56,56
"60479",2018,0,0,136,136
"60479",2019,0,0,119,119
"60479",2020,0,0,233,233
"60480",2015,0,0,84,84
"60480",2017,0,0,133,133
"60480",2019,0,0,198,198
"60480",2020,0,0,240,240
"60481",2015,0,0,20,20
"60481",2017,0,0,19,19
"60481",2018,0,0,136,136
"60481",2019,0,0,131,131
"60481",2020,0,0,27,27
"60482",2017,0,0,19,19
"60482",2018,0,0,46,46
"60482",2019,0,0,198,198
"60482",2020,0,0,174,174
"60483",2017,0,0,56,56
"60483",2018,0,0,99,99
"60483",2019,0,0,25,25
"60483",2020,0,0,80,80
"60484",2015,0,0,84,84
"60484",2017,0,0,96,96
"60484",2019,0,0,28,28
"60485",2015,0,0,56,56
"60485",2017,0,0,114,114
"60485",2019,0,0,97,97
"60485",2020,0,0,240,240
"60486",2017,0,0,77,77
"60486",2019,0,0,83,83
"60486",2020,0,0,32,32
"60487",2015,0,0,15,15
"60487",2017,0,0,114,114
"60487",2019,0,0,125,125
"60487",2020,0,0,32,32
"60488",2015,0,0,28,28
"60488",2017,0,0,37,37
"60488",2019,0,0,25,25
"60488",2020,0,0,14,14
"60489",2015,0,0,20,20
"60489",2017,0,0,56,56
"60489",2018,0,0,136,136
"60489",2019,0,0,119,119
"60489",2020,0,0,233,233
"60490",2015,0,0,84,84
"60490",2017,0,0,96,96
"60490",2019,0,0,28,28
"60491",2015,0,0,20,20
"60491",2017,0,0,19,19
"60491",2018,0,0,136,136
"60491",2019,0,0,131,131
"60491",2020,0,0,27,27
"60492",2015,0,0,15,15
"60492",2019,0,0,69,69
"60492",2020,0,0,13,13
"60493",2015,0,0,84,84
"60493",2017,0,0,96,96
"60493",2019,0,0,28,28
"60494",2017,0,0,19,19
"60494",2018,0,0,46,46
"60494",2019,0,0,198,198
"60494",2020,0,0,174,174
"60495",2015,0,0,56,56
"60495",2017,0,0,37,37
"60495",2018,0,0,37,37
"60495",2019,0,0,25,25
"60496",2017,0,0,77,77
"60496",2019,0,0,83,83
"60496",2020,0,0,32,32
"60497",2015,0,0,56,56
"60497",2017,0,0,83,83
"60497",2019,0,0,198,198
"60497",2020,0,0,240,240
"60498",2015,0,0,56,56
"60498",2017,0,0,37,37
"60498",2018,0,0,37,37
"60498",2019,0,0,42,42
"60499",2015,0,0,28,28
"60499",2017,0,0,37,37
"60499",2019,0,0,25,25
"60499",2020,0,0,14,14
"60500",2015,0,0,33,33
"60500",2017,0,0,56,56
"60500",2018,0,0,46,46
"60500",2019,0,0,119,119
"60500",2020,0,0,233,233
"60501",2015,0,0,15,15
"60501",2019,0,0,69,69
"60501",2020,0,0,13,13
"60502",2015,0,0,28,28
"60502",2017,0,0,37,37
"60502",2019,0,0,56,56
"60502",2020,0,0,14,14
"60503",2017,0,0,77,77
"60503",2019,0,0,83,83
"60503",2020,0,0,32,32
"60504",2015,0,0,84,84
"60504",2017,0,0,96,96
"60504",2019,0,0,28,28
"60505",2017,0,0,19,19
"60505",2018,0,0,46,46
"60505",2019,0,0,198,198
"60505",2020,0,0,174,174
"60506",2015,0,0,28,28
"60506",2017,0,0,37,37
"60506",2019,0,0,25,25
"60506",2020,0,0,14,14
"60507",2015,0,0,28,28
"60507",2017,0,0,37,37
"60507",2019,0,0,25,25
"60507",2020,0,0,14,14
"60508",2015,0,0,15,15
"60508",2017,0,0,19,19
"60508",2018,0,0,46,46
"60508",2019,0,0,162,162
"60508",2020,0,0,187,187
"60509",2015,0,0,15,15
"60509",2017,0,0,19,19
"60509",2018,0,0,46,46
"60509",2019,0,0,162,162
"60509",2020,0,0,187,187
"60510",2015,0,0,15,15
"60510",2017,0,0,114,114
"60510",2019,0,0,125,125
"60510",2020,0,0,32,32
"60511",2015,0,0,28,28
"60511",2017,0,0,37,37
"60511",2019,0,0,25,25
"60511",2020,0,0,14,14
"60512",2015,0,0,15,15
"60512",2017,0,0,114,114
"60512",2019,0,0,125,125
"60512",2020,0,0,32,32
"60513",2015,0,0,15,15
"60513",2017,0,0,19,19
"60513",2018,0,0,46,46
"60513",2019,0,0,162,162
"60513",2020,0,0,187,187
"60514",2015,0,0,84,84
"60514",2017,0,0,96,96
"60514",2019,0,0,28,28
"60515",2015,0,0,15,15
"60515",2017,0,0,37,37
"60515",2018,0,0,37,37
"60515",2019,0,0,42,42
"60516",2015,0,0,15,15
"60516",2017,0,0,114,114
"60516",2019,0,0,125,125
"60516",2020,0,0,32,32
"60517",2017,0,0,46,46
"60518",2015,0,0,56,56
"60518",2017,0,0,114,114
"60518",2019,0,0,97,97
"60518",2020,0,0,240,240
"60519",2015,0,0,28,28
"60519",2017,0,0,37,37
"60519",2019,0,0,25,25
"60519",2020,0,0,14,14
"60520",2015,0,0,56,56
"60520",2017,0,0,83,83
"60520",2019,0,0,198,198
"60520",2020,0,0,240,240
"60521",2017,0,0,37,37
"60521",2019,0,0,65,65
"60521",2020,0,0,121,121
"60522",2015,0,0,56,56
"60522",2017,0,0,114,114
"60522",2019,0,0,97,97
"60522",2020,0,0,240,240
"60523",2015,0,0,84,84
"60523",2017,0,0,96,96
"60523",2019,0,0,28,28
"60524",2015,0,0,56,56
"60524",2017,0,0,83,83
"60524",2019,0,0,198,198
"60524",2020,0,0,240,240
"60525",2015,0,0,20,20
"60525",2017,0,0,19,19
"60525",2018,0,0,136,136
"60525",2019,0,0,162,162
"60525",2020,0,0,201,201
"60526",2015,0,0,56,56
"60526",2017,0,0,37,37
"60526",2018,0,0,37,37
"60526",2019,0,0,42,42
"60527",2015,0,0,33,33
"60527",2017,0,0,56,56
"60527",2019,0,0,49,49
"60527",2020,0,0,59,59
"60528",2015,0,0,15,15
"60528",2017,0,0,114,114
"60528",2019,0,0,125,125
"60528",2020,0,0,32,32
"60529",2015,0,0,56,56
"60529",2017,0,0,37,37
"60529",2018,0,0,37,37
"60529",2019,0,0,42,42
"60530",2015,0,0,84,84
"60530",2017,0,0,133,133
"60530",2019,0,0,198,198
"60530",2020,0,0,240,240
"60531",2015,0,0,15,15
"60531",2017,0,0,37,37
"60531",2018,0,0,37,37
"60531",2019,0,0,42,42
"60533",2015,0,0,15,15
"60533",2017,0,0,56,56
"60533",2018,0,0,37,37
"60533",2019,0,0,42,42
"60534",2015,0,0,15,15
"60534",2019,0,0,69,69
"60534",2020,0,0,13,13
"60535",2015,0,0,84,84
"60535",2017,0,0,133,133
"60535",2019,0,0,198,198
"60535",2020,0,0,240,240
"60536",2015,0,0,15,15
"60536",2017,0,0,19,19
"60536",2018,0,0,46,46
"60536",2019,0,0,162,162
"60536",2020,0,0,187,187
"60537",2015,0,0,28,28
"60537",2017,0,0,37,37
"60537",2019,0,0,25,25
"60537",2020,0,0,14,14
"60538",2017,0,0,56,56
"60538",2018,0,0,99,99
"60538",2019,0,0,62,62
"60538",2020,0,0,80,80
"60539",2015,0,0,56,56
"60539",2017,0,0,83,83
"60539",2019,0,0,162,162
"60539",2020,0,0,187,187
"60540",2015,0,0,15,15
"60540",2019,0,0,69,69
"60540",2020,0,0,13,13
"60541",2015,0,0,15,15
"60541",2017,0,0,19,19
"60541",2018,0,0,46,46
"60541",2019,0,0,162,162
"60541",2020,0,0,187,187
"60542",2015,0,0,84,84
"60542",2017,0,0,96,96
"60542",2019,0,0,28,28
"60543",2015,0,0,20,20
"60543",2017,0,0,19,19
"60543",2018,0,0,136,136
"60543",2019,0,0,198,198
"60543",2020,0,0,233,233
"60544",2017,0,0,77,77
"60544",2019,0,0,83,83
"60544",2020,0,0,32,32
"60545",2017,0,0,37,37
"60545",2019,0,0,65,65
"60545",2020,0,0,121,121
"60546",2015,0,0,20,20
"60546",2017,0,0,19,19
"60546",2018,0,0,136,136
"60546",2019,0,0,198,198
"60546",2020,0,0,233,233
"60547",2015,0,0,56,56
"60547",2017,0,0,83,83
"60547",2019,0,0,162,162
"60547",2020,0,0,187,187
"60548",2015,0,0,33,33
"60548",2017,0,0,56,56
"60548",2019,0,0,49,49
"60548",2020,0,0,59,59
"60549",2015,0,0,84,84
"60549",2017,0,0,133,133
"60549",2019,0,0,198,198
"60549",2020,0,0,240,240
"60550",2015,0,0,84,84
"60550",2017,0,0,96,96
"60550",2019,0,0,28,28
"60551",2015,0,0,84,84
"60551",2017,0,0,133,133
"60551",2019,0,0,198,198
"60551",2020,0,0,240,240
"60552",2015,0,0,20,20
"60552",2017,0,0,56,56
"60552",2018,0,0,136,136
"60552",2019,0,0,88,88
"60552",2020,0,0,59,59
"60553",2015,0,0,15,15
"60553",2017,0,0,37,37
"60553",2018,0,0,37,37
"60553",2019,0,0,42,42
"60554",2015,0,0,33,33
"60554",2017,0,0,56,56
"60554",2019,0,0,49,49
"60554",2020,0,0,59,59
"60555",2017,0,0,77,77
"60555",2019,0,0,83,83
"60555",2020,0,0,32,32
"60556",2017,0,0,77,77
"60556",2019,0,0,83,83
"60556",2020,0,0,32,32
"60557",2015,0,0,84,84
"60557",2017,0,0,96,96
"60557",2019,0,0,28,28
"60558",2017,0,0,56,56
"60558",2018,0,0,99,99
"60558",2019,0,0,62,62
"60558",2020,0,0,80,80
"60559",2015,0,0,84,84
"60559",2017,0,0,133,133
"60559",2019,0,0,198,198
"60559",2020,0,0,240,240
"60560",2015,0,0,20,20
"60560",2017,0,0,19,19
"60560",2018,0,0,136,136
"60560",2019,0,0,198,198
"60560",2020,0,0,233,233
"60561",2015,0,0,20,20
"60561",2017,0,0,56,56
"60561",2018,0,0,136,136
"60561",2019,0,0,88,88
"60561",2020,0,0,59,59
"60562",2015,0,0,56,56
"60562",2017,0,0,83,83
"60562",2019,0,0,162,162
"60562",2020,0,0,187,187
"60563",2015,0,0,15,15
"60563",2017,0,0,37,37
"60563",2018,0,0,37,37
"60563",2019,0,0,42,42
"60564",2015,0,0,15,15
"60564",2017,0,0,37,37
"60564",2018,0,0,37,37
"60564",2019,0,0,25,25
"60565",2015,0,0,56,56
"60565",2017,0,0,114,114
"60565",2019,0,0,97,97
"60565",2020,0,0,240,240
"60566",2015,0,0,84,84
"60566",2017,0,0,96,96
"60566",2019,0,0,28,28
"60567",2015,0,0,84,84
"60567",2017,0,0,133,133
"60567",2019,0,0,153,153
"60567",2020,0,0,32,32
"60568",2015,0,0,56,56
"60568",2017,0,0,83,83
"60568",2019,0,0,198,198
"60568",2020,0,0,240,240
"60569",2015,0,0,15,15
"60569",2019,0,0,69,69
"60569",2020,0,0,13,13
"60570",2015,0,0,15,15
"60570",2017,0,0,114,114
"60570",2019,0,0,125,125
"60570",2020,0,0,32,32
"60571",2015,0,0,84,84
"60571",2017,0,0,96,96
"60571",2019,0,0,28,28
"60572",2015,0,0,15,15
"60572",2019,0,0,69,69
"60572",2020,0,0,13,13
"60573",2015,0,0,56,56
"60573",2017,0,0,114,114
"60573",2019,0,0,97,97
"60573",2020,0,0,240,240
"60574",2015,0,0,84,84
"60574",2017,0,0,96,96
"60574",2019,0,0,28,28
"60575",2015,0,0,84,84
"60575",2017,0,0,96,96
"60575",2019,0,0,28,28
"60576",2015,0,0,84,84
"60576",2017,0,0,96,96
"60576",2019,0,0,28,28
"60577",2015,0,0,84,84
"60577",2017,0,0,133,133
"60577",2019,0,0,153,153
"60577",2020,0,0,32,32
"60578",2015,0,0,20,20
"60578",2017,0,0,19,19
"60578",2018,0,0,136,136
"60578",2019,0,0,131,131
"60578",2020,0,0,27,27
"60579",2015,0,0,20,20
"60579",2017,0,0,19,19
"60579",2018,0,0,136,136
"60579",2019,0,0,131,131
"60579",2020,0,0,27,27
"60581",2015,0,0,56,56
"60581",2017,0,0,83,83
"60581",2019,0,0,198,198
"60581",2020,0,0,240,240
"60582",2015,0,0,15,15
"60582",2019,0,0,69,69
"60582",2020,0,0,13,13
"60583",2015,0,0,84,84
"60583",2017,0,0,96,96
"60583",2019,0,0,28,28
"60584",2015,0,0,84,84
"60584",2017,0,0,19,19
"60584",2018,0,0,46,46
"60584",2019,0,0,162,162
"60584",2020,0,0,187,187
"60585",2015,0,0,15,15
"60585",2017,0,0,37,37
"60585",2018,0,0,37,37
"60585",2019,0,0,25,25
"60586",2015,0,0,84,84
"60586",2017,0,0,96,96
"60586",2019,0,0,28,28
"60587",2015,0,0,15,15
"60587",2019,0,0,69,69
"60587",2020,0,0,13,13
"60588",2015,0,0,84,84
"60588",2017,0,0,96,96
"60588",2019,0,0,28,28
"60589",2015,0,0,84,84
"60589",2017,0,0,19,19
"60589",2018,0,0,46,46
"60589",2019,0,0,162,162
"60589",2020,0,0,187,187
"60590",2015,0,0,84,84
"60590",2017,0,0,96,96
"60590",2019,0,0,28,28
"60591",2015,0,0,84,84
"60591",2017,0,0,96,96
"60591",2019,0,0,28,28
"60592",2015,0,0,15,15
"60592",2017,0,0,114,114
"60592",2019,0,0,125,125
"60592",2020,0,0,32,32
"60593",2015,0,0,15,15
"60593",2019,0,0,69,69
"60593",2020,0,0,13,13
"60594",2015,0,0,84,84
"60594",2017,0,0,133,133
"60594",2019,0,0,153,153
"60594",2020,0,0,32,32
"60595",2015,0,0,56,56
"60595",2017,0,0,37,37
"60595",2018,0,0,37,37
"60595",2019,0,0,42,42
"60596",2015,0,0,84,84
"60596",2017,0,0,96,96
"60596",2019,0,0,28,28
"60597",2015,0,0,20,20
"60597",2017,0,0,19,19
"60597",2018,0,0,136,136
"60597",2019,0,0,131,131
"60597",2020,0,0,27,27
"60598",2015,0,0,84,84
"60598",2017,0,0,96,96
"60598",2019,0,0,28,28
"60599",2017,0,0,37,37
"60599",2019,0,0,65,65
"60599",2020,0,0,121,121
"60600",2015,0,0,20,20
"60600",2017,0,0,19,19
"60600",2018,0,0,136,136
"60600",2019,0,0,131,131
"60600",2020,0,0,27,27
"60601",2015,0,0,84,84
"60601",2017,0,0,133,133
"60601",2019,0,0,198,198
"60601",2020,0,0,240,240
"60602",2017,0,0,37,37
"60602",2019,0,0,65,65
"60602",2020,0,0,121,121
"60603",2015,0,0,28,28
"60603",2017,0,0,37,37
"60603",2019,0,0,25,25
"60603",2020,0,0,14,14
"60604",2015,0,0,84,84
"60604",2017,0,0,96,96
"60604",2019,0,0,28,28
"60605",2017,0,0,46,46
"60608",2017,0,0,46,46
"60609",2015,0,0,84,84
"60609",2017,0,0,96,96
"60609",2019,0,0,28,28
"60610",2015,0,0,28,28
"60610",2017,0,0,37,37
"60610",2019,0,0,25,25
"60610",2020,0,0,14,14
"60611",2015,0,0,84,84
"60611",2017,0,0,133,133
"60611",2019,0,0,153,153
"60611",2020,0,0,32,32
"60612",2015,0,0,15,15
"60612",2017,0,0,19,19
"60612",2018,0,0,46,46
"60612",2019,0,0,162,162
"60612",2020,0,0,187,187
"60613",2015,0,0,15,15
"60613",2017,0,0,114,114
"60613",2019,0,0,125,125
"60613",2020,0,0,32,32
"60614",2015,0,0,15,15
"60614",2017,0,0,114,114
"60614",2019,0,0,125,125
"60614",2020,0,0,32,32
"60615",2017,0,0,77,77
"60615",2019,0,0,83,83
"60615",2020,0,0,32,32
"60616",2015,0,0,15,15
"60616",2017,0,0,114,114
"60616",2019,0,0,125,125
"60616",2020,0,0,32,32
"60617",2015,0,0,28,28
"60617",2017,0,0,37,37
"60617",2019,0,0,25,25
"60617",2020,0,0,14,14
"60618",2015,0,0,20,20
"60618",2017,0,0,19,19
"60618",2018,0,0,136,136
"60618",2019,0,0,167,167
"60618",2020,0,0,59,59
"60619",2015,0,0,33,33
"60619",2017,0,0,56,56
"60619",2018,0,0,46,46
"60619",2019,0,0,119,119
"60619",2020,0,0,233,233
"60620",2015,0,0,84,84
"60620",2017,0,0,96,96
"60620",2019,0,0,28,28
"60621",2015,0,0,28,28
"60621",2017,0,0,37,37
"60621",2019,0,0,56,56
"60621",2020,0,0,14,14
"60622",2017,0,0,46,46
"60623",2015,0,0,84,84
"60623",2017,0,0,96,96
"60623",2019,0,0,28,28
"60624",2015,0,0,84,84
"60624",2017,0,0,133,133
"60624",2019,0,0,153,153
"60624",2020,0,0,32,32
"60625",2015,0,0,28,28
"60625",2017,0,0,37,37
"60625",2019,0,0,25,25
"60625",2020,0,0,14,14
"60626",2015,0,0,15,15
"60626",2017,0,0,114,114
"60626",2019,0,0,125,125
"60626",2020,0,0,32,32
"60627",2017,0,0,77,77
"60627",2019,0,0,83,83
"60627",2020,0,0,32,32
"60628",2015,0,0,84,84
"60628",2017,0,0,96,96
"60628",2019,0,0,28,28
"60629",2015,0,0,84,84
"60629",2017,0,0,96,96
"60629",2019,0,0,28,28
"60630",2015,0,0,15,15
"60630",2017,0,0,114,114
"60630",2019,0,0,125,125
"60630",2020,0,0,32,32
"60631",2017,0,0,19,19
"60631",2018,0,0,46,46
"60631",2019,0,0,198,198
"60631",2020,0,0,174,174
"60632",2015,0,0,28,28
"60632",2017,0,0,37,37
"60632",2019,0,0,25,25
"60632",2020,0,0,14,14
"60633",2015,0,0,84,84
"60633",2017,0,0,96,96
"60633",2019,0,0,28,28
"60634",2015,0,0,56,56
"60634",2017,0,0,83,83
"60634",2019,0,0,198,198
"60634",2020,0,0,240,240
"60635",2015,0,0,84,84
"60635",2017,0,0,96,96
"60635",2019,0,0,97,97
"60635",2020,0,0,13,13
"60636",2015,0,0,15,15
"60636",2017,0,0,56,56
"60636",2018,0,0,99,99
"60636",2019,0,0,62,62
"60636",2020,0,0,27,27
"60637",2015,0,0,33,33
"60637",2017,0,0,56,56
"60637",2019,0,0,49,49
"60637",2020,0,0,59,59
"60638",2015,0,0,84,84
"60638",2017,0,0,96,96
"60638",2019,0,0,28,28
"60639",2015,0,0,84,84
"60639",2017,0,0,96,96
"60639",2019,0,0,28,28
"60640",2015,0,0,15,15
"60640",2017,0,0,114,114
"60640",2019,0,0,125,125
"60640",2020,0,0,32,32
"60641",2015,0,0,15,15
"60641",2019,0,0,69,69
"60641",2020,0,0,13,13
"60642",2015,0,0,15,15
"60642",2019,0,0,69,69
"60642",2020,0,0,13,13
"60643",2015,0,0,15,15
"60643",2017,0,0,37,37
"60643",2018,0,0,37,37
"60643",2019,0,0,25,25
"60644",2015,0,0,15,15
"60644",2017,0,0,114,114
"60644",2019,0,0,125,125
"60644",2020,0,0,32,32
"60645",2015,0,0,15,15
"60645",2017,0,0,114,114
"60645",2019,0,0,125,125
"60645",2020,0,0,32,32
"60646",2015,0,0,84,84
"60646",2017,0,0,96,96
"60646",2019,0,0,28,28
"60647",2015,0,0,15,15
"60647",2019,0,0,69,69
"60647",2020,0,0,13,13
"60648",2017,0,0,77,77
"60648",2019,0,0,83,83
"60648",2020,0,0,32,32
"60650",2015,0,0,20,20
"60650",2017,0,0,19,19
"60650",2018,0,0,136,136
"60650",2019,0,0,198,198
"60650",2020,0,0,233,233
"60651",2015,0,0,84,84
"60651",2017,0,0,96,96
"60651",2019,0,0,28,28
"60652",2015,0,0,84,84
"60652",2017,0,0,133,133
"60652",2019,0,0,153,153
"60652",2020,0,0,32,32
"60653",2015,0,0,56,56
"60653",2017,0,0,37,37
"60653",2018,0,0,37,37
"60653",2019,0,0,42,42
"60654",2015,0,0,15,15
"60654",2017,0,0,56,56
"60654",2018,0,0,37,37
"60654",2019,0,0,42,42
"60655",2015,0,0,28,28
"60655",2017,0,0,37,37
"60655",2019,0,0,25,25
"60655",2020,0,0,14,14
"60656",2015,0,0,33,33
"60656",2017,0,0,56,56
"60656",2019,0,0,49,49
"60656",2020,0,0,59,59
"60657",2015,0,0,28,28
"60657",2017,0,0,37,37
"60657",2019,0,0,25,25
"60657",2020,0,0,14,14
"60658",2015,0,0,20,20
"60658",2017,0,0,19,19
"60658",2018,0,0,136,136
"60658",2019,0,0,167,167
"60658",2020,0,0,59,59
"60659",2015,0,0,15,15
"60659",2017,0,0,114,114
"60659",2019,0,0,125,125
"60659",2020,0,0,32,32
"60660",2015,0,0,15,15
"60660",2017,0,0,114,114
"60660",2019,0,0,125,125
"60660",2020,0,0,32,32
"60661",2015,0,0,20,20
"60661",2017,0,0,56,56
"60661",2018,0,0,136,136
"60661",2019,0,0,88,88
"60661",2020,0,0,59,59
"60662",2015,0,0,84,84
"60662",2017,0,0,133,133
"60662",2019,0,0,153,153
"60662",2020,0,0,32,32
"60663",2015,0,0,84,84
"60663",2017,0,0,133,133
"60663",2019,0,0,198,198
"60663",2020,0,0,240,240
"60664",2017,0,0,77,77
"60664",2019,0,0,83,83
"60664",2020,0,0,32,32
"60665",2015,0,0,15,15
"60665",2019,0,0,69,69
"60665",2020,0,0,13,13
"60666",2017,0,0,19,19
"60666",2018,0,0,46,46
"60666",2019,0,0,198,198
"60666",2020,0,0,174,174
"60667",2015,0,0,20,20
"60667",2017,0,0,19,19
"60667",2018,0,0,136,136
"60667",2019,0,0,162,162
"60667",2020,0,0,201,201
"60668",2015,0,0,84,84
"60668",2017,0,0,96,96
"60668",2019,0,0,28,28
"60669",2015,0,0,56,56
"60669",2017,0,0,83,83
"60669",2019,0,0,162,162
"60669",2020,0,0,187,187
"60670",2015,0,0,56,56
"60670",2017,0,0,56,56
"60670",2018,0,0,46,46
"60670",2019,0,0,162,162
"60670",2020,0,0,187,187
"60671",2015,0,0,20,20
"60671",2017,0,0,19,19
"60671",2018,0,0,136,136
"60671",2019,0,0,198,198
"60671",2020,0,0,233,233
"60672",2015,0,0,20,20
"60672",2017,0,0,19,19
"60672",2018,0,0,136,136
"60672",2019,0,0,167,167
"60672",2020,0,0,59,59
"60673",2015,0,0,56,56
"60673",2017,0,0,83,83
"60673",2019,0,0,198,198
"60673",2020,0,0,240,240
"60674",2015,0,0,15,15
"60674",2019,0,0,69,69
"60674",2020,0,0,13,13
"60675",2015,0,0,15,15
"60675",2017,0,0,56,56
"60675",2018,0,0,37,37
"60675",2019,0,0,42,42
"60676",2015,0,0,28,28
"60676",2017,0,0,37,37
"60676",2019,0,0,25,25
"60676",2020,0,0,14,14
"60677",2015,0,0,84,84
"60677",2017,0,0,96,96
"60677",2019,0,0,28,28
"60678",2015,0,0,15,15
"60678",2017,0,0,114,114
"60678",2019,0,0,125,125
"60678",2020,0,0,32,32
"60679",2015,0,0,33,33
"60679",2017,0,0,56,56
"60679",2019,0,0,49,49
"60679",2020,0,0,59,59
"60680",2015,0,0,15,15
"60680",2017,0,0,19,19
"60680",2018,0,0,46,46
"60680",2019,0,0,162,162
"60680",2020,0,0,187,187
"60681",2015,0,0,84,84
"60681",2017,0,0,133,133
"60681",2019,0,0,153,153
"60681",2020,0,0,32,32
"60682",2015,0,0,15,15
"60682",2017,0,0,19,19
"60682",2018,0,0,46,46
"60682",2019,0,0,162,162
"60682",2020,0,0,187,187
"60683",2015,0,0,33,33
"60683",2017,0,0,56,56
"60683",2018,0,0,46,46
"60683",2019,0,0,119,119
"60683",2020,0,0,233,233
"60684",2015,0,0,56,56
"60684",2017,0,0,83,83
"60684",2019,0,0,162,162
"60684",2020,0,0,187,187
"60685",2015,0,0,84,84
"60685",2017,0,0,96,96
"60685",2019,0,0,28,28
"60686",2015,0,0,15,15
"60686",2019,0,0,69,69
"60686",2020,0,0,13,13
"60687",2015,0,0,84,84
"60687",2017,0,0,133,133
"60687",2019,0,0,153,153
"60687",2020,0,0,32,32
"60688",2015,0,0,84,84
"60688",2017,0,0,96,96
"60688",2019,0,0,28,28
"60689",2015,0,0,15,15
"60689",2017,0,0,56,56
"60689",2018,0,0,37,37
"60689",2019,0,0,42,42
"60691",2015,0,0,84,84
"60691",2017,0,0,133,133
"60691",2019,0,0,153,153
"60691",2020,0,0,32,32
"60692",2017,0,0,77,77
"60692",2019,0,0,83,83
"60692",2020,0,0,32,32
"60693",2015,0,0,28,28
"60693",2017,0,0,37,37
"60693",2019,0,0,56,56
"60693",2020,0,0,14,14
"60694",2015,0,0,84,84
"60694",2017,0,0,133,133
"60694",2019,0,0,153,153
"60694",2020,0,0,32,32
"60695",2015,0,0,15,15
"60695",2017,0,0,19,19
"60695",2018,0,0,46,46
"60695",2019,0,0,162,162
"60695",2020,0,0,187,187
"60697",2015,0,0,84,84
"60697",2017,0,0,96,96
"60697",2019,0,0,28,28
"60698",2015,0,0,15,15
"60698",2017,0,0,37,37
"60698",2018,0,0,37,37
"60698",2019,0,0,42,42
"60699",2015,0,0,84,84
"60699",2017,0,0,133,133
"60699",2019,0,0,153,153
"60699",2020,0,0,32,32
"60700",2015,0,0,84,84
"60700",2017,0,0,96,96
"60700",2019,0,0,28,28
"60701",2015,0,0,56,56
"60701",2017,0,0,114,114
"60701",2019,0,0,97,97
"60701",2020,0,0,240,240
"60702",2017,0,0,77,77
"60702",2019,0,0,83,83
"60702",2020,0,0,32,32
"60703",2015,0,0,84,84
"60703",2017,0,0,96,96
"60703",2019,0,0,28,28
"61001",2016,0,0,69,69
"61001",2017,0,0,34,34
"61001",2019,0,0,7,7
"61002",2019,0,0,108,108
"61005",2017,0,0,100,100
"61005",2019,0,0,108,108
"61005",2020,0,0,63,63
"61006",2019,0,0,108,108
"61007",2016,0,0,69,69
"61007",2017,0,0,110,110
"61007",2019,0,0,80,80
"61007",2020,0,0,47,47
"61008",2016,0,0,69,69
"61008",2017,0,0,168,168
"61008",2019,0,0,87,87
"61010",2019,0,0,108,108
"61011",2016,0,0,69,69
"61011",2017,0,0,110,110
"61011",2019,0,0,80,80
"61011",2020,0,0,47,47
"61012",2016,0,0,69,69
"61012",2017,0,0,34,34
"61012",2020,0,0,21,21
"61013",2016,0,0,69,69
"61013",2017,0,0,34,34
"61013",2019,0,0,7,7
"61014",2019,0,0,108,108
"61015",2016,0,0,69,69
"61015",2017,0,0,34,34
"61015",2019,0,0,7,7
"61017",2016,0,0,69,69
"61017",2017,0,0,168,168
"61017",2019,0,0,87,87
"61018",2019,0,0,108,108
"61020",2019,0,0,108,108
"61021",2017,0,0,34,34
"61021",2020,0,0,8,8
"61023",2019,0,0,108,108
"61024",2017,0,0,63,63
"61024",2019,0,0,108,108
"61026",2016,0,0,69,69
"61026",2017,0,0,34,34
"61026",2019,0,0,7,7
"61028",2016,0,0,69,69
"61028",2017,0,0,110,110
"61028",2019,0,0,80,80
"61028",2020,0,0,47,47
"61029",2016,0,0,69,69
"61029",2017,0,0,34,34
"61029",2019,0,0,7,7
"61030",2016,0,0,69,69
"61030",2017,0,0,110,110
"61030",2019,0,0,80,80
"61030",2020,0,0,47,47
"61032",2016,0,0,69,69
"61032",2017,0,0,168,168
"61032",2019,0,0,87,87
"61034",2015,0,0,73,73
"61034",2017,0,0,34,34
"61034",2020,0,0,21,21
"61035",2017,0,0,81,81
"61035",2020,0,0,8,8
"61036",2019,0,0,108,108
"61037",2016,0,0,69,69
"61037",2017,0,0,34,34
"61037",2019,0,0,108,108
"61037",2020,0,0,63,63
"61038",2017,0,0,100,100
"61038",2019,0,0,108,108
"61038",2020,0,0,63,63
"61039",2019,0,0,108,108
"61040",2017,0,0,63,63
"61040",2019,0,0,80,80
"61040",2020,0,0,47,47
"61041",2017,0,0,100,100
"61041",2019,0,0,108,108
"61041",2020,0,0,63,63
"61043",2017,0,0,100,100
"61043",2019,0,0,108,108
"61043",2020,0,0,63,63
"61044",2016,0,0,69,69
"61044",2017,0,0,110,110
"61044",2019,0,0,80,80
"61044",2020,0,0,47,47
"61046",2017,0,0,100,100
"61046",2019,0,0,108,108
"61046",2020,0,0,63,63
"61048",2016,0,0,69,69
"61048",2017,0,0,34,34
"61048",2019,0,0,7,7
"61049",2019,0,0,108,108
"61050",2017,0,0,100,100
"61050",2019,0,0,108,108
"61050",2020,0,0,63,63
"61051",2016,0,0,69,69
"61051",2017,0,0,34,34
"61051",2019,0,0,7,7
"61052",2016,0,0,69,69
"61052",2017,0,0,34,34
"61052",2020,0,0,21,21
"61053",2016,0,0,69,69
"61053",2017,0,0,34,34
"61053",2020,0,0,21,21
"61054",2019,0,0,108,108
"61055",2019,0,0,108,108
"61056",2016,0,0,69,69
"61056",2017,0,0,34,34
"61056",2019,0,0,7,7
"61060",2016,0,0,69,69
"61060",2017,0,0,168,168
"61060",2019,0,0,87,87
"61061",2017,0,0,100,100
"61061",2019,0,0,108,108
"61061",2020,0,0,63,63
"61062",2019,0,0,108,108
"61063",2016,0,0,69,69
"61063",2017,0,0,110,110
"61063",2019,0,0,80,80
"61063",2020,0,0,47,47
"61064",2016,0,0,69,69
"61064",2017,0,0,34,34
"61064",2019,0,0,7,7
"61066",2016,0,0,69,69
"61066",2017,0,0,34,34
"61066",2019,0,0,7,7
"61067",2016,0,0,69,69
"61067",2017,0,0,34,34
"61067",2019,0,0,7,7
"61068",2016,0,0,69,69
"61068",2017,0,0,34,34
"61068",2019,0,0,7,7
"61069",2016,0,0,69,69
"61069",2017,0,0,110,110
"61069",2019,0,0,80,80
"61069",2020,0,0,47,47
"61070",2016,0,0,69,69
"61070",2017,0,0,110,110
"61070",2019,0,0,80,80
"61070",2020,0,0,47,47
"61071",2019,0,0,108,108
"61072",2019,0,0,108,108
"61074",2017,0,0,81,81
"61074",2020,0,0,8,8
"61075",2017,0,0,34,34
"61075",2020,0,0,8,8
"61076",2019,0,0,108,108
"61077",2016,0,0,69,69
"61077",2017,0,0,34,34
"61077",2019,0,0,7,7
"61078",2016,0,0,69,69
"61078",2017,0,0,110,110
"61078",2019,0,0,80,80
"61078",2020,0,0,47,47
"61079",2017,0,0,100,100
"61079",2019,0,0,108,108
"61079",2020,0,0,63,63
"61080",2017,0,0,46,46
"61080",2020,0,0,8,8
"61081",2019,0,0,108,108
"61082",2016,0,0,69,69
"61082",2017,0,0,34,34
"61082",2019,0,0,7,7
"61084",2016,0,0,69,69
"61084",2017,0,0,110,110
"61084",2019,0,0,80,80
"61084",2020,0,0,47,47
"61085",2017,0,0,81,81
"61085",2020,0,0,8,8
"61086",2019,0,0,108,108
"61087",2016,0,0,69,69
"61087",2017,0,0,34,34
"61087",2019,0,0,7,7
"61088",2016,0,0,69,69
"61088",2017,0,0,168,168
"61088",2019,0,0,87,87
"61089",2019,0,0,108,108
"61091",2017,0,0,34,34
"61091",2020,0,0,8,8
"61092",2016,0,0,69,69
"61092",2017,0,0,34,34
"61092",2020,0,0,21,21
"61093",2017,0,0,63,63
"61093",2019,0,0,80,80
"61093",2020,0,0,47,47
"61094",2017,0,0,63,63
"61094",2019,0,0,80,80
"61094",2020,0,0,47,47
"61095",2017,0,0,63,63
"61095",2019,0,0,80,80
"61095",2020,0,0,47,47
"61096",2017,0,0,81,81
"61096",2020,0,0,8,8
"61097",2017,0,0,100,100
"61097",2019,0,0,108,108
"61097",2020,0,0,63,63
"61098",2016,0,0,69,69
"61098",2017,0,0,34,34
"61098",2019,0,0,7,7
"61099",2017,0,0,100,100
"61099",2019,0,0,108,108
"61099",2020,0,0,63,63
"61100",2016,0,0,69,69
"61100",2017,0,0,34,34
"61100",2020,0,0,21,21
"61101",2019,0,0,108,108
"61102",2017,0,0,63,63
"61102",2019,0,0,108,108
"61103",2016,0,0,69,69
"61103",2017,0,0,168,168
"61103",2019,0,0,87,87
"61104",2017,0,0,81,81
"61104",2020,0,0,8,8
"61105",2016,0,0,69,69
"61105",2017,0,0,34,34
"61105",2019,0,0,7,7
"61107",2017,0,0,46,46
"61107",2020,0,0,8,8
"61108",2016,0,0,69,69
"61108",2017,0,0,168,168
"61108",2019,0,0,87,87
"61111",2016,0,0,69,69
"61111",2017,0,0,34,34
"61111",2019,0,0,7,7
"61113",2017,0,0,100,100
"61113",2019,0,0,108,108
"61113",2020,0,0,63,63
"61114",2016,0,0,69,69
"61114",2017,0,0,110,110
"61114",2019,0,0,80,80
"61114",2020,0,0,47,47
"61116",2017,0,0,100,100
"61116",2019,0,0,108,108
"61116",2020,0,0,63,63
"61117",2016,0,0,69,69
"61117",2017,0,0,34,34
"61117",2019,0,0,7,7
"61118",2017,0,0,100,100
"61118",2019,0,0,108,108
"61118",2020,0,0,63,63
"61120",2019,0,0,108,108
"61121",2016,0,0,69,69
"61121",2017,0,0,34,34
"61121",2019,0,0,7,7
"61122",2019,0,0,108,108
"61123",2019,0,0,108,108
"61124",2017,0,0,34,34
"61124",2020,0,0,8,8
"61126",2016,0,0,69,69
"61126",2017,0,0,34,34
"61126",2019,0,0,7,7
"61129",2017,0,0,100,100
"61129",2019,0,0,108,108
"61129",2020,0,0,63,63
"61130",2016,0,0,69,69
"61130",2017,0,0,34,34
"61130",2019,0,0,7,7
"61133",2016,0,0,69,69
"61133",2017,0,0,34,34
"61133",2019,0,0,7,7
"61137",2016,0,0,69,69
"61137",2017,0,0,110,110
"61137",2019,0,0,80,80
"61137",2020,0,0,47,47
"61138",2019,0,0,108,108
"61139",2019,0,0,108,108
"61140",2015,0,0,73,73
"61140",2017,0,0,34,34
"61140",2020,0,0,21,21
"61141",2016,0,0,69,69
"61141",2017,0,0,34,34
"61141",2019,0,0,7,7
"61142",2017,0,0,100,100
"61142",2019,0,0,108,108
"61142",2020,0,0,63,63
"61143",2016,0,0,69,69
"61143",2017,0,0,34,34
"61143",2019,0,0,7,7
"61145",2017,0,0,34,34
"61145",2020,0,0,8,8
"61146",2017,0,0,63,63
"61146",2019,0,0,108,108
"61148",2016,0,0,69,69
"61148",2017,0,0,110,110
"61148",2019,0,0,80,80
"61148",2020,0,0,47,47
"61149",2017,0,0,63,63
"61149",2019,0,0,80,80
"61149",2020,0,0,47,47
"61150",2016,0,0,69,69
"61150",2017,0,0,168,168
"61150",2019,0,0,87,87
"61151",2016,0,0,69,69
"61151",2017,0,0,34,34
"61151",2020,0,0,21,21
"61152",2019,0,0,108,108
"61153",2019,0,0,108,108
"61156",2016,0,0,69,69
"61156",2017,0,0,34,34
"61156",2019,0,0,7,7
"61158",2016,0,0,69,69
"61158",2017,0,0,110,110
"61158",2019,0,0,80,80
"61158",2020,0,0,47,47
"61159",2016,0,0,69,69
"61159",2017,0,0,67,67
"61159",2019,0,0,7,7
"61160",2017,0,0,100,100
"61160",2019,0,0,108,108
"61160",2020,0,0,63,63
"61162",2016,0,0,69,69
"61162",2017,0,0,34,34
"61162",2020,0,0,21,21
"61163",2017,0,0,34,34
"61163",2020,0,0,8,8
"61164",2016,0,0,69,69
"61164",2017,0,0,34,34
"61164",2019,0,0,7,7
"61165",2016,0,0,69,69
"61165",2017,0,0,34,34
"61165",2019,0,0,7,7
"61166",2016,0,0,69,69
"61166",2017,0,0,67,67
"61166",2019,0,0,7,7
"61167",2016,0,0,69,69
"61167",2017,0,0,168,168
"61167",2019,0,0,87,87
"61168",2017,0,0,81,81
"61168",2020,0,0,8,8
"61169",2017,0,0,63,63
"61169",2019,0,0,80,80
"61169",2020,0,0,47,47
"61170",2019,0,0,108,108
"61171",2019,0,0,108,108
"61176",2019,0,0,108,108
"61178",2019,0,0,108,108
"61180",2019,0,0,108,108
"61181",2019,0,0,108,108
"61182",2017,0,0,46,46
"61182",2020,0,0,8,8
"61183",2016,0,0,69,69
"61183",2017,0,0,34,34
"61183",2019,0,0,7,7
"61187",2016,0,0,69,69
"61187",2017,0,0,34,34
"61187",2020,0,0,21,21
"61188",2016,0,0,69,69
"61188",2017,0,0,67,67
"61188",2019,0,0,7,7
"61189",2016,0,0,69,69
"61189",2017,0,0,110,110
"61189",2019,0,0,80,80
"61189",2020,0,0,47,47
"61190",2019,0,0,108,108
"61192",2019,0,0,108,108
"61193",2016,0,0,69,69
"61193",2017,0,0,168,168
"61193",2019,0,0,87,87
"61194",2016,0,0,69,69
"61194",2017,0,0,110,110
"61194",2019,0,0,80,80
"61194",2020,0,0,47,47
"61195",2017,0,0,81,81
"61195",2020,0,0,8,8
"61196",2016,0,0,69,69
"61196",2017,0,0,34,34
"61196",2019,0,0,7,7
"61197",2019,0,0,108,108
"61198",2019,0,0,108,108
"61199",2016,0,0,69,69
"61199",2017,0,0,110,110
"61199",2019,0,0,80,80
"61199",2020,0,0,47,47
"61202",2016,0,0,69,69
"61202",2017,0,0,34,34
"61202",2019,0,0,7,7
"61203",2016,0,0,69,69
"61203",2017,0,0,34,34
"61203",2019,0,0,7,7
"61206",2015,0,0,73,73
"61206",2017,0,0,34,34
"61206",2020,0,0,21,21
"61207",2016,0,0,69,69
"61207",2017,0,0,34,34
"61207",2019,0,0,7,7
"61208",2015,0,0,73,73
"61208",2017,0,0,34,34
"61208",2020,0,0,21,21
"61209",2017,0,0,81,81
"61209",2020,0,0,8,8
"61210",2019,0,0,108,108
"61211",2017,0,0,34,34
"61211",2020,0,0,8,8
"61212",2019,0,0,108,108
"61213",2017,0,0,46,46
"61213",2020,0,0,8,8
"61214",2016,0,0,69,69
"61214",2017,0,0,34,34
"61214",2020,0,0,21,21
"61215",2016,0,0,69,69
"61215",2017,0,0,34,34
"61215",2019,0,0,7,7
"61216",2016,0,0,69,69
"61216",2017,0,0,34,34
"61216",2019,0,0,7,7
"61217",2019,0,0,108,108
"61218",2016,0,0,69,69
"61218",2017,0,0,110,110
"61218",2019,0,0,80,80
"61218",2020,0,0,47,47
"61219",2016,0,0,69,69
"61219",2017,0,0,110,110
"61219",2019,0,0,80,80
"61219",2020,0,0,47,47
"61221",2017,0,0,63,63
"61221",2019,0,0,80,80
"61221",2020,0,0,47,47
"61222",2017,0,0,63,63
"61222",2019,0,0,80,80
"61222",2020,0,0,47,47
"61224",2016,0,0,69,69
"61224",2017,0,0,34,34
"61224",2019,0,0,7,7
"61225",2019,0,0,108,108
"61227",2016,0,0,69,69
"61227",2017,0,0,110,110
"61227",2019,0,0,80,80
"61227",2020,0,0,47,47
"61228",2016,0,0,69,69
"61228",2017,0,0,34,34
"61228",2019,0,0,7,7
"61229",2017,0,0,100,100
"61229",2019,0,0,108,108
"61229",2020,0,0,63,63
"61230",2015,0,0,73,73
"61230",2017,0,0,34,34
"61230",2020,0,0,21,21
"61232",2017,0,0,63,63
"61232",2019,0,0,108,108
"61233",2017,0,0,81,81
"61233",2020,0,0,8,8
"61234",2016,0,0,69,69
"61234",2017,0,0,34,34
"61234",2019,0,0,7,7
"61237",2019,0,0,108,108
"61238",2019,0,0,108,108
"61240",2019,0,0,108,108
"61241",2017,0,0,100,100
"61241",2019,0,0,108,108
"61241",2020,0,0,63,63
"61242",2017,0,0,100,100
"61242",2019,0,0,108,108
"61242",2020,0,0,63,63
"61243",2017,0,0,81,81
"61243",2020,0,0,8,8
"61244",2016,0,0,69,69
"61244",2017,0,0,67,67
"61244",2020,0,0,21,21
"61248",2017,0,0,63,63
"61248",2019,0,0,108,108
"61251",2016,0,0,69,69
"61251",2017,0,0,34,34
"61251",2019,0,0,7,7
"61252",2019,0,0,108,108
"61255",2017,0,0,100,100
"61255",2019,0,0,108,108
"61255",2020,0,0,63,63
"61256",2019,0,0,108,108
"61257",2017,0,0,81,81
"61257",2020,0,0,8,8
"61258",2016,0,0,69,69
"61258",2017,0,0,34,34
"61258",2019,0,0,7,7
"61259",2016,0,0,69,69
"61259",2017,0,0,34,34
"61259",2020,0,0,21,21
"61260",2017,0,0,81,81
"61260",2020,0,0,8,8
"61261",2016,0,0,69,69
"61261",2017,0,0,34,34
"61261",2019,0,0,7,7
"61262",2017,0,0,63,63
"61262",2019,0,0,80,80
"61262",2020,0,0,47,47
"61263",2016,0,0,69,69
"61263",2017,0,0,34,34
"61263",2019,0,0,7,7
"61264",2019,0,0,108,108
"61265",2016,0,0,69,69
"61265",2017,0,0,110,110
"61265",2019,0,0,80,80
"61265",2020,0,0,47,47
"61266",2016,0,0,69,69
"61266",2017,0,0,34,34
"61266",2019,0,0,7,7
"61267",2016,0,0,69,69
"61267",2017,0,0,110,110
"61267",2019,0,0,80,80
"61267",2020,0,0,47,47
"61268",2019,0,0,108,108
"61269",2016,0,0,69,69
"61269",2017,0,0,110,110
"61269",2019,0,0,80,80
"61269",2020,0,0,47,47
"61271",2019,0,0,108,108
"61272",2019,0,0,108,108
"61273",2016,0,0,69,69
"61273",2017,0,0,110,110
"61273",2019,0,0,80,80
"61273",2020,0,0,47,47
"61274",2017,0,0,100,100
"61274",2019,0,0,108,108
"61274",2020,0,0,63,63
"61275",2019,0,0,108,108
"61276",2019,0,0,108,108
"61277",2016,0,0,69,69
"61277",2017,0,0,34,34
"61277",2019,0,0,7,7
"61278",2017,0,0,63,63
"61278",2019,0,0,80,80
"61278",2020,0,0,47,47
"61279",2016,0,0,69,69
"61279",2017,0,0,34,34
"61279",2019,0,0,7,7
"61281",2016,0,0,69,69
"61281",2017,0,0,110,110
"61281",2019,0,0,80,80
"61281",2020,0,0,47,47
"61283",2016,0,0,69,69
"61283",2017,0,0,110,110
"61283",2019,0,0,80,80
"61283",2020,0,0,47,47
"61284",2016,0,0,69,69
"61284",2017,0,0,34,34
"61284",2019,0,0,7,7
"61286",2016,0,0,69,69
"61286",2017,0,0,34,34
"61286",2019,0,0,7,7
"61287",2016,0,0,69,69
"61287",2017,0,0,110,110
"61287",2019,0,0,80,80
"61287",2020,0,0,47,47
"61288",2019,0,0,108,108
"61289",2019,0,0,108,108
"61290",2016,0,0,69,69
"61290",2017,0,0,110,110
"61290",2019,0,0,80,80
"61290",2020,0,0,47,47
"61291",2019,0,0,108,108
"61292",2016,0,0,69,69
"61292",2017,0,0,110,110
"61292",2019,0,0,80,80
"61292",2020,0,0,47,47
"61293",2016,0,0,69,69
"61293",2017,0,0,34,34
"61293",2019,0,0,7,7
"61294",2019,0,0,108,108
"61295",2017,0,0,81,81
"61295",2020,0,0,8,8
"61297",2016,0,0,69,69
"61297",2017,0,0,34,34
"61297",2020,0,0,21,21
"61298",2019,0,0,108,108
"61300",2017,0,0,100,100
"61300",2019,0,0,108,108
"61300",2020,0,0,63,63
"61301",2016,0,0,69,69
"61301",2017,0,0,34,34
"61301",2019,0,0,7,7
"61302",2019,0,0,108,108
"61303",2016,0,0,69,69
"61303",2017,0,0,110,110
"61303",2019,0,0,80,80
"61303",2020,0,0,47,47
"61304",2016,0,0,69,69
"61304",2017,0,0,34,34
"61304",2019,0,0,7,7
"61307",2019,0,0,108,108
"61308",2016,0,0,69,69
"61308",2017,0,0,110,110
"61308",2019,0,0,80,80
"61308",2020,0,0,47,47
"61309",2017,0,0,100,100
"61309",2019,0,0,108,108
"61309",2020,0,0,63,63
"61310",2019,0,0,108,108
"61314",2019,0,0,108,108
"61316",2019,0,0,108,108
"61317",2016,0,0,69,69
"61317",2017,0,0,168,168
"61317",2019,0,0,87,87
"61319",2016,0,0,69,69
"61319",2017,0,0,34,34
"61319",2019,0,0,7,7
"61321",2016,0,0,69,69
"61321",2017,0,0,34,34
"61321",2019,0,0,7,7
"61322",2016,0,0,69,69
"61322",2017,0,0,34,34
"61322",2019,0,0,7,7
"61323",2017,0,0,100,100
"61323",2019,0,0,108,108
"61323",2020,0,0,63,63
"61324",2017,0,0,63,63
"61324",2019,0,0,108,108
"61326",2017,0,0,34,34
"61326",2020,0,0,8,8
"61327",2016,0,0,69,69
"61327",2017,0,0,34,34
"61327",2019,0,0,7,7
"61328",2019,0,0,108,108
"61329",2017,0,0,100,100
"61329",2019,0,0,108,108
"61329",2020,0,0,63,63
"61330",2016,0,0,69,69
"61330",2017,0,0,67,67
"61330",2019,0,0,7,7
"61331",2016,0,0,69,69
"61331",2017,0,0,34,34
"61331",2019,0,0,7,7
"61332",2016,0,0,69,69
"61332",2017,0,0,110,110
"61332",2019,0,0,80,80
"61332",2020,0,0,47,47
"61333",2019,0,0,108,108
"61336",2017,0,0,100,100
"61336",2019,0,0,108,108
"61336",2020,0,0,63,63
"61339",2016,0,0,69,69
"61339",2017,0,0,110,110
"61339",2019,0,0,80,80
"61339",2020,0,0,47,47
"61341",2016,0,0,69,69
"61341",2017,0,0,34,34
"61341",2019,0,0,7,7
"61342",2016,0,0,69,69
"61342",2017,0,0,168,168
"61342",2019,0,0,87,87
"61344",2017,0,0,81,81
"61344",2020,0,0,8,8
"61345",2017,0,0,100,100
"61345",2019,0,0,108,108
"61345",2020,0,0,63,63
"61346",2019,0,0,108,108
"61347",2019,0,0,108,108
"61348",2017,0,0,100,100
"61348",2019,0,0,108,108
"61348",2020,0,0,63,63
"61349",2016,0,0,69,69
"61349",2017,0,0,110,110
"61349",2019,0,0,80,80
"61349",2020,0,0,47,47
"61350",2016,0,0,69,69
"61350",2017,0,0,34,34
"61350",2019,0,0,7,7
"61351",2019,0,0,108,108
"61352",2016,0,0,69,69
"61352",2017,0,0,110,110
"61352",2019,0,0,80,80
"61352",2020,0,0,47,47
"61357",2016,0,0,69,69
"61357",2017,0,0,34,34
"61357",2019,0,0,7,7
"61358",2019,0,0,108,108
"61360",2016,0,0,69,69
"61360",2017,0,0,34,34
"61360",2019,0,0,7,7
"61361",2016,0,0,69,69
"61361",2017,0,0,110,110
"61361",2019,0,0,80,80
"61361",2020,0,0,47,47
"61362",2017,0,0,63,63
"61362",2019,0,0,108,108
"61363",2016,0,0,69,69
"61363",2017,0,0,34,34
"61363",2020,0,0,21,21
"61365",2016,0,0,69,69
"61365",2017,0,0,34,34
"61365",2019,0,0,7,7
"61366",2019,0,0,108,108
"61367",2016,0,0,69,69
"61367",2017,0,0,34,34
"61367",2019,0,0,7,7
"61369",2017,0,0,63,63
"61369",2019,0,0,108,108
"61370",2017,0,0,34,34
"61370",2020,0,0,8,8
"61371",2019,0,0,108,108
"61372",2016,0,0,69,69
"61372",2017,0,0,34,34
"61372",2019,0,0,7,7
"61373",2016,0,0,69,69
"61373",2017,0,0,34,34
"61373",2020,0,0,21,21
"61374",2017,0,0,63,63
"61374",2019,0,0,80,80
"61374",2020,0,0,47,47
"61375",2019,0,0,108,108
"61376",2017,0,0,63,63
"61376",2019,0,0,80,80
"61376",2020,0,0,47,47
"61379",2017,0,0,100,100
"61379",2019,0,0,108,108
"61379",2020,0,0,63,63
"61381",2017,0,0,100,100
"61381",2019,0,0,108,108
"61381",2020,0,0,63,63
"61382",2016,0,0,69,69
"61382",2017,0,0,34,34
"61382",2019,0,0,7,7
"61384",2017,0,0,46,46
"61384",2020,0,0,8,8
"61385",2016,0,0,69,69
"61385",2017,0,0,168,168
"61385",2019,0,0,87,87
"61386",2016,0,0,69,69
"61386",2017,0,0,168,168
"61386",2019,0,0,87,87
"61387",2017,0,0,34,34
"61387",2020,0,0,8,8
"61388",2016,0,0,69,69
"61388",2017,0,0,34,34
"61388",2019,0,0,7,7
"61389",2016,0,0,69,69
"61389",2017,0,0,67,67
"61389",2020,0,0,21,21
"61390",2017,0,0,81,81
"61390",2020,0,0,8,8
"61391",2016,0,0,69,69
"61391",2017,0,0,110,110
"61391",2019,0,0,80,80
"61391",2020,0,0,47,47
"61392",2019,0,0,87,87
"61393",2019,0,0,108,108
"61394",2017,0,0,100,100
"61394",2019,0,0,108,108
"61394",2020,0,0,63,63
"61395",2017,0,0,100,100
"61395",2019,0,0,108,108
"61395",2020,0,0,63,63
"61396",2016,0,0,69,69
"61396",2017,0,0,34,34
"61396",2019,0,0,7,7
"61397",2016,0,0,69,69
"61397",2017,0,0,34,34
"61397",2019,0,0,7,7
"61398",2016,0,0,69,69
"61398",2017,0,0,34,34
"61398",2019,0,0,7,7
"61399",2019,0,0,108,108
"61400",2016,0,0,69,69
"61400",2017,0,0,34,34
"61400",2019,0,0,7,7
"61401",2017,0,0,63,63
"61401",2019,0,0,108,108
"61402",2016,0,0,69,69
"61402",2017,0,0,110,110
"61402",2019,0,0,80,80
"61402",2020,0,0,47,47
"61404",2016,0,0,69,69
"61404",2017,0,0,34,34
"61404",2019,0,0,7,7
"61405",2017,0,0,100,100
"61405",2019,0,0,108,108
"61405",2020,0,0,63,63
"61406",2016,0,0,69,69
"61406",2017,0,0,168,168
"61406",2019,0,0,87,87
"61407",2016,0,0,69,69
"61407",2017,0,0,110,110
"61407",2019,0,0,80,80
"61407",2020,0,0,47,47
"61408",2016,0,0,69,69
"61408",2017,0,0,110,110
"61408",2019,0,0,80,80
"61408",2020,0,0,47,47
"61411",2016,0,0,69,69
"61411",2017,0,0,34,34
"61411",2019,0,0,7,7
"61412",2016,0,0,69,69
"61412",2017,0,0,34,34
"61412",2019,0,0,7,7
"61413",2019,0,0,108,108
"61414",2016,0,0,69,69
"61414",2017,0,0,34,34
"61414",2019,0,0,7,7
"61415",2016,0,0,69,69
"61415",2017,0,0,34,34
"61415",2019,0,0,7,7
"61416",2019,0,0,7,7
"61418",2017,0,0,100,100
"61418",2019,0,0,108,108
"61418",2020,0,0,63,63
"61419",2019,0,0,108,108
"61420",2019,0,0,108,108
"61421",2017,0,0,63,63
"61421",2019,0,0,108,108
"61422",2015,0,0,73,73
"61422",2017,0,0,34,34
"61422",2020,0,0,21,21
"61423",2016,0,0,69,69
"61423",2017,0,0,168,168
"61423",2019,0,0,87,87
"61424",2017,0,0,46,46
"61424",2020,0,0,8,8
"61425",2016,0,0,69,69
"61425",2017,0,0,34,34
"61425",2020,0,0,21,21
"61426",2017,0,0,100,100
"61426",2019,0,0,108,108
"61426",2020,0,0,63,63
"61427",2017,0,0,81,81
"61427",2020,0,0,8,8
"61429",2015,0,0,73,73
"61429",2017,0,0,34,34
"61429",2020,0,0,21,21
"61432",2016,0,0,69,69
"61432",2017,0,0,34,34
"61432",2020,0,0,21,21
"61433",2016,0,0,69,69
"61433",2017,0,0,34,34
"61433",2019,0,0,7,7
"61435",2016,0,0,69,69
"61435",2017,0,0,168,168
"61435",2019,0,0,87,87
"61436",2016,0,0,69,69
"61436",2017,0,0,110,110
"61436",2019,0,0,80,80
"61436",2020,0,0,47,47
"61438",2016,0,0,69,69
"61438",2017,0,0,34,34
"61438",2020,0,0,21,21
"61439",2017,0,0,81,81
"61439",2020,0,0,8,8
"61440",2016,0,0,69,69
"61440",2017,0,0,34,34
"61440",2020,0,0,21,21
"61442",2017,0,0,81,81
"61442",2020,0,0,8,8
"61443",2017,0,0,63,63
"61443",2019,0,0,80,80
"61443",2020,0,0,47,47
"61444",2016,0,0,69,69
"61444",2017,0,0,110,110
"61444",2019,0,0,80,80
"61444",2020,0,0,47,47
"61445",2016,0,0,69,69
"61445",2017,0,0,110,110
"61445",2019,0,0,80,80
"61445",2020,0,0,47,47
"61446",2016,0,0,69,69
"61446",2017,0,0,168,168
"61446",2019,0,0,87,87
"61447",2016,0,0,69,69
"61447",2017,0,0,110,110
"61447",2019,0,0,80,80
"61447",2020,0,0,47,47
"61448",2017,0,0,100,100
"61448",2019,0,0,108,108
"61448",2020,0,0,63,63
"61450",2016,0,0,69,69
"61450",2017,0,0,34,34
"61450",2019,0,0,7,7
"61451",2016,0,0,69,69
"61451",2017,0,0,110,110
"61451",2019,0,0,80,80
"61451",2020,0,0,47,47
"61452",2017,0,0,63,63
"61452",2019,0,0,108,108
"61453",2019,0,0,108,108
"61454",2016,0,0,69,69
"61454",2017,0,0,34,34
"61454",2019,0,0,7,7
"61456",2016,0,0,69,69
"61456",2017,0,0,34,34
"61456",2020,0,0,21,21
"61457",2016,0,0,69,69
"61457",2017,0,0,168,168
"61457",2019,0,0,87,87
"61459",2017,0,0,63,63
"61459",2019,0,0,80,80
"61459",2020,0,0,47,47
"61460",2016,0,0,69,69
"61460",2017,0,0,168,168
"61460",2019,0,0,87,87
"61461",2016,0,0,69,69
"61461",2017,0,0,168,168
"61461",2019,0,0,87,87
"61462",2019,0,0,108,108
"61463",2017,0,0,34,34
"61463",2020,0,0,8,8
"61464",2016,0,0,69,69
"61464",2017,0,0,34,34
"61464",2019,0,0,7,7
"61466",2017,0,0,63,63
"61466",2019,0,0,80,80
"61466",2020,0,0,47,47
"61467",2016,0,0,69,69
"61467",2017,0,0,34,34
"61467",2019,0,0,7,7
"61472",2019,0,0,108,108
"61473",2019,0,0,108,108
"61474",2019,0,0,108,108
"61475",2015,0,0,73,73
"61475",2017,0,0,34,34
"61475",2020,0,0,21,21
"61476",2016,0,0,69,69
"61476",2017,0,0,34,34
"61476",2019,0,0,7,7
"61479",2019,0,0,108,108
"61480",2019,0,0,7,7
"61481",2016,0,0,69,69
"61481",2017,0,0,34,34
"61481",2019,0,0,7,7
"61482",2017,0,0,81,81
"61482",2020,0,0,8,8
"61483",2017,0,0,81,81
"61483",2020,0,0,8,8
"61484",2017,0,0,100,100
"61484",2019,0,0,108,108
"61484",2020,0,0,63,63
"61485",2019,0,0,108,108
"61486",2017,0,0,63,63
"61486",2019,0,0,80,80
"61486",2020,0,0,47,47
"61487",2017,0,0,34,34
"61487",2020,0,0,8,8
"61488",2016,0,0,69,69
"61488",2017,0,0,168,168
"61488",2019,0,0,87,87
"61490",2019,0,0,108,108
"61491",2015,0,0,73,73
"61491",2017,0,0,34,34
"61491",2020,0,0,21,21
"61492",2016,0,0,69,69
"61492",2017,0,0,34,34
"61492",2019,0,0,7,7
"61493",2016,0,0,69,69
"61493",2017,0,0,168,168
"61493",2019,0,0,87,87
"61494",2019,0,0,108,108
"61497",2016,0,0,69,69
"61497",2017,0,0,34,34
"61497",2019,0,0,7,7
"61498",2016,0,0,69,69
"61498",2017,0,0,34,34
"61498",2019,0,0,7,7
"61499",2016,0,0,69,69
"61499",2017,0,0,34,34
"61499",2019,0,0,7,7
"61500",2015,0,0,73,73
"61500",2017,0,0,34,34
"61500",2019,0,0,108,108
"61500",2020,0,0,63,63
"61501",2017,0,0,100,100
"61501",2019,0,0,108,108
"61501",2020,0,0,63,63
"61502",2016,0,0,69,69
"61502",2017,0,0,34,34
"61502",2019,0,0,7,7
"61503",2019,0,0,108,108
"61505",2019,0,0,108,108
"61507",2016,0,0,69,69
"61507",2017,0,0,34,34
"61507",2019,0,0,7,7
"61508",2019,0,0,108,108
"61510",2015,0,0,73,73
"61510",2017,0,0,34,34
"61510",2020,0,0,21,21
"61512",2016,0,0,69,69
"61512",2017,0,0,110,110
"61512",2019,0,0,80,80
"61512",2020,0,0,47,47
"62001",2018,0,91,91,182
"62001",2019,0,98,98,196
"62001",2020,0,118,118,236
"62002",2018,0,91,91,182
"62002",2019,0,98,98,196
"62002",2020,0,118,118,236
"62003",2018,0,91,91,182
"62003",2019,0,98,98,196
"62003",2020,0,118,118,236
"62004",2018,0,91,91,182
"62004",2019,0,98,98,196
"62004",2020,0,118,118,236
"62005",2018,0,91,91,182
"62005",2019,0,98,98,196
"62005",2020,0,118,118,236
"62006",2018,0,91,91,182
"62006",2019,0,98,98,196
"62006",2020,0,118,118,236
"62007",2018,0,91,91,182
"62007",2019,0,98,98,196
"62007",2020,0,118,118,236
"62008",2018,0,91,91,182
"62008",2019,0,98,98,196
"62008",2020,0,118,118,236
"62009",2018,0,91,91,182
"62009",2019,0,98,98,196
"62009",2020,0,118,118,236
"62010",2018,0,91,91,182
"62010",2019,0,98,98,196
"62010",2020,0,118,118,236
"62011",2018,0,91,91,182
"62011",2019,0,98,98,196
"62011",2020,0,118,118,236
"62012",2018,0,91,91,182
"62012",2019,0,98,98,196
"62012",2020,0,118,118,236
"62013",2018,0,91,91,182
"62013",2019,0,98,98,196
"62013",2020,0,118,118,236
"62014",2018,0,91,91,182
"62014",2019,0,98,98,196
"62014",2020,0,118,118,236
"62015",2018,0,91,91,182
"62015",2019,0,98,271,369
"62015",2020,0,118,118,236
"62016",2018,0,91,91,182
"62016",2019,0,98,271,369
"62016",2020,0,118,118,236
"62017",2018,0,91,91,182
"62017",2019,0,98,98,196
"62017",2020,0,118,118,236
"62018",2018,0,91,91,182
"62018",2019,0,98,271,369
"62018",2020,0,118,118,236
"62019",2018,0,91,91,182
"62019",2019,0,98,98,196
"62019",2020,0,118,118,236
"62020",2018,0,91,91,182
"62020",2019,0,98,98,196
"62020",2020,0,118,118,236
"62021",2018,0,91,91,182
"62021",2019,0,98,271,369
"62021",2020,0,118,118,236
"62022",2018,0,91,91,182
"62022",2019,0,98,98,196
"62022",2020,0,118,118,236
"62023",2018,0,91,91,182
"62023",2019,0,98,98,196
"62023",2020,0,118,118,236
"62024",2018,0,91,91,182
"62024",2019,0,98,98,196
"62024",2020,0,118,118,236
"62025",2018,0,91,91,182
"62025",2019,0,98,98,196
"62025",2020,0,118,118,236
"62026",2018,0,91,91,182
"62026",2019,0,98,98,196
"62026",2020,0,118,118,236
"62027",2018,0,91,91,182
"62027",2019,0,98,271,369
"62027",2020,0,118,118,236
"62028",2018,0,91,91,182
"62028",2019,0,98,98,196
"62028",2020,0,118,118,236
"62029",2018,0,91,91,182
"62029",2019,0,98,98,196
"62029",2020,0,118,118,236
"62030",2018,0,91,91,182
"62030",2019,0,98,271,369
"62030",2020,0,118,118,236
"62031",2018,0,91,91,182
"62031",2019,0,98,98,196
"62031",2020,0,118,118,236
"62032",2018,0,91,91,182
"62032",2019,0,98,98,196
"62032",2020,0,118,118,236
"62033",2018,0,91,91,182
"62033",2019,0,98,98,196
"62033",2020,0,118,118,236
"62034",2018,0,91,91,182
"62034",2019,0,98,98,196
"62034",2020,0,118,118,236
"62035",2018,0,91,91,182
"62035",2019,0,98,98,196
"62035",2020,0,118,118,236
"62036",2018,0,91,91,182
"62036",2019,0,98,271,369
"62036",2020,0,118,118,236
"62037",2018,0,91,91,182
"62037",2019,0,98,98,196
"62037",2020,0,118,118,236
"62038",2018,0,91,91,182
"62038",2019,0,98,98,196
"62038",2020,0,118,118,236
"62039",2018,0,91,91,182
"62039",2019,0,98,98,196
"62039",2020,0,118,118,236
"62040",2018,0,91,91,182
"62040",2019,0,98,98,196
"62040",2020,0,118,118,236
"62041",2018,0,91,91,182
"62041",2019,0,98,98,196
"62041",2020,0,118,118,236
"62042",2018,0,91,91,182
"62042",2019,0,98,98,196
"62042",2020,0,118,118,236
"62043",2018,0,91,91,182
"62043",2019,0,98,98,196
"62043",2020,0,118,118,236
"62044",2018,0,91,91,182
"62044",2019,0,98,271,369
"62044",2020,0,118,118,236
"62045",2018,0,91,91,182
"62045",2019,0,98,98,196
"62045",2020,0,118,118,236
"62046",2018,0,91,91,182
"62046",2019,0,98,271,369
"62046",2020,0,118,118,236
"62047",2018,0,91,91,182
"62047",2019,0,98,271,369
"62047",2020,0,118,118,236
"62048",2018,0,91,91,182
"62048",2019,0,98,98,196
"62048",2020,0,118,118,236
"62049",2018,0,91,91,182
"62049",2019,0,98,98,196
"62049",2020,0,118,118,236
"62050",2018,0,91,91,182
"62050",2019,0,98,271,369
"62050",2020,0,118,118,236
"62051",2018,0,91,91,182
"62051",2019,0,98,98,196
"62051",2020,0,118,118,236
"62052",2018,0,91,91,182
"62052",2019,0,98,98,196
"62052",2020,0,118,118,236
"62053",2018,0,91,91,182
"62053",2019,0,98,98,196
"62053",2020,0,118,118,236
"62054",2018,0,91,91,182
"62054",2019,0,98,98,196
"62054",2020,0,118,118,236
"62055",2018,0,91,91,182
"62055",2019,0,98,98,196
"62055",2020,0,118,118,236
"62056",2018,0,91,91,182
"62056",2019,0,98,98,196
"62056",2020,0,118,118,236
"62057",2018,0,91,91,182
"62057",2019,0,98,98,196
"62057",2020,0,118,118,236
"62058",2018,0,91,91,182
"62058",2019,0,98,98,196
"62058",2020,0,118,118,236
"62059",2018,0,91,91,182
"62059",2019,0,98,98,196
"62059",2020,0,118,118,236
"62060",2018,0,91,91,182
"62060",2019,0,98,271,369
"62060",2020,0,118,118,236
"62061",2018,0,91,91,182
"62061",2019,0,98,271,369
"62061",2020,0,118,118,236
"62062",2018,0,91,91,182
"62062",2019,0,98,98,196
"62062",2020,0,118,118,236
"62063",2018,0,91,91,182
"62063",2019,0,98,98,196
"62063",2020,0,118,118,236
"62064",2018,0,91,91,182
"62064",2019,0,98,98,196
"62064",2020,0,118,118,236
"62065",2018,0,91,91,182
"62065",2019,0,98,98,196
"62065",2020,0,118,118,236
"62066",2018,0,91,91,182
"62066",2019,0,98,271,369
"62066",2020,0,118,118,236
"62067",2018,0,91,91,182
"62067",2019,0,98,98,196
"62067",2020,0,118,118,236
"62068",2018,0,91,91,182
"62068",2019,0,98,98,196
"62068",2020,0,118,118,236
"62069",2018,0,91,91,182
"62069",2019,0,98,98,196
"62069",2020,0,118,118,236
"62070",2018,0,91,91,182
"62070",2019,0,98,98,196
"62070",2020,0,118,118,236
"62071",2018,0,91,91,182
"62071",2019,0,98,98,196
"62071",2020,0,118,118,236
"62072",2018,0,91,91,182
"62072",2019,0,98,98,196
"62072",2020,0,118,118,236
"62073",2018,0,91,91,182
"62073",2019,0,98,98,196
"62073",2020,0,118,118,236
"62074",2018,0,91,91,182
"62074",2019,0,98,98,196
"62074",2020,0,118,118,236
"62075",2018,0,91,91,182
"62075",2019,0,98,98,196
"62075",2020,0,118,118,236
"62076",2018,0,91,91,182
"62076",2019,0,98,98,196
"62076",2020,0,118,118,236
"62077",2018,0,91,91,182
"62077",2019,0,98,98,196
"62077",2020,0,118,118,236
"62078",2018,0,91,91,182
"62078",2019,0,98,98,196
"62078",2020,0,118,118,236
"62079",2018,0,91,91,182
"62079",2019,0,98,98,196
"62079",2020,0,118,118,236
"62080",2018,0,91,91,182
"62080",2019,0,98,98,196
"62080",2020,0,118,118,236
"62081",2018,0,91,91,182
"62081",2019,0,98,98,196
"62081",2020,0,118,118,236
"62082",2018,0,91,91,182
"62082",2019,0,98,98,196
"62082",2020,0,118,118,236
"62083",2018,0,91,91,182
"62083",2019,0,98,98,196
"62083",2020,0,118,118,236
"62084",2018,0,91,91,182
"62084",2019,0,98,98,196
"62084",2020,0,118,118,236
"62085",2018,0,91,91,182
"62085",2019,0,98,98,196
"62085",2020,0,118,118,236
"62086",2018,0,91,91,182
"62086",2019,0,98,98,196
"62086",2020,0,118,118,236
"62087",2018,0,91,91,182
"62087",2019,0,98,98,196
"62087",2020,0,118,118,236
"62088",2018,0,91,91,182
"62088",2019,0,98,98,196
"62088",2020,0,118,118,236
"62089",2018,0,91,91,182
"62089",2019,0,98,98,196
"62089",2020,0,118,118,236
"62090",2018,0,91,91,182
"62090",2019,0,98,271,369
"62090",2020,0,118,118,236
"62091",2018,0,91,91,182
"62091",2019,0,98,271,369
"62091",2020,0,118,118,236
"62092",2018,0,91,91,182
"62092",2019,0,98,271,369
"62092",2020,0,118,118,236
"62093",2018,0,91,91,182
"62093",2019,0,98,98,196
"62093",2020,0,118,118,236
"62094",2018,0,91,91,182
"62094",2019,0,98,271,369
"62094",2020,0,118,118,236
"62095",2018,0,91,91,182
"62095",2019,0,98,98,196
"62095",2020,0,118,118,236
"62096",2018,0,91,91,182
"62096",2019,0,98,98,196
"62096",2020,0,118,118,236
"62097",2018,0,91,91,182
"62097",2019,0,98,98,196
"62097",2020,0,118,118,236
"62099",2018,0,91,91,182
"62099",2019,0,98,98,196
"62099",2020,0,118,118,236
"62100",2018,0,91,91,182
"62100",2019,0,98,271,369
"62100",2020,0,118,118,236
"62101",2018,0,91,91,182
"62101",2019,0,98,271,369
"62101",2020,0,118,118,236
"62102",2018,0,91,91,182
"62102",2019,0,98,98,196
"62102",2020,0,118,118,236
"62103",2018,0,91,91,182
"62103",2019,0,98,98,196
"62103",2020,0,118,118,236
"62104",2018,0,91,91,182
"62104",2019,0,98,98,196
"62104",2020,0,118,118,236
"62105",2018,0,91,91,182
"62105",2019,0,98,98,196
"62105",2020,0,118,118,236
"62106",2018,0,91,91,182
"62106",2019,0,98,98,196
"62106",2020,0,118,118,236
"62107",2018,0,91,91,182
"62107",2019,0,98,98,196
"62107",2020,0,118,118,236
"62108",2018,0,91,91,182
"62108",2019,0,98,271,369
"62108",2020,0,118,118,236
"62109",2018,0,91,91,182
"62109",2019,0,98,271,369
"62109",2020,0,118,118,236
"62111",2018,0,91,91,182
"62111",2019,0,98,271,369
"62111",2020,0,118,118,236
"62112",2018,0,91,91,182
"62112",2019,0,98,98,196
"62112",2020,0,118,118,236
"62113",2018,0,91,91,182
"62113",2019,0,98,98,196
"62113",2020,0,118,118,236
"62114",2018,0,91,91,182
"62114",2019,0,98,271,369
"62114",2020,0,118,118,236
"62115",2018,0,91,91,182
"62115",2019,0,98,98,196
"62115",2020,0,118,118,236
"62116",2018,0,91,91,182
"62116",2019,0,98,271,369
"62116",2020,0,118,118,236
"62117",2018,0,91,91,182
"62117",2019,0,98,98,196
"62117",2020,0,118,118,236
"62118",2018,0,91,91,182
"62118",2019,0,98,98,196
"62118",2020,0,118,118,236
"62119",2018,0,91,91,182
"62119",2019,0,98,98,196
"62119",2020,0,118,118,236
"62120",2018,0,91,91,182
"62120",2019,0,98,98,196
"62120",2020,0,118,118,236
"62121",2018,0,91,91,182
"62121",2019,0,98,98,196
"62121",2020,0,118,118,236
"62122",2018,0,91,91,182
"62122",2019,0,98,98,196
"62122",2020,0,118,118,236
"62123",2018,0,91,91,182
"62123",2019,0,98,271,369
"62123",2020,0,118,118,236
"62124",2018,0,91,91,182
"62124",2019,0,98,271,369
"62124",2020,0,118,118,236
"62125",2018,0,91,91,182
"62125",2019,0,98,98,196
"62125",2020,0,118,118,236
"62126",2018,0,91,91,182
"62126",2019,0,98,98,196
"62126",2020,0,118,118,236
"62127",2018,0,91,91,182
"62127",2019,0,98,98,196
"62127",2020,0,118,118,236
"62128",2018,0,91,91,182
"62128",2019,0,98,98,196
"62128",2020,0,118,118,236
"62129",2018,0,91,91,182
"62129",2019,0,98,98,196
"62129",2020,0,118,118,236
"62130",2018,0,91,91,182
"62130",2019,0,98,98,196
"62130",2020,0,118,118,236
"62131",2018,0,91,91,182
"62131",2019,0,98,98,196
"62131",2020,0,118,118,236
"62132",2018,0,91,91,182
"62132",2019,0,98,98,196
"62132",2020,0,118,118,236
"62133",2018,0,91,91,182
"62133",2019,0,98,98,196
"62133",2020,0,118,118,236
"62134",2018,0,91,91,182
"62134",2019,0,98,271,369
"62134",2020,0,118,118,236
"62135",2018,0,91,91,182
"62135",2019,0,98,98,196
"62135",2020,0,118,118,236
"62137",2018,0,91,91,182
"62137",2019,0,98,271,369
"62137",2020,0,118,118,236
"62138",2018,0,91,91,182
"62138",2019,0,98,271,369
"62138",2020,0,118,118,236
"62139",2018,0,91,91,182
"62139",2019,0,98,98,196
"62139",2020,0,118,118,236
"62140",2018,0,91,91,182
"62140",2019,0,98,98,196
"62140",2020,0,118,118,236
"62141",2018,0,91,91,182
"62141",2019,0,98,98,196
"62141",2020,0,118,118,236
"62142",2018,0,91,91,182
"62142",2019,0,98,271,369
"62142",2020,0,118,118,236
"62143",2018,0,91,91,182
"62143",2019,0,98,271,369
"62143",2020,0,118,118,236
"62144",2018,0,91,91,182
"62144",2019,0,98,98,196
"62144",2020,0,118,118,236
"62145",2018,0,91,91,182
"62145",2019,0,98,98,196
"62145",2020,0,118,118,236
"62146",2018,0,91,91,182
"62146",2019,0,98,98,196
"62146",2020,0,118,118,236
"62147",2018,0,91,91,182
"62147",2019,0,98,98,196
"62147",2020,0,118,118,236
"62148",2018,0,91,91,182
"62148",2019,0,98,98,196
"62148",2020,0,118,118,236
"62149",2018,0,91,91,182
"62149",2019,0,98,98,196
"62149",2020,0,118,118,236
"62150",2018,0,91,91,182
"62150",2019,0,98,271,369
"62150",2020,0,118,118,236
"62151",2018,0,91,91,182
"62151",2019,0,98,98,196
"62151",2020,0,118,118,236
"62152",2018,0,91,91,182
"62152",2019,0,98,98,196
"62152",2020,0,118,118,236
"62153",2018,0,91,91,182
"62153",2019,0,98,98,196
"62153",2020,0,118,118,236
"62154",2018,0,91,91,182
"62154",2019,0,98,271,369
"62154",2020,0,118,118,236
"62155",2018,0,91,91,182
"62155",2019,0,98,98,196
"62155",2020,0,118,118,236
"62156",2018,0,91,91,182
"62156",2019,0,98,98,196
"62156",2020,0,118,118,236
"62157",2018,0,91,91,182
"62157",2019,0,98,271,369
"62157",2020,0,118,118,236
"62158",2018,0,91,91,182
"62158",2019,0,98,271,369
"62158",2020,0,118,118,236
"62160",2018,0,91,91,182
"62160",2019,0,98,98,196
"62160",2020,0,118,118,236
"62161",2018,0,91,91,182
"62161",2019,0,98,98,196
"62161",2020,0,118,118,236
"62162",2018,0,91,91,182
"62162",2019,0,98,98,196
"62162",2020,0,118,118,236
"62163",2018,0,91,91,182
"62163",2019,0,98,271,369
"62163",2020,0,118,118,236
"62164",2018,0,91,91,182
"62164",2019,0,98,98,196
"62164",2020,0,118,118,236
"62165",2018,0,91,91,182
"62165",2019,0,98,98,196
"62165",2020,0,118,118,236
"62166",2018,0,91,91,182
"62166",2019,0,98,98,196
"62166",2020,0,118,118,236
"62167",2018,0,91,91,182
"62167",2019,0,98,98,196
"62167",2020,0,118,118,236
"62168",2018,0,91,91,182
"62168",2019,0,98,98,196
"62168",2020,0,118,118,236
"62169",2018,0,91,91,182
"62169",2019,0,98,98,196
"62169",2020,0,118,118,236
"62170",2018,0,91,91,182
"62170",2019,0,98,98,196
"62170",2020,0,118,118,236
"62171",2018,0,91,91,182
"62171",2019,0,98,98,196
"62171",2020,0,118,118,236
"62172",2018,0,91,91,182
"62172",2019,0,98,98,196
"62172",2020,0,118,118,236
"62173",2018,0,91,91,182
"62173",2019,0,98,98,196
"62173",2020,0,118,118,236
"62174",2018,0,91,91,182
"62174",2019,0,98,98,196
"62174",2020,0,118,118,236
"62175",2018,0,91,91,182
"62175",2019,0,98,271,369
"62175",2020,0,118,118,236
"62176",2018,0,91,91,182
"62176",2019,0,98,271,369
"62176",2020,0,118,118,236
"62177",2018,0,91,91,182
"62177",2019,0,98,271,369
"62177",2020,0,118,118,236
"62178",2018,0,91,91,182
"62178",2019,0,98,98,196
"62178",2020,0,118,118,236
"62179",2018,0,91,91,182
"62179",2019,0,98,98,196
"62179",2020,0,118,118,236
"62180",2018,0,91,91,182
"62180",2019,0,98,98,196
"62180",2020,0,118,118,236
"62181",2018,0,91,91,182
"62181",2019,0,98,98,196
"62181",2020,0,118,118,236
"62182",2018,0,91,91,182
"62182",2019,0,98,271,369
"62182",2020,0,118,118,236
"62183",2018,0,91,91,182
"62183",2019,0,98,271,369
"62183",2020,0,118,118,236
"62184",2018,0,91,91,182
"62184",2019,0,98,98,196
"62184",2020,0,118,118,236
"62185",2018,0,91,91,182
"62185",2019,0,98,98,196
"62185",2020,0,118,118,236
"62186",2018,0,91,91,182
"62186",2019,0,98,98,196
"62186",2020,0,118,118,236
"62187",2018,0,91,91,182
"62187",2019,0,98,271,369
"62187",2020,0,118,118,236
"62188",2018,0,91,91,182
"62188",2019,0,98,98,196
"62188",2020,0,118,118,236
"62189",2018,0,91,91,182
"62189",2019,0,98,98,196
"62189",2020,0,118,118,236
"62190",2018,0,91,91,182
"62190",2019,0,98,98,196
"62190",2020,0,118,118,236
"62191",2018,0,91,91,182
"62191",2019,0,98,98,196
"62191",2020,0,118,118,236
"62192",2018,0,91,91,182
"62192",2019,0,98,98,196
"62192",2020,0,118,118,236
"62193",2018,0,91,91,182
"62193",2019,0,98,98,196
"62193",2020,0,118,118,236
"62194",2018,0,91,91,182
"62194",2019,0,98,98,196
"62194",2020,0,118,118,236
"62195",2018,0,91,91,182
"62195",2019,0,98,98,196
"62195",2020,0,118,118,236
"62196",2018,0,91,91,182
"62196",2019,0,98,271,369
"62196",2020,0,118,118,236
"62197",2018,0,91,91,182
"62197",2019,0,98,98,196
"62197",2020,0,118,118,236
"62198",2018,0,91,91,182
"62198",2019,0,98,98,196
"62198",2020,0,118,118,236
"62199",2018,0,91,91,182
"62199",2019,0,98,98,196
"62199",2020,0,118,118,236
"62200",2018,0,91,91,182
"62200",2019,0,98,98,196
"62200",2020,0,118,118,236
"62201",2018,0,91,91,182
"62201",2019,0,98,98,196
"62201",2020,0,118,118,236
"62202",2018,0,91,91,182
"62202",2019,0,98,98,196
"62202",2020,0,118,118,236
"62203",2018,0,91,91,182
"62203",2019,0,98,98,196
"62203",2020,0,118,118,236
"62204",2018,0,91,91,182
"62204",2019,0,98,271,369
"62204",2020,0,118,118,236
"62205",2018,0,91,91,182
"62205",2019,0,98,98,196
"62205",2020,0,118,118,236
"62206",2018,0,91,91,182
"62206",2019,0,98,271,369
"62206",2020,0,118,118,236
"62207",2018,0,91,91,182
"62207",2019,0,98,271,369
"62207",2020,0,118,118,236
"62208",2018,0,91,91,182
"62208",2019,0,98,271,369
"62208",2020,0,118,118,236
"62209",2018,0,91,91,182
"62209",2019,0,98,98,196
"62209",2020,0,118,118,236
"62211",2018,0,91,91,182
"62211",2019,0,98,98,196
"62211",2020,0,118,118,236
"62212",2018,0,91,91,182
"62212",2019,0,98,271,369
"62212",2020,0,118,118,236
"62213",2018,0,91,91,182
"62213",2019,0,98,98,196
"62213",2020,0,118,118,236
"62214",2018,0,91,91,182
"62214",2019,0,98,98,196
"62214",2020,0,118,118,236
"62215",2018,0,91,91,182
"62215",2019,0,98,98,196
"62215",2020,0,118,118,236
"62216",2018,0,91,91,182
"62216",2019,0,98,98,196
"62216",2020,0,118,118,236
"62217",2018,0,91,91,182
"62217",2019,0,98,98,196
"62217",2020,0,118,118,236
"62218",2018,0,91,91,182
"62218",2019,0,98,98,196
"62218",2020,0,118,118,236
"62219",2018,0,91,91,182
"62219",2019,0,98,271,369
"62219",2020,0,118,118,236
"62220",2018,0,91,91,182
"62220",2019,0,98,271,369
"62220",2020,0,118,118,236
"62221",2018,0,91,91,182
"62221",2019,0,98,98,196
"62221",2020,0,118,118,236
"62222",2018,0,91,91,182
"62222",2019,0,98,271,369
"62222",2020,0,118,118,236
"62223",2018,0,91,91,182
"62223",2019,0,98,98,196
"62223",2020,0,118,118,236
"62224",2018,0,91,91,182
"62224",2019,0,98,98,196
"62224",2020,0,118,118,236
"62225",2018,0,91,91,182
"62225",2019,0,98,98,196
"62225",2020,0,118,118,236
"62227",2018,0,91,91,182
"62227",2019,0,98,271,369
"62227",2020,0,118,118,236
"62228",2018,0,91,91,182
"62228",2019,0,98,98,196
"62228",2020,0,118,118,236
"62229",2018,0,91,91,182
"62229",2019,0,98,98,196
"62229",2020,0,118,118,236
"62230",2018,0,91,91,182
"62230",2019,0,98,98,196
"62230",2020,0,118,118,236
"62231",2018,0,91,91,182
"62231",2019,0,98,271,369
"62231",2020,0,118,118,236
"62232",2018,0,91,91,182
"62232",2019,0,98,98,196
"62232",2020,0,118,118,236
"62233",2018,0,91,91,182
"62233",2019,0,98,271,369
"62233",2020,0,118,118,236
"62234",2018,0,91,91,182
"62234",2019,0,98,271,369
"62234",2020,0,118,118,236
"62235",2018,0,91,91,182
"62235",2019,0,98,98,196
"62235",2020,0,118,118,236
"62236",2018,0,91,91,182
"62236",2019,0,98,271,369
"62236",2020,0,118,118,236
"62237",2018,0,91,91,182
"62237",2019,0,98,98,196
"62237",2020,0,118,118,236
"62238",2018,0,91,91,182
"62238",2019,0,98,271,369
"62238",2020,0,118,118,236
"62239",2018,0,91,91,182
"62239",2019,0,98,98,196
"62239",2020,0,118,118,236
"62240",2018,0,91,91,182
"62240",2019,0,98,98,196
"62240",2020,0,118,118,236
"62241",2018,0,91,91,182
"62241",2019,0,98,271,369
"62241",2020,0,118,118,236
"62242",2018,0,91,91,182
"62242",2019,0,98,271,369
"62242",2020,0,118,118,236
"62243",2018,0,91,91,182
"62243",2019,0,98,271,369
"62243",2020,0,118,118,236
"62244",2018,0,91,91,182
"62244",2019,0,98,98,196
"62244",2020,0,118,118,236
"62245",2018,0,91,91,182
"62245",2019,0,98,98,196
"62245",2020,0,118,118,236
"62246",2018,0,91,91,182
"62246",2019,0,98,98,196
"62246",2020,0,118,118,236
"62247",2018,0,91,91,182
"62247",2019,0,98,98,196
"62247",2020,0,118,118,236
"62248",2018,0,91,91,182
"62248",2019,0,98,98,196
"62248",2020,0,118,118,236
"62249",2018,0,91,91,182
"62249",2019,0,98,98,196
"62249",2020,0,118,118,236
"62250",2018,0,91,91,182
"62250",2019,0,98,98,196
"62250",2020,0,118,118,236
"62251",2018,0,91,91,182
"62251",2019,0,98,98,196
"62251",2020,0,118,118,236
"62252",2018,0,91,91,182
"62252",2019,0,98,98,196
"62252",2020,0,118,118,236
"62253",2018,0,91,91,182
"62253",2019,0,98,271,369
"62253",2020,0,118,118,236
"62254",2018,0,91,91,182
"62254",2019,0,98,98,196
"62254",2020,0,118,118,236
"62255",2018,0,91,91,182
"62255",2019,0,98,98,196
"62255",2020,0,118,118,236
"62256",2018,0,91,91,182
"62256",2019,0,98,98,196
"62256",2020,0,118,118,236
"62257",2018,0,91,91,182
"62257",2019,0,98,98,196
"62257",2020,0,118,118,236
"62258",2018,0,91,91,182
"62258",2019,0,98,271,369
"62258",2020,0,118,118,236
"62259",2018,0,91,91,182
"62259",2019,0,98,98,196
"62259",2020,0,118,118,236
"62260",2018,0,91,91,182
"62260",2019,0,98,271,369
"62260",2020,0,118,118,236
"62261",2018,0,91,91,182
"62261",2019,0,98,271,369
"62261",2020,0,118,118,236
"62262",2018,0,91,91,182
"62262",2019,0,98,98,196
"62262",2020,0,118,118,236
"62263",2018,0,91,91,182
"62263",2019,0,98,98,196
"62263",2020,0,118,118,236
"62264",2018,0,91,91,182
"62264",2019,0,98,98,196
"62264",2020,0,118,118,236
"62265",2018,0,91,91,182
"62265",2019,0,98,98,196
"62265",2020,0,118,118,236
"62266",2018,0,91,91,182
"62266",2019,0,98,271,369
"62266",2020,0,118,118,236
"62267",2018,0,91,91,182
"62267",2019,0,98,98,196
"62267",2020,0,118,118,236
"62268",2018,0,91,91,182
"62268",2019,0,98,98,196
"62268",2020,0,118,118,236
"62269",2018,0,91,91,182
"62269",2019,0,98,98,196
"62269",2020,0,118,118,236
"62270",2018,0,91,91,182
"62270",2019,0,98,98,196
"62270",2020,0,118,118,236
"62271",2018,0,91,91,182
"62271",2019,0,98,98,196
"62271",2020,0,118,118,236
"62272",2018,0,91,91,182
"62272",2019,0,98,98,196
"62272",2020,0,118,118,236
"62273",2018,0,91,91,182
"62273",2019,0,98,98,196
"62273",2020,0,118,118,236
"62274",2018,0,91,91,182
"62274",2019,0,98,98,196
"62274",2020,0,118,118,236
"62275",2018,0,91,91,182
"62275",2019,0,98,271,369
"62275",2020,0,118,118,236
"62276",2018,0,91,91,182
"62276",2019,0,98,98,196
"62276",2020,0,118,118,236
"62277",2018,0,91,91,182
"62277",2019,0,98,98,196
"62277",2020,0,118,118,236
"62278",2018,0,91,91,182
"62278",2019,0,98,98,196
"62278",2020,0,118,118,236
"62279",2018,0,91,91,182
"62279",2019,0,98,98,196
"62279",2020,0,118,118,236
"62280",2018,0,91,91,182
"62280",2019,0,98,98,196
"62280",2020,0,118,118,236
"62281",2018,0,91,91,182
"62281",2019,0,98,98,196
"62281",2020,0,118,118,236
"62282",2018,0,91,91,182
"62282",2019,0,98,271,369
"62282",2020,0,118,118,236
"62283",2018,0,91,91,182
"62283",2019,0,98,271,369
"62283",2020,0,118,118,236
"62284",2018,0,91,91,182
"62284",2019,0,98,98,196
"62284",2020,0,118,118,236
"62285",2018,0,91,91,182
"62285",2019,0,98,98,196
"62285",2020,0,118,118,236
"62286",2018,0,91,91,182
"62286",2019,0,98,98,196
"62286",2020,0,118,118,236
"62288",2018,0,91,91,182
"62288",2019,0,98,98,196
"62288",2020,0,118,118,236
"62289",2018,0,91,91,182
"62289",2019,0,98,271,369
"62289",2020,0,118,118,236
"62290",2018,0,91,91,182
"62290",2019,0,98,98,196
"62290",2020,0,118,118,236
"62291",2018,0,91,91,182
"62291",2019,0,98,98,196
"62291",2020,0,118,118,236
"62292",2018,0,91,91,182
"62292",2019,0,98,98,196
"62292",2020,0,118,118,236
"62293",2018,0,91,91,182
"62293",2019,0,98,271,369
"62293",2020,0,118,118,236
"62295",2018,0,91,91,182
"62295",2019,0,98,98,196
"62295",2020,0,118,118,236
"62296",2018,0,91,91,182
"62296",2019,0,98,271,369
"62296",2020,0,118,118,236
"62297",2018,0,91,91,182
"62297",2019,0,98,98,196
"62297",2020,0,118,118,236
"62298",2018,0,91,91,182
"62298",2019,0,98,98,196
"62298",2020,0,118,118,236
"62299",2018,0,91,91,182
"62299",2019,0,98,271,369
"62299",2020,0,118,118,236
"62300",2018,0,91,91,182
"62300",2019,0,98,98,196
"62300",2020,0,118,118,236
"62301",2018,0,91,91,182
"62301",2019,0,98,98,196
"62301",2020,0,118,118,236
"62302",2018,0,91,91,182
"62302",2019,0,98,98,196
"62302",2020,0,118,118,236
"62303",2018,0,91,91,182
"62303",2019,0,98,271,369
"62303",2020,0,118,118,236
"62304",2018,0,91,91,182
"62304",2019,0,98,98,196
"62304",2020,0,118,118,236
"62306",2018,0,91,91,182
"62306",2019,0,98,98,196
"62306",2020,0,118,118,236
"62307",2018,0,91,91,182
"62307",2019,0,98,98,196
"62307",2020,0,118,118,236
"62308",2018,0,91,91,182
"62308",2019,0,98,98,196
"62308",2020,0,118,118,236
"62309",2018,0,91,91,182
"62309",2019,0,98,98,196
"62309",2020,0,118,118,236
"62310",2018,0,91,91,182
"62310",2019,0,98,98,196
"62310",2020,0,118,118,236
"62311",2018,0,91,91,182
"62311",2019,0,98,98,196
"62311",2020,0,118,118,236
"62312",2018,0,91,91,182
"62312",2019,0,98,271,369
"62312",2020,0,118,118,236
"62313",2018,0,91,91,182
"62313",2019,0,98,98,196
"62313",2020,0,118,118,236
"62314",2018,0,91,91,182
"62314",2019,0,98,98,196
"62314",2020,0,118,118,236
"62315",2018,0,91,91,182
"62315",2019,0,98,271,369
"62315",2020,0,118,118,236
"62316",2018,0,91,91,182
"62316",2019,0,98,271,369
"62316",2020,0,118,118,236
"62317",2018,0,91,91,182
"62317",2019,0,98,98,196
"62317",2020,0,118,118,236
"62318",2018,0,91,91,182
"62318",2019,0,98,271,369
"62318",2020,0,118,118,236
"62319",2018,0,91,91,182
"62319",2019,0,98,98,196
"62319",2020,0,118,118,236
"62320",2018,0,91,91,182
"62320",2019,0,98,98,196
"62320",2020,0,118,118,236
"62321",2018,0,91,91,182
"62321",2019,0,98,98,196
"62321",2020,0,118,118,236
"62322",2018,0,91,91,182
"62322",2019,0,98,271,369
"62322",2020,0,118,118,236
"62323",2018,0,91,91,182
"62323",2019,0,98,98,196
"62323",2020,0,118,118,236
"62324",2018,0,91,91,182
"62324",2019,0,98,98,196
"62324",2020,0,118,118,236
"62325",2018,0,91,91,182
"62325",2019,0,98,98,196
"62325",2020,0,118,118,236
"62326",2018,0,91,91,182
"62326",2019,0,98,98,196
"62326",2020,0,118,118,236
"62327",2018,0,91,91,182
"62327",2019,0,98,98,196
"62327",2020,0,118,118,236
"62328",2018,0,91,91,182
"62328",2019,0,98,98,196
"62328",2020,0,118,118,236
"62329",2018,0,91,91,182
"62329",2019,0,98,98,196
"62329",2020,0,118,118,236
"62330",2018,0,91,91,182
"62330",2019,0,98,98,196
"62330",2020,0,118,118,236
"62331",2018,0,91,91,182
"62331",2019,0,98,98,196
"62331",2020,0,118,118,236
"62332",2018,0,91,91,182
"62332",2019,0,98,98,196
"62332",2020,0,118,118,236
"62333",2018,0,91,91,182
"62333",2019,0,98,98,196
"62333",2020,0,118,118,236
"62334",2018,0,91,91,182
"62334",2019,0,98,98,196
"62334",2020,0,118,118,236
"62335",2018,0,91,91,182
"62335",2019,0,98,271,369
"62335",2020,0,118,118,236
"62336",2018,0,91,91,182
"62336",2019,0,98,98,196
"62336",2020,0,118,118,236
"62337",2018,0,91,91,182
"62337",2019,0,98,271,369
"62337",2020,0,118,118,236
"62338",2018,0,91,91,182
"62338",2019,0,98,98,196
"62338",2020,0,118,118,236
"62339",2018,0,91,91,182
"62339",2019,0,98,271,369
"62339",2020,0,118,118,236
"62340",2018,0,91,91,182
"62340",2019,0,98,98,196
"62340",2020,0,118,118,236
"62341",2018,0,91,91,182
"62341",2019,0,98,98,196
"62341",2020,0,118,118,236
"62342",2018,0,91,91,182
"62342",2019,0,98,98,196
"62342",2020,0,118,118,236
"62343",2018,0,91,91,182
"62343",2019,0,98,98,196
"62343",2020,0,118,118,236
"62344",2018,0,91,91,182
"62344",2019,0,98,98,196
"62344",2020,0,118,118,236
"62345",2018,0,91,91,182
"62345",2019,0,98,271,369
"62345",2020,0,118,118,236
"62346",2018,0,91,91,182
"62346",2019,0,98,271,369
"62346",2020,0,118,118,236
"62347",2018,0,91,91,182
"62347",2019,0,98,98,196
"62347",2020,0,118,118,236
"62348",2018,0,91,91,182
"62348",2019,0,98,271,369
"62348",2020,0,118,118,236
"62349",2018,0,91,91,182
"62349",2019,0,98,98,196
"62349",2020,0,118,118,236
"62350",2018,0,91,91,182
"62350",2019,0,98,98,196
"62350",2020,0,118,118,236
"62351",2018,0,91,91,182
"62351",2019,0,98,98,196
"62351",2020,0,118,118,236
"62352",2018,0,91,91,182
"62352",2019,0,98,271,369
"62352",2020,0,118,118,236
"62353",2018,0,91,91,182
"62353",2019,0,98,98,196
"62353",2020,0,118,118,236
"62354",2018,0,91,91,182
"62354",2019,0,98,98,196
"62354",2020,0,118,118,236
"62355",2018,0,91,91,182
"62355",2019,0,98,98,196
"62355",2020,0,118,118,236
"62356",2018,0,91,91,182
"62356",2019,0,98,98,196
"62356",2020,0,118,118,236
"62357",2018,0,91,91,182
"62357",2019,0,98,271,369
"62357",2020,0,118,118,236
"62358",2018,0,91,91,182
"62358",2019,0,98,98,196
"62358",2020,0,118,118,236
"62359",2018,0,91,91,182
"62359",2019,0,98,271,369
"62359",2020,0,118,118,236
"62360",2018,0,91,91,182
"62360",2019,0,98,98,196
"62360",2020,0,118,118,236
"62361",2018,0,91,91,182
"62361",2019,0,98,271,369
"62361",2020,0,118,118,236
"62362",2018,0,91,91,182
"62362",2019,0,98,98,196
"62362",2020,0,118,118,236
"62363",2018,0,91,91,182
"62363",2019,0,98,98,196
"62363",2020,0,118,118,236
"62364",2018,0,91,91,182
"62364",2019,0,98,98,196
"62364",2020,0,118,118,236
"62365",2018,0,91,91,182
"62365",2019,0,98,271,369
"62365",2020,0,118,118,236
"62366",2018,0,91,91,182
"62366",2019,0,98,98,196
"62366",2020,0,118,118,236
"62367",2018,0,91,91,182
"62367",2019,0,98,271,369
"62367",2020,0,118,118,236
"62368",2018,0,91,91,182
"62368",2019,0,98,98,196
"62368",2020,0,118,118,236
"62369",2018,0,91,91,182
"62369",2019,0,98,98,196
"62369",2020,0,118,118,236
"62370",2018,0,91,91,182
"62370",2019,0,98,271,369
"62370",2020,0,118,118,236
"62371",2018,0,91,91,182
"62371",2019,0,98,98,196
"62371",2020,0,118,118,236
"62372",2018,0,91,91,182
"62372",2019,0,98,271,369
"62372",2020,0,118,118,236
"62373",2018,0,91,91,182
"62373",2019,0,98,98,196
"62373",2020,0,118,118,236
"62374",2018,0,91,91,182
"62374",2019,0,98,98,196
"62374",2020,0,118,118,236
"62375",2018,0,91,91,182
"62375",2019,0,98,98,196
"62375",2020,0,118,118,236
"62376",2018,0,91,91,182
"62376",2019,0,98,98,196
"62376",2020,0,118,118,236
"62377",2018,0,91,91,182
"62377",2019,0,98,98,196
"62377",2020,0,118,118,236
"62378",2018,0,91,91,182
"62378",2019,0,98,98,196
"62378",2020,0,118,118,236
"62379",2018,0,91,91,182
"62379",2019,0,98,98,196
"62379",2020,0,118,118,236
"62380",2018,0,91,91,182
"62380",2019,0,98,98,196
"62380",2020,0,118,118,236
"62381",2018,0,91,91,182
"62381",2019,0,98,271,369
"62381",2020,0,118,118,236
"62382",2018,0,91,91,182
"62382",2019,0,98,271,369
"62382",2020,0,118,118,236
"62383",2018,0,91,91,182
"62383",2019,0,98,98,196
"62383",2020,0,118,118,236
"62384",2018,0,91,91,182
"62384",2019,0,98,98,196
"62384",2020,0,118,118,236
"62385",2018,0,91,91,182
"62385",2019,0,98,271,369
"62385",2020,0,118,118,236
"62386",2018,0,91,91,182
"62386",2019,0,98,98,196
"62386",2020,0,118,118,236
"62387",2018,0,91,91,182
"62387",2019,0,98,98,196
"62387",2020,0,118,118,236
"62388",2018,0,91,91,182
"62388",2019,0,98,271,369
"62388",2020,0,118,118,236
"62389",2018,0,91,91,182
"62389",2019,0,98,271,369
"62389",2020,0,118,118,236
"62390",2018,0,91,91,182
"62390",2019,0,98,271,369
"62390",2020,0,118,118,236
"62391",2018,0,91,91,182
"62391",2019,0,98,98,196
"62391",2020,0,118,118,236
"62392",2018,0,91,91,182
"62392",2019,0,98,98,196
"62392",2020,0,118,118,236
"62393",2018,0,91,91,182
"62393",2019,0,98,98,196
"62393",2020,0,118,118,236
"62395",2018,0,91,91,182
"62395",2019,0,98,271,369
"62395",2020,0,118,118,236
"62396",2018,0,91,91,182
"62396",2019,0,98,271,369
"62396",2020,0,118,118,236
"62397",2018,0,91,91,182
"62397",2019,0,98,98,196
"62397",2020,0,118,118,236
"62398",2018,0,91,91,182
"62398",2019,0,98,271,369
"62398",2020,0,118,118,236
"62399",2018,0,91,91,182
"62399",2019,0,98,98,196
"62399",2020,0,118,118,236
"62400",2018,0,91,91,182
"62400",2019,0,98,98,196
"62400",2020,0,118,118,236
"62401",2018,0,91,91,182
"62401",2019,0,98,98,196
"62401",2020,0,118,118,236
"62402",2018,0,91,91,182
"62402",2019,0,98,98,196
"62402",2020,0,118,118,236
"62403",2018,0,91,91,182
"62403",2019,0,98,98,196
"62403",2020,0,118,118,236
"62404",2018,0,91,91,182
"62404",2019,0,98,271,369
"62404",2020,0,118,118,236
"62405",2018,0,91,91,182
"62405",2019,0,98,98,196
"62405",2020,0,118,118,236
"62406",2018,0,91,91,182
"62406",2019,0,98,98,196
"62406",2020,0,118,118,236
"62407",2018,0,91,91,182
"62407",2019,0,98,98,196
"62407",2020,0,118,118,236
"62408",2018,0,91,91,182
"62408",2019,0,98,98,196
"62408",2020,0,118,118,236
"62409",2018,0,91,91,182
"62409",2019,0,98,98,196
"62409",2020,0,118,118,236
"62410",2018,0,91,91,182
"62410",2019,0,98,98,196
"62410",2020,0,118,118,236
"62411",2018,0,91,91,182
"62411",2019,0,98,271,369
"62411",2020,0,118,118,236
"62412",2018,0,91,91,182
"62412",2019,0,98,98,196
"62412",2020,0,118,118,236
"62413",2018,0,91,91,182
"62413",2019,0,98,98,196
"62413",2020,0,118,118,236
"62414",2018,0,91,91,182
"62414",2019,0,98,98,196
"62414",2020,0,118,118,236
"62415",2018,0,91,91,182
"62415",2019,0,98,98,196
"62415",2020,0,118,118,236
"62416",2018,0,91,91,182
"62416",2019,0,98,271,369
"62416",2020,0,118,118,236
"62418",2018,0,91,91,182
"62418",2019,0,98,98,196
"62418",2020,0,118,118,236
"62419",2018,0,91,91,182
"62419",2019,0,98,98,196
"62419",2020,0,118,118,236
"62421",2018,0,91,91,182
"62421",2019,0,98,98,196
"62421",2020,0,118,118,236
"62422",2018,0,91,91,182
"62422",2019,0,98,98,196
"62422",2020,0,118,118,236
"62423",2018,0,91,91,182
"62423",2019,0,98,98,196
"62423",2020,0,118,118,236
"62424",2018,0,91,91,182
"62424",2019,0,98,98,196
"62424",2020,0,118,118,236
"62425",2018,0,91,91,182
"62425",2019,0,98,98,196
"62425",2020,0,118,118,236
"62426",2018,0,91,91,182
"62426",2019,0,98,98,196
"62426",2020,0,118,118,236
"62427",2018,0,91,91,182
"62427",2019,0,98,98,196
"62427",2020,0,118,118,236
"62428",2018,0,91,91,182
"62428",2019,0,98,98,196
"62428",2020,0,118,118,236
"62429",2018,0,91,91,182
"62429",2019,0,98,98,196
"62429",2020,0,118,118,236
"62430",2018,0,91,91,182
"62430",2019,0,98,271,369
"62430",2020,0,118,118,236
"62432",2018,0,91,91,182
"62432",2019,0,98,98,196
"62432",2020,0,118,118,236
"62433",2018,0,91,91,182
"62433",2019,0,98,271,369
"62433",2020,0,118,118,236
"62434",2018,0,91,91,182
"62434",2019,0,98,98,196
"62434",2020,0,118,118,236
"62435",2018,0,91,91,182
"62435",2019,0,98,271,369
"62435",2020,0,118,118,236
"62436",2018,0,91,91,182
"62436",2019,0,98,271,369
"62436",2020,0,118,118,236
"62437",2018,0,91,91,182
"62437",2019,0,98,98,196
"62437",2020,0,118,118,236
"62438",2018,0,91,91,182
"62438",2019,0,98,98,196
"62438",2020,0,118,118,236
"62439",2018,0,91,91,182
"62439",2019,0,98,98,196
"62439",2020,0,118,118,236
"62440",2018,0,91,91,182
"62440",2019,0,98,98,196
"62440",2020,0,118,118,236
"62441",2018,0,91,91,182
"62441",2019,0,98,98,196
"62441",2020,0,118,118,236
"62442",2018,0,91,91,182
"62442",2019,0,98,271,369
"62442",2020,0,118,118,236
"62443",2018,0,91,91,182
"62443",2019,0,98,98,196
"62443",2020,0,118,118,236
"62444",2018,0,91,91,182
"62444",2019,0,98,98,196
"62444",2020,0,118,118,236
"62445",2018,0,91,91,182
"62445",2019,0,98,98,196
"62445",2020,0,118,118,236
"62446",2018,0,91,91,182
"62446",2019,0,98,98,196
"62446",2020,0,118,118,236
"62447",2018,0,91,91,182
"62447",2019,0,98,271,369
"62447",2020,0,118,118,236
"62448",2018,0,91,91,182
"62448",2019,0,98,98,196
"62448",2020,0,118,118,236
"62449",2018,0,91,91,182
"62449",2019,0,98,271,369
"62449",2020,0,118,118,236
"62450",2018,0,91,91,182
"62450",2019,0,98,98,196
"62450",2020,0,118,118,236
"62451",2018,0,91,91,182
"62451",2019,0,98,98,196
"62451",2020,0,118,118,236
"62452",2018,0,91,91,182
"62452",2019,0,98,98,196
"62452",2020,0,118,118,236
"62453",2018,0,91,91,182
"62453",2019,0,98,98,196
"62453",2020,0,118,118,236
"62454",2018,0,91,91,182
"62454",2019,0,98,98,196
"62454",2020,0,118,118,236
"62455",2018,0,91,91,182
"62455",2019,0,98,98,196
"62455",2020,0,118,118,236
"62456",2018,0,91,91,182
"62456",2019,0,98,98,196
"62456",2020,0,118,118,236
"62457",2018,0,91,91,182
"62457",2019,0,98,98,196
"62457",2020,0,118,118,236
"62458",2018,0,91,91,182
"62458",2019,0,98,98,196
"62458",2020,0,118,118,236
"62459",2018,0,91,91,182
"62459",2019,0,98,271,369
"62459",2020,0,118,118,236
"62460",2018,0,91,91,182
"62460",2019,0,98,98,196
"62460",2020,0,118,118,236
"62461",2018,0,91,91,182
"62461",2019,0,98,271,369
"62461",2020,0,118,118,236
"62462",2018,0,91,91,182
"62462",2019,0,98,98,196
"62462",2020,0,118,118,236
"62463",2018,0,91,91,182
"62463",2019,0,98,98,196
"62463",2020,0,118,118,236
"62464",2018,0,91,91,182
"62464",2019,0,98,98,196
"62464",2020,0,118,118,236
"62465",2018,0,91,91,182
"62465",2019,0,98,98,196
"62465",2020,0,118,118,236
"62466",2018,0,91,91,182
"62466",2019,0,98,271,369
"62466",2020,0,118,118,236
"62467",2018,0,91,91,182
"62467",2019,0,98,271,369
"62467",2020,0,118,118,236
"62468",2018,0,91,91,182
"62468",2019,0,98,271,369
"62468",2020,0,118,118,236
"62469",2018,0,91,91,182
"62469",2019,0,98,98,196
"62469",2020,0,118,118,236
"62470",2018,0,91,91,182
"62470",2019,0,98,271,369
"62470",2020,0,118,118,236
"62471",2018,0,91,91,182
"62471",2019,0,98,98,196
"62471",2020,0,118,118,236
"62472",2018,0,91,91,182
"62472",2019,0,98,271,369
"62472",2020,0,118,118,236
"62473",2018,0,91,91,182
"62473",2019,0,98,98,196
"62473",2020,0,118,118,236
"62474",2018,0,91,91,182
"62474",2019,0,98,98,196
"62474",2020,0,118,118,236
"62475",2018,0,91,91,182
"62475",2019,0,98,271,369
"62475",2020,0,118,118,236
"62476",2018,0,91,91,182
"62476",2019,0,98,98,196
"62476",2020,0,118,118,236
"62477",2018,0,91,91,182
"62477",2019,0,98,98,196
"62477",2020,0,118,118,236
"62478",2018,0,91,91,182
"62478",2019,0,98,98,196
"62478",2020,0,118,118,236
"62479",2018,0,91,91,182
"62479",2019,0,98,98,196
"62479",2020,0,118,118,236
"62480",2018,0,91,91,182
"62480",2019,0,98,98,196
"62480",2020,0,118,118,236
"62481",2018,0,91,91,182
"62481",2019,0,98,271,369
"62481",2020,0,118,118,236
"62483",2018,0,91,91,182
"62483",2019,0,98,98,196
"62483",2020,0,118,118,236
"62484",2018,0,91,91,182
"62484",2019,0,98,98,196
"62484",2020,0,118,118,236
"62485",2018,0,91,91,182
"62485",2019,0,98,98,196
"62485",2020,0,118,118,236
"62486",2018,0,91,91,182
"62486",2019,0,98,98,196
"62486",2020,0,118,118,236
"62487",2018,0,91,91,182
"62487",2019,0,98,98,196
"62487",2020,0,118,118,236
"62488",2018,0,91,91,182
"62488",2019,0,98,98,196
"62488",2020,0,118,118,236
"62489",2018,0,91,91,182
"62489",2019,0,98,98,196
"62489",2020,0,118,118,236
"62490",2018,0,91,91,182
"62490",2019,0,98,98,196
"62490",2020,0,118,118,236
"62491",2018,0,91,91,182
"62491",2019,0,98,98,196
"62491",2020,0,118,118,236
"62492",2018,0,91,91,182
"62492",2019,0,98,271,369
"62492",2020,0,118,118,236
"62493",2018,0,91,91,182
"62493",2019,0,98,98,196
"62493",2020,0,118,118,236
"62494",2018,0,91,91,182
"62494",2019,0,98,98,196
"62494",2020,0,118,118,236
"62495",2018,0,91,91,182
"62495",2019,0,98,98,196
"62495",2020,0,118,118,236
"62496",2018,0,91,91,182
"62496",2019,0,98,98,196
"62496",2020,0,118,118,236
"62497",2018,0,91,91,182
"62497",2019,0,98,98,196
"62497",2020,0,118,118,236
"62498",2018,0,91,91,182
"62498",2019,0,98,98,196
"62498",2020,0,118,118,236
"62499",2018,0,91,91,182
"62499",2019,0,98,271,369
"62499",2020,0,118,118,236
"62500",2018,0,91,91,182
"62500",2019,0,98,98,196
"62500",2020,0,118,118,236
"62501",2018,0,91,91,182
"62501",2019,0,98,271,369
"62501",2020,0,118,118,236
"62502",2018,0,91,91,182
"62502",2019,0,98,98,196
"62502",2020,0,118,118,236
"62503",2018,0,91,91,182
"62503",2019,0,98,98,196
"62503",2020,0,118,118,236
"62504",2018,0,91,91,182
"62504",2019,0,98,98,196
"62504",2020,0,118,118,236
"62505",2018,0,91,91,182
"62505",2019,0,98,98,196
"62505",2020,0,118,118,236
"62506",2018,0,91,91,182
"62506",2019,0,98,98,196
"62506",2020,0,118,118,236
"62507",2018,0,91,91,182
"62507",2019,0,98,271,369
"62507",2020,0,118,118,236
"62508",2018,0,91,91,182
"62508",2019,0,98,98,196
"62508",2020,0,118,118,236
"62509",2018,0,91,91,182
"62509",2019,0,98,98,196
"62509",2020,0,118,118,236
"62510",2018,0,91,91,182
"62510",2019,0,98,98,196
"62510",2020,0,118,118,236
"62511",2018,0,91,91,182
"62511",2019,0,98,271,369
"62511",2020,0,118,118,236
"62512",2018,0,91,91,182
"62512",2019,0,98,98,196
"62512",2020,0,118,118,236
"62513",2018,0,91,91,182
"62513",2019,0,98,271,369
"62513",2020,0,118,118,236
"62514",2018,0,91,91,182
"62514",2019,0,98,271,369
"62514",2020,0,118,118,236
"62515",2018,0,91,91,182
"62515",2019,0,98,98,196
"62515",2020,0,118,118,236
"62516",2018,0,91,91,182
"62516",2019,0,98,98,196
"62516",2020,0,118,118,236
"62517",2018,0,91,91,182
"62517",2019,0,98,98,196
"62517",2020,0,118,118,236
"62518",2018,0,91,91,182
"62518",2019,0,98,271,369
"62518",2020,0,118,118,236
"62519",2018,0,91,91,182
"62519",2019,0,98,98,196
"62519",2020,0,118,118,236
"62520",2018,0,91,91,182
"62520",2019,0,98,98,196
"62520",2020,0,118,118,236
"62521",2018,0,91,91,182
"62521",2019,0,98,271,369
"62521",2020,0,118,118,236
"62522",2018,0,91,91,182
"62522",2019,0,98,271,369
"62522",2020,0,118,118,236
"62523",2018,0,91,91,182
"62523",2019,0,98,98,196
"62523",2020,0,118,118,236
"62524",2018,0,91,91,182
"62524",2019,0,98,98,196
"62524",2020,0,118,118,236
"62525",2018,0,91,91,182
"62525",2019,0,98,98,196
"62525",2020,0,118,118,236
"62526",2018,0,91,91,182
"62526",2019,0,98,98,196
"62526",2020,0,118,118,236
"62527",2018,0,91,91,182
"62527",2019,0,98,271,369
"62527",2020,0,118,118,236
"62528",2018,0,91,91,182
"62528",2019,0,98,98,196
"62528",2020,0,118,118,236
"62529",2018,0,91,91,182
"62529",2019,0,98,98,196
"62529",2020,0,118,118,236
"62530",2018,0,91,91,182
"62530",2019,0,98,98,196
"62530",2020,0,118,118,236
"62531",2018,0,91,91,182
"62531",2019,0,98,98,196
"62531",2020,0,118,118,236
"62532",2018,0,91,91,182
"62532",2019,0,98,98,196
"62532",2020,0,118,118,236
"62533",2018,0,91,91,182
"62533",2019,0,98,98,196
"62533",2020,0,118,118,236
"62534",2018,0,91,91,182
"62534",2019,0,98,98,196
"62534",2020,0,118,118,236
"62535",2018,0,91,91,182
"62535",2019,0,98,271,369
"62535",2020,0,118,118,236
"62536",2018,0,91,91,182
"62536",2019,0,98,98,196
"62536",2020,0,118,118,236
"62537",2018,0,91,91,182
"62537",2019,0,98,271,369
"62537",2020,0,118,118,236
"62538",2018,0,91,91,182
"62538",2019,0,98,271,369
"62538",2020,0,118,118,236
"62539",2018,0,91,91,182
"62539",2019,0,98,271,369
"62539",2020,0,118,118,236
"62540",2018,0,91,91,182
"62540",2019,0,98,98,196
"62540",2020,0,118,118,236
"62541",2018,0,91,91,182
"62541",2019,0,98,271,369
"62541",2020,0,118,118,236
"62542",2018,0,91,91,182
"62542",2019,0,98,271,369
"62542",2020,0,118,118,236
"62543",2018,0,91,91,182
"62543",2019,0,98,98,196
"62543",2020,0,118,118,236
"62544",2018,0,91,91,182
"62544",2019,0,98,271,369
"62544",2020,0,118,118,236
"62545",2018,0,91,91,182
"62545",2019,0,98,98,196
"62545",2020,0,118,118,236
"62546",2018,0,91,91,182
"62546",2019,0,98,98,196
"62546",2020,0,118,118,236
"62547",2018,0,91,91,182
"62547",2019,0,98,271,369
"62547",2020,0,118,118,236
"62548",2018,0,91,91,182
"62548",2019,0,98,98,196
"62548",2020,0,118,118,236
"62549",2018,0,91,91,182
"62549",2019,0,98,271,369
"62549",2020,0,118,118,236
"62550",2018,0,91,91,182
"62550",2019,0,98,271,369
"62550",2020,0,118,118,236
"62551",2018,0,91,91,182
"62551",2019,0,98,271,369
"62551",2020,0,118,118,236
"62552",2018,0,91,91,182
"62552",2019,0,98,271,369
"62552",2020,0,118,118,236
"62553",2018,0,91,91,182
"62553",2019,0,98,98,196
"62553",2020,0,118,118,236
"62554",2018,0,91,91,182
"62554",2019,0,98,271,369
"62554",2020,0,118,118,236
"62555",2018,0,91,91,182
"62555",2019,0,98,98,196
"62555",2020,0,118,118,236
"62556",2018,0,91,91,182
"62556",2019,0,98,271,369
"62556",2020,0,118,118,236
"62557",2018,0,91,91,182
"62557",2019,0,98,98,196
"62557",2020,0,118,118,236
"62558",2018,0,91,91,182
"62558",2019,0,98,98,196
"62558",2020,0,118,118,236
"62559",2018,0,91,91,182
"62559",2019,0,98,98,196
"62559",2020,0,118,118,236
"62560",2018,0,91,91,182
"62560",2019,0,98,98,196
"62560",2020,0,118,118,236
"62561",2018,0,91,91,182
"62561",2019,0,98,98,196
"62561",2020,0,118,118,236
"62562",2018,0,91,91,182
"62562",2019,0,98,98,196
"62562",2020,0,118,118,236
"62563",2018,0,91,91,182
"62563",2019,0,98,98,196
"62563",2020,0,118,118,236
"62564",2018,0,91,91,182
"62564",2019,0,98,98,196
"62564",2020,0,118,118,236
"62565",2018,0,91,91,182
"62565",2019,0,98,98,196
"62565",2020,0,118,118,236
"62566",2018,0,91,91,182
"62566",2019,0,98,98,196
"62566",2020,0,118,118,236
"62567",2018,0,91,91,182
"62567",2019,0,98,98,196
"62567",2020,0,118,118,236
"62568",2018,0,91,91,182
"62568",2019,0,98,98,196
"62568",2020,0,118,118,236
"62569",2018,0,91,91,182
"62569",2019,0,98,98,196
"62569",2020,0,118,118,236
"62570",2018,0,91,91,182
"62570",2019,0,98,98,196
"62570",2020,0,118,118,236
"62571",2018,0,91,91,182
"62571",2019,0,98,271,369
"62571",2020,0,118,118,236
"62572",2018,0,91,91,182
"62572",2019,0,98,98,196
"62572",2020,0,118,118,236
"62573",2018,0,91,91,182
"62573",2019,0,98,98,196
"62573",2020,0,118,118,236
"62574",2018,0,91,91,182
"62574",2019,0,98,98,196
"62574",2020,0,118,118,236
"62576",2018,0,91,91,182
"62576",2019,0,98,271,369
"62576",2020,0,118,118,236
"62577",2018,0,91,91,182
"62577",2019,0,98,271,369
"62577",2020,0,118,118,236
"62578",2018,0,91,91,182
"62578",2019,0,98,98,196
"62578",2020,0,118,118,236
"62579",2018,0,91,91,182
"62579",2019,0,98,98,196
"62579",2020,0,118,118,236
"62580",2018,0,91,91,182
"62580",2019,0,98,98,196
"62580",2020,0,118,118,236
"62581",2018,0,91,91,182
"62581",2019,0,98,271,369
"62581",2020,0,118,118,236
"62582",2018,0,91,91,182
"62582",2019,0,98,98,196
"62582",2020,0,118,118,236
"62583",2018,0,91,91,182
"62583",2019,0,98,271,369
"62583",2020,0,118,118,236
"62584",2018,0,91,91,182
"62584",2019,0,98,98,196
"62584",2020,0,118,118,236
"62585",2018,0,91,91,182
"62585",2019,0,98,271,369
"62585",2020,0,118,118,236
"62586",2018,0,91,91,182
"62586",2019,0,98,98,196
"62586",2020,0,118,118,236
"62587",2018,0,91,91,182
"62587",2019,0,98,98,196
"62587",2020,0,118,118,236
"62588",2018,0,91,91,182
"62588",2019,0,98,271,369
"62588",2020,0,118,118,236
"62589",2018,0,91,91,182
"62589",2019,0,98,98,196
"62589",2020,0,118,118,236
"62590",2018,0,91,91,182
"62590",2019,0,98,271,369
"62590",2020,0,118,118,236
"62591",2018,0,91,91,182
"62591",2019,0,98,98,196
"62591",2020,0,118,118,236
"62592",2018,0,91,91,182
"62592",2019,0,98,98,196
"62592",2020,0,118,118,236
"62593",2018,0,91,91,182
"62593",2019,0,98,98,196
"62593",2020,0,118,118,236
"62594",2018,0,91,91,182
"62594",2019,0,98,98,196
"62594",2020,0,118,118,236
"62595",2018,0,91,91,182
"62595",2019,0,98,98,196
"62595",2020,0,118,118,236
"62596",2018,0,91,91,182
"62596",2019,0,98,271,369
"62596",2020,0,118,118,236
"62597",2018,0,91,91,182
"62597",2019,0,98,98,196
"62597",2020,0,118,118,236
"62598",2018,0,91,91,182
"62598",2019,0,98,98,196
"62598",2020,0,118,118,236
"62599",2018,0,91,91,182
"62599",2019,0,98,98,196
"62599",2020,0,118,118,236
"62600",2018,0,91,91,182
"62600",2019,0,98,98,196
"62600",2020,0,118,118,236
"62601",2018,0,91,91,182
"62601",2019,0,98,98,196
"62601",2020,0,118,118,236
"62602",2018,0,91,91,182
"62602",2019,0,98,271,369
"62602",2020,0,118,118,236
"62603",2018,0,91,91,182
"62603",2019,0,98,98,196
"62603",2020,0,118,118,236
"62604",2018,0,91,91,182
"62604",2019,0,98,98,196
"62604",2020,0,118,118,236
"62605",2018,0,91,91,182
"62605",2019,0,98,271,369
"62605",2020,0,118,118,236
"62606",2018,0,91,91,182
"62606",2019,0,98,98,196
"62606",2020,0,118,118,236
"62607",2018,0,91,91,182
"62607",2019,0,98,271,369
"62607",2020,0,118,118,236
"62608",2018,0,91,91,182
"62608",2019,0,98,98,196
"62608",2020,0,118,118,236
"62609",2018,0,91,91,182
"62609",2019,0,98,98,196
"62609",2020,0,118,118,236
"62610",2018,0,91,91,182
"62610",2019,0,98,271,369
"62610",2020,0,118,118,236
"62611",2018,0,91,91,182
"62611",2019,0,98,98,196
"62611",2020,0,118,118,236
"62612",2018,0,91,91,182
"62612",2019,0,98,98,196
"62612",2020,0,118,118,236
"62613",2018,0,91,91,182
"62613",2019,0,98,98,196
"62613",2020,0,118,118,236
"62614",2018,0,91,91,182
"62614",2019,0,98,98,196
"62614",2020,0,118,118,236
"62615",2018,0,91,91,182
"62615",2019,0,98,98,196
"62615",2020,0,118,118,236
"62616",2018,0,91,91,182
"62616",2019,0,98,271,369
"62616",2020,0,118,118,236
"62617",2018,0,91,91,182
"62617",2019,0,98,98,196
"62617",2020,0,118,118,236
"62618",2018,0,91,91,182
"62618",2019,0,98,98,196
"62618",2020,0,118,118,236
"62619",2018,0,91,91,182
"62619",2019,0,98,98,196
"62619",2020,0,118,118,236
"62620",2018,0,91,91,182
"62620",2019,0,98,98,196
"62620",2020,0,118,118,236
"62621",2018,0,91,91,182
"62621",2019,0,98,98,196
"62621",2020,0,118,118,236
"62622",2018,0,91,91,182
"62622",2019,0,98,98,196
"62622",2020,0,118,118,236
"62623",2018,0,91,91,182
"62623",2019,0,98,98,196
"62623",2020,0,118,118,236
"62624",2018,0,91,91,182
"62624",2019,0,98,98,196
"62624",2020,0,118,118,236
"62625",2018,0,91,91,182
"62625",2019,0,98,271,369
"62625",2020,0,118,118,236
"62626",2018,0,91,91,182
"62626",2019,0,98,98,196
"62626",2020,0,118,118,236
"62627",2018,0,91,91,182
"62627",2019,0,98,98,196
"62627",2020,0,118,118,236
"62628",2018,0,91,91,182
"62628",2019,0,98,98,196
"62628",2020,0,118,118,236
"62629",2018,0,91,91,182
"62629",2019,0,98,98,196
"62629",2020,0,118,118,236
"62630",2018,0,91,91,182
"62630",2019,0,98,98,196
"62630",2020,0,118,118,236
"62631",2018,0,91,91,182
"62631",2019,0,98,271,369
"62631",2020,0,118,118,236
"62632",2018,0,91,91,182
"62632",2019,0,98,98,196
"62632",2020,0,118,118,236
"62633",2018,0,91,91,182
"62633",2019,0,98,271,369
"62633",2020,0,118,118,236
"62634",2018,0,91,91,182
"62634",2019,0,98,98,196
"62634",2020,0,118,118,236
"62635",2018,0,91,91,182
"62635",2019,0,98,271,369
"62635",2020,0,118,118,236
"62636",2018,0,91,91,182
"62636",2019,0,98,98,196
"62636",2020,0,118,118,236
"62637",2018,0,91,91,182
"62637",2019,0,98,98,196
"62637",2020,0,118,118,236
"62638",2018,0,91,91,182
"62638",2019,0,98,98,196
"62638",2020,0,118,118,236
"62639",2018,0,91,91,182
"62639",2019,0,98,98,196
"62639",2020,0,118,118,236
"62640",2018,0,91,91,182
"62640",2019,0,98,271,369
"62640",2020,0,118,118,236
"62641",2018,0,91,91,182
"62641",2019,0,98,98,196
"62641",2020,0,118,118,236
"62642",2018,0,91,91,182
"62642",2019,0,98,98,196
"62642",2020,0,118,118,236
"62643",2018,0,91,91,182
"62643",2019,0,98,98,196
"62643",2020,0,118,118,236
"62644",2018,0,91,91,182
"62644",2019,0,98,98,196
"62644",2020,0,118,118,236
"62645",2018,0,91,91,182
"62645",2019,0,98,98,196
"62645",2020,0,118,118,236
"62646",2018,0,91,91,182
"62646",2019,0,98,98,196
"62646",2020,0,118,118,236
"62647",2018,0,91,91,182
"62647",2019,0,98,271,369
"62647",2020,0,118,118,236
"62648",2018,0,91,91,182
"62648",2019,0,98,271,369
"62648",2020,0,118,118,236
"62649",2018,0,91,91,182
"62649",2019,0,98,271,369
"62649",2020,0,118,118,236
"62650",2018,0,91,91,182
"62650",2019,0,98,98,196
"62650",2020,0,118,118,236
"62651",2018,0,91,91,182
"62651",2019,0,98,98,196
"62651",2020,0,118,118,236
"62652",2018,0,91,91,182
"62652",2019,0,98,98,196
"62652",2020,0,118,118,236
"62653",2018,0,91,91,182
"62653",2019,0,98,98,196
"62653",2020,0,118,118,236
"62654",2018,0,91,91,182
"62654",2019,0,98,98,196
"62654",2020,0,118,118,236
"62655",2018,0,91,91,182
"62655",2019,0,98,271,369
"62655",2020,0,118,118,236
"62656",2018,0,91,91,182
"62656",2019,0,98,98,196
"62656",2020,0,118,118,236
"62657",2018,0,91,91,182
"62657",2019,0,98,98,196
"62657",2020,0,118,118,236
"62658",2018,0,91,91,182
"62658",2019,0,98,98,196
"62658",2020,0,118,118,236
"62659",2018,0,91,91,182
"62659",2019,0,98,271,369
"62659",2020,0,118,118,236
"62660",2018,0,91,91,182
"62660",2019,0,98,98,196
"62660",2020,0,118,118,236
"62661",2018,0,91,91,182
"62661",2019,0,98,271,369
"62661",2020,0,118,118,236
"62662",2018,0,91,91,182
"62662",2019,0,98,98,196
"62662",2020,0,118,118,236
"62663",2018,0,91,91,182
"62663",2019,0,98,271,369
"62663",2020,0,118,118,236
"62664",2018,0,91,91,182
"62664",2019,0,98,98,196
"62664",2020,0,118,118,236
"62665",2018,0,91,91,182
"62665",2019,0,98,271,369
"62665",2020,0,118,118,236
"62666",2018,0,91,91,182
"62666",2019,0,98,98,196
"62666",2020,0,118,118,236
"62667",2018,0,91,91,182
"62667",2019,0,98,98,196
"62667",2020,0,118,118,236
"62668",2018,0,91,91,182
"62668",2019,0,98,98,196
"62668",2020,0,118,118,236
"62669",2018,0,91,91,182
"62669",2019,0,98,98,196
"62669",2020,0,118,118,236
"62670",2018,0,91,91,182
"62670",2019,0,98,98,196
"62670",2020,0,118,118,236
"62671",2018,0,91,91,182
"62671",2019,0,98,98,196
"62671",2020,0,118,118,236
"62672",2018,0,91,91,182
"62672",2019,0,98,98,196
"62672",2020,0,118,118,236
"62673",2018,0,91,91,182
"62673",2019,0,98,98,196
"62673",2020,0,118,118,236
"62674",2018,0,91,91,182
"62674",2019,0,98,98,196
"62674",2020,0,118,118,236
"62675",2018,0,91,91,182
"62675",2019,0,98,98,196
"62675",2020,0,118,118,236
"62676",2018,0,91,91,182
"62676",2019,0,98,98,196
"62676",2020,0,118,118,236
"62677",2018,0,91,91,182
"62677",2019,0,98,271,369
"62677",2020,0,118,118,236
"62678",2018,0,91,91,182
"62678",2019,0,98,98,196
"62678",2020,0,118,118,236
"62679",2018,0,91,91,182
"62679",2019,0,98,98,196
"62679",2020,0,118,118,236
"62680",2018,0,91,91,182
"62680",2019,0,98,98,196
"62680",2020,0,118,118,236
"62681",2018,0,91,91,182
"62681",2019,0,98,98,196
"62681",2020,0,118,118,236
"62682",2018,0,91,91,182
"62682",2019,0,98,98,196
"62682",2020,0,118,118,236
"62683",2018,0,91,91,182
"62683",2019,0,98,271,369
"62683",2020,0,118,118,236
"62684",2018,0,91,91,182
"62684",2019,0,98,98,196
"62684",2020,0,118,118,236
"62685",2018,0,91,91,182
"62685",2019,0,98,98,196
"62685",2020,0,118,118,236
"62686",2018,0,91,91,182
"62686",2019,0,98,271,369
"62686",2020,0,118,118,236
"62688",2018,0,91,91,182
"62688",2019,0,98,271,369
"62688",2020,0,118,118,236
"62689",2018,0,91,91,182
"62689",2019,0,98,98,196
"62689",2020,0,118,118,236
"62690",2018,0,91,91,182
"62690",2019,0,98,271,369
"62690",2020,0,118,118,236
"62691",2018,0,91,91,182
"62691",2019,0,98,98,196
"62691",2020,0,118,118,236
"62692",2018,0,91,91,182
"62692",2019,0,98,98,196
"62692",2020,0,118,118,236
"62693",2018,0,91,91,182
"62693",2019,0,98,98,196
"62693",2020,0,118,118,236
"62694",2018,0,91,91,182
"62694",2019,0,98,271,369
"62694",2020,0,118,118,236
"62695",2018,0,91,91,182
"62695",2019,0,98,271,369
"62695",2020,0,118,118,236
"62696",2018,0,91,91,182
"62696",2019,0,98,98,196
"62696",2020,0,118,118,236
"62697",2018,0,91,91,182
"62697",2019,0,98,98,196
"62697",2020,0,118,118,236
"62698",2018,0,91,91,182
"62698",2019,0,98,271,369
"62698",2020,0,118,118,236
"62699",2018,0,91,91,182
"62699",2019,0,98,98,196
"62699",2020,0,118,118,236
"62700",2018,0,91,91,182
"62700",2019,0,98,271,369
"62700",2020,0,118,118,236
"62701",2018,0,91,91,182
"62701",2019,0,98,98,196
"62701",2020,0,118,118,236
"62702",2018,0,91,91,182
"62702",2019,0,98,98,196
"62702",2020,0,118,118,236
"62703",2018,0,91,91,182
"62703",2019,0,98,98,196
"62703",2020,0,118,118,236
"62704",2018,0,91,91,182
"62704",2019,0,98,98,196
"62704",2020,0,118,118,236
"62705",2018,0,91,91,182
"62705",2019,0,98,98,196
"62705",2020,0,118,118,236
"62706",2018,0,91,91,182
"62706",2019,0,98,98,196
"62706",2020,0,118,118,236
"62708",2018,0,91,91,182
"62708",2019,0,98,98,196
"62708",2020,0,118,118,236
"62709",2018,0,91,91,182
"62709",2019,0,98,98,196
"62709",2020,0,118,118,236
"62710",2018,0,91,91,182
"62710",2019,0,98,98,196
"62710",2020,0,118,118,236
"62711",2018,0,91,91,182
"62711",2019,0,98,98,196
"62711",2020,0,118,118,236
"62712",2018,0,91,91,182
"62712",2019,0,98,98,196
"62712",2020,0,118,118,236
"62713",2018,0,91,91,182
"62713",2019,0,98,98,196
"62713",2020,0,118,118,236
"62714",2018,0,91,91,182
"62714",2019,0,98,98,196
"62714",2020,0,118,118,236
"62715",2018,0,91,91,182
"62715",2019,0,98,98,196
"62715",2020,0,118,118,236
"62716",2018,0,91,91,182
"62716",2019,0,98,98,196
"62716",2020,0,118,118,236
"62717",2018,0,91,91,182
"62717",2019,0,98,271,369
"62717",2020,0,118,118,236
"62718",2018,0,91,91,182
"62718",2019,0,98,98,196
"62718",2020,0,118,118,236
"62719",2018,0,91,91,182
"62719",2019,0,98,271,369
"62719",2020,0,118,118,236
"62720",2018,0,91,91,182
"62720",2019,0,98,98,196
"62720",2020,0,118,118,236
"62721",2018,0,91,91,182
"62721",2019,0,98,98,196
"62721",2020,0,118,118,236
"62722",2018,0,91,91,182
"62722",2019,0,98,271,369
"62722",2020,0,118,118,236
"62723",2018,0,91,91,182
"62723",2019,0,98,271,369
"62723",2020,0,118,118,236
"62724",2018,0,91,91,182
"62724",2019,0,98,98,196
"62724",2020,0,118,118,236
"62725",2018,0,91,91,182
"62725",2019,0,98,271,369
"62725",2020,0,118,118,236
"62726",2018,0,91,91,182
"62726",2019,0,98,98,196
"62726",2020,0,118,118,236
"62727",2018,0,91,91,182
"62727",2019,0,98,98,196
"62727",2020,0,118,118,236
"62728",2018,0,91,91,182
"62728",2019,0,98,98,196
"62728",2020,0,118,118,236
"62729",2018,0,91,91,182
"62729",2019,0,98,98,196
"62729",2020,0,118,118,236
"62730",2018,0,91,91,182
"62730",2019,0,98,98,196
"62730",2020,0,118,118,236
"62731",2018,0,91,91,182
"62731",2019,0,98,98,196
"62731",2020,0,118,118,236
"62732",2018,0,91,91,182
"62732",2019,0,98,98,196
"62732",2020,0,118,118,236
"62733",2018,0,91,91,182
"62733",2019,0,98,98,196
"62733",2020,0,118,118,236
"62734",2018,0,91,91,182
"62734",2019,0,98,98,196
"62734",2020,0,118,118,236
"62735",2018,0,91,91,182
"62735",2019,0,98,98,196
"62735",2020,0,118,118,236
"62736",2018,0,91,91,182
"62736",2019,0,98,98,196
"62736",2020,0,118,118,236
"62737",2018,0,91,91,182
"62737",2019,0,98,98,196
"62737",2020,0,118,118,236
"62738",2018,0,91,91,182
"62738",2019,0,98,271,369
"62738",2020,0,118,118,236
"62739",2018,0,91,91,182
"62739",2019,0,98,98,196
"62739",2020,0,118,118,236
"62740",2018,0,91,91,182
"62740",2019,0,98,98,196
"62740",2020,0,118,118,236
"62741",2018,0,91,91,182
"62741",2019,0,98,98,196
"62741",2020,0,118,118,236
"62742",2018,0,91,91,182
"62742",2019,0,98,271,369
"62742",2020,0,118,118,236
"62743",2018,0,91,91,182
"62743",2019,0,98,271,369
"62743",2020,0,118,118,236
"62744",2018,0,91,91,182
"62744",2019,0,98,98,196
"62744",2020,0,118,118,236
"62745",2018,0,91,91,182
"62745",2019,0,98,271,369
"62745",2020,0,118,118,236
"62746",2018,0,91,91,182
"62746",2019,0,98,98,196
"62746",2020,0,118,118,236
"62747",2018,0,91,91,182
"62747",2019,0,98,98,196
"62747",2020,0,118,118,236
"62748",2018,0,91,91,182
"62748",2019,0,98,98,196
"62748",2020,0,118,118,236
"62749",2018,0,91,91,182
"62749",2019,0,98,271,369
"62749",2020,0,118,118,236
"62750",2018,0,91,91,182
"62750",2019,0,98,98,196
"62750",2020,0,118,118,236
"62751",2018,0,91,91,182
"62751",2019,0,98,98,196
"62751",2020,0,118,118,236
"62752",2018,0,91,91,182
"62752",2019,0,98,271,369
"62752",2020,0,118,118,236
"62753",2018,0,91,91,182
"62753",2019,0,98,98,196
"62753",2020,0,118,118,236
"62754",2018,0,91,91,182
"62754",2019,0,98,98,196
"62754",2020,0,118,118,236
"62755",2018,0,91,91,182
"62755",2019,0,98,98,196
"62755",2020,0,118,118,236
"62756",2018,0,91,91,182
"62756",2019,0,98,98,196
"62756",2020,0,118,118,236
"62757",2018,0,91,91,182
"62757",2019,0,98,98,196
"62757",2020,0,118,118,236
"62758",2018,0,91,91,182
"62758",2019,0,98,98,196
"62758",2020,0,118,118,236
"62759",2018,0,91,91,182
"62759",2019,0,98,98,196
"62759",2020,0,118,118,236
"62760",2018,0,91,91,182
"62760",2019,0,98,98,196
"62760",2020,0,118,118,236
"62761",2018,0,91,91,182
"62761",2019,0,98,98,196
"62761",2020,0,118,118,236
"62762",2018,0,91,91,182
"62762",2019,0,98,98,196
"62762",2020,0,118,118,236
"62763",2018,0,91,91,182
"62763",2019,0,98,271,369
"62763",2020,0,118,118,236
"62764",2018,0,91,91,182
"62764",2019,0,98,98,196
"62764",2020,0,118,118,236
"62765",2018,0,91,91,182
"62765",2019,0,98,98,196
"62765",2020,0,118,118,236
"62766",2018,0,91,91,182
"62766",2019,0,98,98,196
"62766",2020,0,118,118,236
"62767",2018,0,91,91,182
"62767",2019,0,98,271,369
"62767",2020,0,118,118,236
"62768",2018,0,91,91,182
"62768",2019,0,98,271,369
"62768",2020,0,118,118,236
"62769",2018,0,91,91,182
"62769",2019,0,98,98,196
"62769",2020,0,118,118,236
"62770",2018,0,91,91,182
"62770",2019,0,98,98,196
"62770",2020,0,118,118,236
"62771",2018,0,91,91,182
"62771",2019,0,98,98,196
"62771",2020,0,118,118,236
"62772",2018,0,91,91,182
"62772",2019,0,98,98,196
"62772",2020,0,118,118,236
"62773",2018,0,91,91,182
"62773",2019,0,98,98,196
"62773",2020,0,118,118,236
"62774",2018,0,91,91,182
"62774",2019,0,98,98,196
"62774",2020,0,118,118,236
"62775",2018,0,91,91,182
"62775",2019,0,98,98,196
"62775",2020,0,118,118,236
"62776",2018,0,91,91,182
"62776",2019,0,98,98,196
"62776",2020,0,118,118,236
"62777",2018,0,91,91,182
"62777",2019,0,98,98,196
"62777",2020,0,118,118,236
"62778",2018,0,91,91,182
"62778",2019,0,98,271,369
"62778",2020,0,118,118,236
"62779",2018,0,91,91,182
"62779",2019,0,98,271,369
"62779",2020,0,118,118,236
"62780",2018,0,91,91,182
"62780",2019,0,98,98,196
"62780",2020,0,118,118,236
"62781",2018,0,91,91,182
"62781",2019,0,98,98,196
"62781",2020,0,118,118,236
"62782",2018,0,91,91,182
"62782",2019,0,98,98,196
"62782",2020,0,118,118,236
"62783",2018,0,91,91,182
"62783",2019,0,98,271,369
"62783",2020,0,118,118,236
"62784",2018,0,91,91,182
"62784",2019,0,98,98,196
"62784",2020,0,118,118,236
"62785",2018,0,91,91,182
"62785",2019,0,98,98,196
"62785",2020,0,118,118,236
"62786",2018,0,91,91,182
"62786",2019,0,98,98,196
"62786",2020,0,118,118,236
"62787",2018,0,91,91,182
"62787",2019,0,98,271,369
"62787",2020,0,118,118,236
"62788",2018,0,91,91,182
"62788",2019,0,98,98,196
"62788",2020,0,118,118,236
"62789",2018,0,91,91,182
"62789",2019,0,98,98,196
"62789",2020,0,118,118,236
"62790",2018,0,91,91,182
"62790",2019,0,98,98,196
"62790",2020,0,118,118,236
"62791",2018,0,91,91,182
"62791",2019,0,98,271,369
"62791",2020,0,118,118,236
"62792",2018,0,91,91,182
"62792",2019,0,98,98,196
"62792",2020,0,118,118,236
"62793",2018,0,91,91,182
"62793",2019,0,98,98,196
"62793",2020,0,118,118,236
"62794",2018,0,91,91,182
"62794",2019,0,98,98,196
"62794",2020,0,118,118,236
"62795",2018,0,91,91,182
"62795",2019,0,98,271,369
"62795",2020,0,118,118,236
"62796",2018,0,91,91,182
"62796",2019,0,98,98,196
"62796",2020,0,118,118,236
"62797",2018,0,91,91,182
"62797",2019,0,98,271,369
"62797",2020,0,118,118,236
"62798",2018,0,91,91,182
"62798",2019,0,98,271,369
"62798",2020,0,118,118,236
"62799",2018,0,91,91,182
"62799",2019,0,98,271,369
"62799",2020,0,118,118,236
"62800",2018,0,91,91,182
"62800",2019,0,98,98,196
"62800",2020,0,118,118,236
"62801",2018,0,91,91,182
"62801",2019,0,98,98,196
"62801",2020,0,118,118,236
"62802",2018,0,91,91,182
"62802",2019,0,98,271,369
"62802",2020,0,118,118,236
"62803",2018,0,91,91,182
"62803",2019,0,98,98,196
"62803",2020,0,118,118,236
"62804",2018,0,91,91,182
"62804",2019,0,98,271,369
"62804",2020,0,118,118,236
"62805",2018,0,91,91,182
"62805",2019,0,98,98,196
"62805",2020,0,118,118,236
"62806",2018,0,91,91,182
"62806",2019,0,98,98,196
"62806",2020,0,118,118,236
"62808",2018,0,91,91,182
"62808",2019,0,98,271,369
"62808",2020,0,118,118,236
"62809",2018,0,91,91,182
"62809",2019,0,98,271,369
"62809",2020,0,118,118,236
"62810",2018,0,91,91,182
"62810",2019,0,98,98,196
"62810",2020,0,118,118,236
"62811",2018,0,91,91,182
"62811",2019,0,98,98,196
"62811",2020,0,118,118,236
"62812",2018,0,91,91,182
"62812",2019,0,98,98,196
"62812",2020,0,118,118,236
"62813",2018,0,91,91,182
"62813",2019,0,98,98,196
"62813",2020,0,118,118,236
"62814",2018,0,91,91,182
"62814",2019,0,98,271,369
"62814",2020,0,118,118,236
"62815",2018,0,91,91,182
"62815",2019,0,98,271,369
"62815",2020,0,118,118,236
"62816",2018,0,91,91,182
"62816",2019,0,98,98,196
"62816",2020,0,118,118,236
"62817",2018,0,91,91,182
"62817",2019,0,98,98,196
"62817",2020,0,118,118,236
"62818",2018,0,91,91,182
"62818",2019,0,98,271,369
"62818",2020,0,118,118,236
"62819",2018,0,91,91,182
"62819",2019,0,98,98,196
"62819",2020,0,118,118,236
"62820",2018,0,91,91,182
"62820",2019,0,98,98,196
"62820",2020,0,118,118,236
"62821",2018,0,91,91,182
"62821",2019,0,98,98,196
"62821",2020,0,118,118,236
"62822",2018,0,91,91,182
"62822",2019,0,98,271,369
"62822",2020,0,118,118,236
"62823",2018,0,91,91,182
"62823",2019,0,98,271,369
"62823",2020,0,118,118,236
"62824",2018,0,91,91,182
"62824",2019,0,98,271,369
"62824",2020,0,118,118,236
"62825",2018,0,91,91,182
"62825",2019,0,98,98,196
"62825",2020,0,118,118,236
"62826",2018,0,91,91,182
"62826",2019,0,98,271,369
"62826",2020,0,118,118,236
"62827",2018,0,91,91,182
"62827",2019,0,98,98,196
"62827",2020,0,118,118,236
"62828",2018,0,91,91,182
"62828",2019,0,98,98,196
"62828",2020,0,118,118,236
"62829",2018,0,91,91,182
"62829",2019,0,98,98,196
"62829",2020,0,118,118,236
"62830",2018,0,91,91,182
"62830",2019,0,98,98,196
"62830",2020,0,118,118,236
"62831",2018,0,91,91,182
"62831",2019,0,98,98,196
"62831",2020,0,118,118,236
"62832",2018,0,91,91,182
"62832",2019,0,98,271,369
"62832",2020,0,118,118,236
"62833",2018,0,91,91,182
"62833",2019,0,98,271,369
"62833",2020,0,118,118,236
"62834",2018,0,91,91,182
"62834",2019,0,98,271,369
"62834",2020,0,118,118,236
"62835",2018,0,91,91,182
"62835",2019,0,98,98,196
"62835",2020,0,118,118,236
"62836",2018,0,91,91,182
"62836",2019,0,98,98,196
"62836",2020,0,118,118,236
"62837",2018,0,91,91,182
"62837",2019,0,98,98,196
"62837",2020,0,118,118,236
"62838",2018,0,91,91,182
"62838",2019,0,98,271,369
"62838",2020,0,118,118,236
"62839",2018,0,91,91,182
"62839",2019,0,98,98,196
"62839",2020,0,118,118,236
"62840",2018,0,91,91,182
"62840",2019,0,98,98,196
"62840",2020,0,118,118,236
"62841",2018,0,91,91,182
"62841",2019,0,98,98,196
"62841",2020,0,118,118,236
"62842",2018,0,91,91,182
"62842",2019,0,98,98,196
"62842",2020,0,118,118,236
"62843",2018,0,91,91,182
"62843",2019,0,98,98,196
"62843",2020,0,118,118,236
"62844",2018,0,91,91,182
"62844",2019,0,98,98,196
"62844",2020,0,118,118,236
"62845",2018,0,91,91,182
"62845",2019,0,98,98,196
"62845",2020,0,118,118,236
"62846",2018,0,91,91,182
"62846",2019,0,98,98,196
"62846",2020,0,118,118,236
"62847",2018,0,91,91,182
"62847",2019,0,98,98,196
"62847",2020,0,118,118,236
"62848",2018,0,91,91,182
"62848",2019,0,98,98,196
"62848",2020,0,118,118,236
"62849",2018,0,91,91,182
"62849",2019,0,98,271,369
"62849",2020,0,118,118,236
"62850",2018,0,91,91,182
"62850",2019,0,98,271,369
"62850",2020,0,118,118,236
"62851",2018,0,91,91,182
"62851",2019,0,98,98,196
"62851",2020,0,118,118,236
"62852",2018,0,91,91,182
"62852",2019,0,98,98,196
"62852",2020,0,118,118,236
"62853",2018,0,91,91,182
"62853",2019,0,98,98,196
"62853",2020,0,118,118,236
"62854",2018,0,91,91,182
"62854",2019,0,98,98,196
"62854",2020,0,118,118,236
"62855",2018,0,91,91,182
"62855",2019,0,98,98,196
"62855",2020,0,118,118,236
"62856",2018,0,91,91,182
"62856",2019,0,98,98,196
"62856",2020,0,118,118,236
"62857",2018,0,91,91,182
"62857",2019,0,98,98,196
"62857",2020,0,118,118,236
"62858",2018,0,91,91,182
"62858",2019,0,98,98,196
"62858",2020,0,118,118,236
"62859",2018,0,91,91,182
"62859",2019,0,98,271,369
"62859",2020,0,118,118,236
"62860",2018,0,91,91,182
"62860",2019,0,98,271,369
"62860",2020,0,118,118,236
"62861",2018,0,91,91,182
"62861",2019,0,98,98,196
"62861",2020,0,118,118,236
"62862",2018,0,91,91,182
"62862",2019,0,98,98,196
"62862",2020,0,118,118,236
"62863",2018,0,91,91,182
"62863",2019,0,98,98,196
"62863",2020,0,118,118,236
"62864",2018,0,91,91,182
"62864",2019,0,98,98,196
"62864",2020,0,118,118,236
"62865",2018,0,91,91,182
"62865",2019,0,98,98,196
"62865",2020,0,118,118,236
"62866",2018,0,91,91,182
"62866",2019,0,98,271,369
"62866",2020,0,118,118,236
"62867",2018,0,91,91,182
"62867",2019,0,98,98,196
"62867",2020,0,118,118,236
"62868",2018,0,91,91,182
"62868",2019,0,98,271,369
"62868",2020,0,118,118,236
"62869",2018,0,91,91,182
"62869",2019,0,98,98,196
"62869",2020,0,118,118,236
"62870",2018,0,91,91,182
"62870",2019,0,98,271,369
"62870",2020,0,118,118,236
"62871",2018,0,91,91,182
"62871",2019,0,98,271,369
"62871",2020,0,118,118,236
"62872",2018,0,91,91,182
"62872",2019,0,98,271,369
"62872",2020,0,118,118,236
"62873",2018,0,91,91,182
"62873",2019,0,98,98,196
"62873",2020,0,118,118,236
"62874",2018,0,91,91,182
"62874",2019,0,98,98,196
"62874",2020,0,118,118,236
"62875",2018,0,91,91,182
"62875",2019,0,98,98,196
"62875",2020,0,118,118,236
"62876",2018,0,91,91,182
"62876",2019,0,98,98,196
"62876",2020,0,118,118,236
"62877",2018,0,91,91,182
"62877",2019,0,98,271,369
"62877",2020,0,118,118,236
"62878",2018,0,91,91,182
"62878",2019,0,98,98,196
"62878",2020,0,118,118,236
"62879",2018,0,91,91,182
"62879",2019,0,98,271,369
"62879",2020,0,118,118,236
"62880",2018,0,91,91,182
"62880",2019,0,98,98,196
"62880",2020,0,118,118,236
"62881",2018,0,91,91,182
"62881",2019,0,98,271,369
"62881",2020,0,118,118,236
"62882",2018,0,91,91,182
"62882",2019,0,98,98,196
"62882",2020,0,118,118,236
"62883",2018,0,91,91,182
"62883",2019,0,98,271,369
"62883",2020,0,118,118,236
"62885",2018,0,91,91,182
"62885",2019,0,98,98,196
"62885",2020,0,118,118,236
"62886",2018,0,91,91,182
"62886",2019,0,98,98,196
"62886",2020,0,118,118,236
"62887",2018,0,91,91,182
"62887",2019,0,98,98,196
"62887",2020,0,118,118,236
"62888",2018,0,91,91,182
"62888",2019,0,98,98,196
"62888",2020,0,118,118,236
"62889",2018,0,91,91,182
"62889",2019,0,98,98,196
"62889",2020,0,118,118,236
"62890",2018,0,91,91,182
"62890",2019,0,98,271,369
"62890",2020,0,118,118,236
"62891",2018,0,91,91,182
"62891",2019,0,98,271,369
"62891",2020,0,118,118,236
"62892",2018,0,91,91,182
"62892",2019,0,98,98,196
"62892",2020,0,118,118,236
"62893",2018,0,91,91,182
"62893",2019,0,98,98,196
"62893",2020,0,118,118,236
"62894",2018,0,91,91,182
"62894",2019,0,98,98,196
"62894",2020,0,118,118,236
"62895",2018,0,91,91,182
"62895",2019,0,98,98,196
"62895",2020,0,118,118,236
"62896",2018,0,91,91,182
"62896",2019,0,98,98,196
"62896",2020,0,118,118,236
"62897",2018,0,91,91,182
"62897",2019,0,98,98,196
"62897",2020,0,118,118,236
"62898",2018,0,91,91,182
"62898",2019,0,98,98,196
"62898",2020,0,118,118,236
"62899",2018,0,91,91,182
"62899",2019,0,98,98,196
"62899",2020,0,118,118,236
"62900",2018,0,91,91,182
"62900",2019,0,98,98,196
"62900",2020,0,118,118,236
"62901",2018,0,91,91,182
"62901",2019,0,98,98,196
"62901",2020,0,118,118,236
"62902",2018,0,91,91,182
"62902",2019,0,98,98,196
"62902",2020,0,118,118,236
"62903",2018,0,91,91,182
"62903",2019,0,98,98,196
"62903",2020,0,118,118,236
"62904",2018,0,91,91,182
"62904",2019,0,98,98,196
"62904",2020,0,118,118,236
"62905",2018,0,91,91,182
"62905",2019,0,98,98,196
"62905",2020,0,118,118,236
"62906",2018,0,91,91,182
"62906",2019,0,98,98,196
"62906",2020,0,118,118,236
"62907",2018,0,91,91,182
"62907",2019,0,98,98,196
"62907",2020,0,118,118,236
"62908",2018,0,91,91,182
"62908",2019,0,98,98,196
"62908",2020,0,118,118,236
"62909",2018,0,91,91,182
"62909",2019,0,98,98,196
"62909",2020,0,118,118,236
"63001",2015,0,0,58,58
"63001",2017,0,0,14,14
"63001",2019,0,0,109,109
"63001",2020,0,98,155,253
"63002",2017,0,0,14,14
"63002",2019,0,0,109,109
"63002",2020,0,98,155,253
"63003",2017,0,0,14,14
"63003",2019,0,0,109,109
"63003",2020,0,98,155,253
"63004",2015,0,0,58,58
"63004",2017,0,0,14,14
"63004",2019,0,0,109,109
"63004",2020,0,98,155,253
"63005",2015,0,0,58,58
"63005",2017,0,0,14,14
"63005",2019,0,0,109,109
"63005",2020,0,98,155,253
"63006",2017,0,0,14,14
"63006",2019,0,0,109,109
"63006",2020,0,98,117,215
"63007",2017,0,0,14,14
"63007",2019,0,0,109,109
"63007",2020,0,98,117,215
"63008",2017,0,0,14,14
"63008",2019,0,0,109,109
"63008",2020,0,98,155,253
"63009",2017,0,0,14,14
"63009",2019,0,0,109,109
"63009",2020,0,98,117,215
"63010",2017,0,0,14,14
"63010",2019,0,0,109,109
"63010",2020,0,98,117,215
"63011",2015,0,0,15,15
"63011",2019,0,0,109,109
"63011",2020,0,98,103,201
"63012",2015,0,0,58,58
"63012",2017,0,0,14,14
"63012",2019,0,0,109,109
"63012",2020,0,98,155,253
"63013",2015,0,0,58,58
"63013",2017,0,0,14,14
"63013",2019,0,0,109,109
"63013",2020,0,98,155,253
"63014",2015,0,0,58,58
"63014",2017,0,0,14,14
"63014",2019,0,0,109,109
"63014",2020,0,98,155,253
"63015",2017,0,0,14,14
"63015",2019,0,0,109,109
"63015",2020,0,98,155,253
"63016",2017,0,0,14,14
"63016",2019,0,0,109,109
"63016",2020,0,98,155,253
"63017",2017,0,0,14,14
"63017",2019,0,0,109,109
"63017",2020,0,98,117,215
"63019",2015,0,0,58,58
"63019",2017,0,0,14,14
"63019",2019,0,0,109,109
"63019",2020,0,98,155,253
"63020",2015,0,0,58,58
"63020",2017,0,0,14,14
"63020",2019,0,0,109,109
"63020",2020,0,98,155,253
"63021",2015,0,0,58,58
"63021",2017,0,0,14,14
"63021",2019,0,0,109,109
"63021",2020,0,98,155,253
"63022",2017,0,0,14,14
"63022",2019,0,0,109,109
"63022",2020,0,98,117,215
"63023",2017,0,0,14,14
"63023",2019,0,0,109,109
"63023",2020,0,98,155,253
"63024",2015,0,0,58,58
"63024",2017,0,0,14,14
"63024",2019,0,0,109,109
"63024",2020,0,98,103,201
"63025",2015,0,0,58,58
"63025",2017,0,0,14,14
"63025",2019,0,0,109,109
"63025",2020,0,98,155,253
"63026",2015,0,0,58,58
"63026",2017,0,0,14,14
"63026",2019,0,0,109,109
"63026",2020,0,98,155,253
"63027",2017,0,0,14,14
"63027",2019,0,0,109,109
"63027",2020,0,98,117,215
"63028",2015,0,0,58,58
"63028",2017,0,0,14,14
"63028",2019,0,0,109,109
"63028",2020,0,98,103,201
"63029",2015,0,0,58,58
"63029",2017,0,0,14,14
"63029",2019,0,0,109,109
"63029",2020,0,98,155,253
"63030",2015,0,0,58,58
"63030",2017,0,0,14,14
"63030",2019,0,0,109,109
"63030",2020,0,98,155,253
"63031",2017,0,0,14,14
"63031",2019,0,0,109,109
"63031",2020,0,98,117,215
"63032",2015,0,0,58,58
"63032",2017,0,0,14,14
"63032",2019,0,0,109,109
"63032",2020,0,98,155,253
"63033",2015,0,0,58,58
"63033",2017,0,0,14,14
"63033",2019,0,0,109,109
"63033",2020,0,98,155,253
"63034",2015,0,0,58,58
"63034",2017,0,0,14,14
"63034",2019,0,0,109,109
"63034",2020,0,98,155,253
"63035",2015,0,0,58,58
"63035",2017,0,0,14,14
"63035",2019,0,0,109,109
"63035",2020,0,98,155,253
"63036",2015,0,0,58,58
"63036",2017,0,0,14,14
"63036",2019,0,0,109,109
"63036",2020,0,98,155,253
"63037",2017,0,0,14,14
"63037",2019,0,0,109,109
"63037",2020,0,98,155,253
"63038",2015,0,0,58,58
"63038",2017,0,0,14,14
"63038",2019,0,0,109,109
"63038",2020,0,98,103,201
"63039",2017,0,0,14,14
"63039",2019,0,0,109,109
"63039",2020,0,98,117,215
"63040",2015,0,0,58,58
"63040",2017,0,0,14,14
"63040",2019,0,0,109,109
"63040",2020,0,98,155,253
"63041",2015,0,0,58,58
"63041",2017,0,0,14,14
"63041",2019,0,0,109,109
"63041",2020,0,98,155,253
"63042",2015,0,0,58,58
"63042",2017,0,0,14,14
"63042",2019,0,0,109,109
"63042",2020,0,98,155,253
"63043",2015,0,0,58,58
"63043",2017,0,0,14,14
"63043",2019,0,0,109,109
"63043",2020,0,98,155,253
"63044",2017,0,0,14,14
"63044",2019,0,0,109,109
"63044",2020,0,98,155,253
"63045",2017,0,0,14,14
"63045",2019,0,0,109,109
"63045",2020,0,98,155,253
"63046",2015,0,0,58,58
"63046",2017,0,0,14,14
"63046",2019,0,0,109,109
"63046",2020,0,98,155,253
"63047",2015,0,0,58,58
"63047",2017,0,0,14,14
"63047",2019,0,0,109,109
"63047",2020,0,98,103,201
"63048",2015,0,0,58,58
"63048",2017,0,0,14,14
"63048",2019,0,0,109,109
"63048",2020,0,98,103,201
"63049",2015,0,0,58,58
"63049",2017,0,0,14,14
"63049",2019,0,0,109,109
"63049",2020,0,98,155,253
"63050",2017,0,0,14,14
"63050",2019,0,0,109,109
"63050",2020,0,98,117,215
"63051",2015,0,0,58,58
"63051",2017,0,0,14,14
"63051",2019,0,0,109,109
"63051",2020,0,98,155,253
"63052",2017,0,0,14,14
"63052",2019,0,0,109,109
"63052",2020,0,98,117,215
"63053",2015,0,0,58,58
"63053",2017,0,0,14,14
"63053",2019,0,0,109,109
"63053",2020,0,98,103,201
"63054",2015,0,0,58,58
"63054",2017,0,0,14,14
"63054",2019,0,0,109,109
"63054",2020,0,98,155,253
"63055",2015,0,0,58,58
"63055",2017,0,0,14,14
"63055",2019,0,0,109,109
"63055",2020,0,98,155,253
"63056",2017,0,0,14,14
"63056",2019,0,0,109,109
"63056",2020,0,98,155,253
"63057",2017,0,0,14,14
"63057",2019,0,0,109,109
"63057",2020,0,98,155,253
"63058",2017,0,0,14,14
"63058",2019,0,0,109,109
"63058",2020,0,98,155,253
"63059",2015,0,0,58,58
"63059",2017,0,0,14,14
"63059",2019,0,0,109,109
"63059",2020,0,98,155,253
"63060",2015,0,0,15,15
"63060",2019,0,0,109,109
"63060",2020,0,98,103,201
"63061",2015,0,0,58,58
"63061",2017,0,0,14,14
"63061",2019,0,0,109,109
"63061",2020,0,98,155,253
"63062",2015,0,0,15,15
"63062",2019,0,0,109,109
"63062",2020,0,98,103,201
"63063",2015,0,0,58,58
"63063",2017,0,0,14,14
"63063",2019,0,0,109,109
"63063",2020,0,98,155,253
"63064",2015,0,0,58,58
"63064",2017,0,0,14,14
"63064",2019,0,0,109,109
"63064",2020,0,98,155,253
"63065",2017,0,0,14,14
"63065",2019,0,0,109,109
"63065",2020,0,98,155,253
"63066",2017,0,0,14,14
"63066",2019,0,0,109,109
"63066",2020,0,98,155,253
"63067",2015,0,0,15,15
"63067",2019,0,0,109,109
"63067",2020,0,98,103,201
"63069",2015,0,0,58,58
"63069",2017,0,0,14,14
"63069",2019,0,0,109,109
"63069",2020,0,98,155,253
"63070",2015,0,0,58,58
"63070",2017,0,0,14,14
"63070",2019,0,0,109,109
"63070",2020,0,98,155,253
"63071",2015,0,0,58,58
"63071",2017,0,0,14,14
"63071",2019,0,0,109,109
"63071",2020,0,98,155,253
"63072",2017,0,0,14,14
"63072",2019,0,0,109,109
"63072",2020,0,98,155,253
"63073",2015,0,0,58,58
"63073",2017,0,0,14,14
"63073",2019,0,0,109,109
"63073",2020,0,98,155,253
"63074",2015,0,0,58,58
"63074",2017,0,0,14,14
"63074",2019,0,0,109,109
"63074",2020,0,98,155,253
"63075",2015,0,0,58,58
"63075",2017,0,0,14,14
"63075",2019,0,0,109,109
"63075",2020,0,98,155,253
"63076",2017,0,0,14,14
"63076",2019,0,0,109,109
"63076",2020,0,98,155,253
"63077",2015,0,0,58,58
"63077",2017,0,0,14,14
"63077",2019,0,0,109,109
"63077",2020,0,98,103,201
"63079",2015,0,0,58,58
"63079",2017,0,0,14,14
"63079",2019,0,0,109,109
"63079",2020,0,98,155,253
"63080",2015,0,0,58,58
"63080",2017,0,0,14,14
"63080",2019,0,0,109,109
"63080",2020,0,98,155,253
"63081",2017,0,0,14,14
"63081",2019,0,0,109,109
"63081",2020,0,98,155,253
"63082",2015,0,0,58,58
"63082",2017,0,0,14,14
"63082",2019,0,0,109,109
"63082",2020,0,98,155,253
"63083",2015,0,0,58,58
"63083",2017,0,0,14,14
"63083",2019,0,0,109,109
"63083",2020,0,98,155,253
"63084",2015,0,0,58,58
"63084",2017,0,0,14,14
"63084",2019,0,0,109,109
"63084",2020,0,98,155,253
"63085",2015,0,0,58,58
"63085",2017,0,0,14,14
"63085",2019,0,0,109,109
"63085",2020,0,98,155,253
"63086",2017,0,0,14,14
"63086",2019,0,0,109,109
"63086",2020,0,98,155,253
"63087",2015,0,0,58,58
"63087",2017,0,0,14,14
"63087",2019,0,0,109,109
"63087",2020,0,98,155,253
"63088",2015,0,0,58,58
"63088",2017,0,0,14,14
"63088",2019,0,0,109,109
"63088",2020,0,98,155,253
"63089",2015,0,0,58,58
"63089",2017,0,0,14,14
"63089",2019,0,0,109,109
"63089",2020,0,98,155,253
"63090",2015,0,0,58,58
"63090",2017,0,0,14,14
"63090",2019,0,0,109,109
"63090",2020,0,98,155,253
"63091",2017,0,0,14,14
"63091",2019,0,0,109,109
"63091",2020,0,98,117,215
"63092",2015,0,0,58,58
"63092",2017,0,0,14,14
"63092",2019,0,0,109,109
"63092",2020,0,98,155,253
"63093",2015,0,0,58,58
"63093",2017,0,0,14,14
"63093",2019,0,0,109,109
"63093",2020,0,98,155,253
"63094",2015,0,0,15,15
"63094",2019,0,0,109,109
"63094",2020,0,98,103,201
"63095",2017,0,0,14,14
"63095",2019,0,0,109,109
"63095",2020,0,98,155,253
"63096",2015,0,0,58,58
"63096",2017,0,0,14,14
"63096",2019,0,0,109,109
"63096",2020,0,98,155,253
"63097",2015,0,0,58,58
"63097",2017,0,0,14,14
"63097",2019,0,0,109,109
"63097",2020,0,98,155,253
"63098",2015,0,0,58,58
"63098",2017,0,0,14,14
"63098",2019,0,0,109,109
"63098",2020,0,98,103,201
"63099",2015,0,0,58,58
"63099",2017,0,0,14,14
"63099",2019,0,0,109,109
"63099",2020,0,98,155,253
"63100",2015,0,0,58,58
"63100",2017,0,0,14,14
"63100",2019,0,0,109,109
"63100",2020,0,98,155,253
"63101",2015,0,0,15,15
"63101",2019,0,0,109,109
"63101",2020,0,98,103,201
"63102",2017,0,0,14,14
"63102",2019,0,0,109,109
"63102",2020,0,98,155,253
"63103",2015,0,0,58,58
"63103",2017,0,0,14,14
"63103",2019,0,0,109,109
"63103",2020,0,98,155,253
"63104",2017,0,0,14,14
"63104",2019,0,0,109,109
"63104",2020,0,98,117,215
"63105",2017,0,0,14,14
"63105",2019,0,0,109,109
"63105",2020,0,98,155,253
"63106",2015,0,0,58,58
"63106",2017,0,0,14,14
"63106",2019,0,0,109,109
"63106",2020,0,98,155,253
"63107",2015,0,0,58,58
"63107",2017,0,0,14,14
"63107",2019,0,0,109,109
"63107",2020,0,98,155,253
"63108",2015,0,0,58,58
"63108",2017,0,0,14,14
"63108",2019,0,0,109,109
"63108",2020,0,98,155,253
"63109",2015,0,0,58,58
"63109",2017,0,0,14,14
"63109",2019,0,0,109,109
"63109",2020,0,98,155,253
"63110",2015,0,0,58,58
"63110",2017,0,0,14,14
"63110",2019,0,0,109,109
"63110",2020,0,98,155,253
"63111",2015,0,0,58,58
"63111",2017,0,0,14,14
"63111",2019,0,0,109,109
"63111",2020,0,98,155,253
"63112",2015,0,0,58,58
"63112",2017,0,0,14,14
"63112",2019,0,0,109,109
"63112",2020,0,98,155,253
"63113",2015,0,0,58,58
"63113",2017,0,0,14,14
"63113",2019,0,0,109,109
"63113",2020,0,98,155,253
"63114",2017,0,0,14,14
"63114",2019,0,0,109,109
"63114",2020,0,98,117,215
"63115",2015,0,0,58,58
"63115",2017,0,0,14,14
"63115",2019,0,0,109,109
"63115",2020,0,98,155,253
"63116",2015,0,0,58,58
"63116",2017,0,0,14,14
"63116",2019,0,0,109,109
"63116",2020,0,98,155,253
"63117",2015,0,0,58,58
"63117",2017,0,0,14,14
"63117",2019,0,0,109,109
"63117",2020,0,98,103,201
"63118",2015,0,0,58,58
"63118",2017,0,0,14,14
"63118",2019,0,0,109,109
"63118",2020,0,98,155,253
"63119",2015,0,0,58,58
"63119",2017,0,0,14,14
"63119",2019,0,0,109,109
"63119",2020,0,98,155,253
"63120",2015,0,0,58,58
"63120",2017,0,0,14,14
"63120",2019,0,0,109,109
"63120",2020,0,98,155,253
"63121",2015,0,0,58,58
"63121",2017,0,0,14,14
"63121",2019,0,0,109,109
"63121",2020,0,98,155,253
"63122",2015,0,0,58,58
"63122",2017,0,0,14,14
"63122",2019,0,0,109,109
"63122",2020,0,98,155,253
"63123",2015,0,0,58,58
"63123",2017,0,0,14,14
"63123",2019,0,0,109,109
"63123",2020,0,98,155,253
"63124",2015,0,0,58,58
"63124",2017,0,0,14,14
"63124",2019,0,0,109,109
"63124",2020,0,98,155,253
"63125",2017,0,0,14,14
"63125",2019,0,0,109,109
"63125",2020,0,98,155,253
"63126",2015,0,0,58,58
"63126",2017,0,0,14,14
"63126",2019,0,0,109,109
"63126",2020,0,98,155,253
"63128",2017,0,0,14,14
"63128",2019,0,0,109,109
"63128",2020,0,98,155,253
"63129",2015,0,0,58,58
"63129",2017,0,0,14,14
"63129",2019,0,0,109,109
"63129",2020,0,98,103,201
"63130",2015,0,0,15,15
"63130",2019,0,0,109,109
"63130",2020,0,98,103,201
"63131",2015,0,0,58,58
"63131",2017,0,0,14,14
"63131",2019,0,0,109,109
"63131",2020,0,98,155,253
"63132",2017,0,0,14,14
"63132",2019,0,0,109,109
"63132",2020,0,98,155,253
"63134",2015,0,0,58,58
"63134",2017,0,0,14,14
"63134",2019,0,0,109,109
"63134",2020,0,98,155,253
"63135",2015,0,0,58,58
"63135",2017,0,0,14,14
"63135",2019,0,0,109,109
"63135",2020,0,98,155,253
"63136",2017,0,0,14,14
"63136",2019,0,0,109,109
"63136",2020,0,98,155,253
"63137",2017,0,0,14,14
"63137",2019,0,0,109,109
"63137",2020,0,98,155,253
"63138",2017,0,0,14,14
"63138",2019,0,0,109,109
"63138",2020,0,98,155,253
"63139",2017,0,0,14,14
"63139",2019,0,0,109,109
"63139",2020,0,98,117,215
"63140",2015,0,0,58,58
"63140",2017,0,0,14,14
"63140",2019,0,0,109,109
"63140",2020,0,98,155,253
"63141",2015,0,0,58,58
"63141",2017,0,0,14,14
"63141",2019,0,0,109,109
"63141",2020,0,98,155,253
"63142",2017,0,0,14,14
"63142",2019,0,0,109,109
"63142",2020,0,98,155,253
"63143",2015,0,0,58,58
"63143",2017,0,0,14,14
"63143",2019,0,0,109,109
"63143",2020,0,98,155,253
"63144",2015,0,0,58,58
"63144",2017,0,0,14,14
"63144",2019,0,0,109,109
"63144",2020,0,98,103,201
"63145",2015,0,0,58,58
"63145",2017,0,0,14,14
"63145",2019,0,0,109,109
"63145",2020,0,98,155,253
"63146",2015,0,0,58,58
"63146",2017,0,0,14,14
"63146",2019,0,0,109,109
"63146",2020,0,98,155,253
"63147",2017,0,0,14,14
"63147",2019,0,0,109,109
"63147",2020,0,98,117,215
"63148",2015,0,0,58,58
"63148",2017,0,0,14,14
"63148",2019,0,0,109,109
"63148",2020,0,98,155,253
"63149",2015,0,0,58,58
"63149",2017,0,0,14,14
"63149",2019,0,0,109,109
"63149",2020,0,98,155,253
"63150",2015,0,0,58,58
"63150",2017,0,0,14,14
"63150",2019,0,0,109,109
"63150",2020,0,98,155,253
"63151",2017,0,0,14,14
"63151",2019,0,0,109,109
"63151",2020,0,98,155,253
"63152",2015,0,0,15,15
"63152",2019,0,0,109,109
"63152",2020,0,98,103,201
"63153",2015,0,0,58,58
"63153",2017,0,0,14,14
"63153",2019,0,0,109,109
"63153",2020,0,98,103,201
"63154",2015,0,0,58,58
"63154",2017,0,0,14,14
"63154",2019,0,0,109,109
"63154",2020,0,98,155,253
"63155",2017,0,0,14,14
"63155",2019,0,0,109,109
"63155",2020,0,98,155,253
"63156",2015,0,0,58,58
"63156",2017,0,0,14,14
"63156",2019,0,0,109,109
"63156",2020,0,98,155,253
"63157",2017,0,0,14,14
"63157",2019,0,0,109,109
"63157",2020,0,98,155,253
"63158",2017,0,0,14,14
"63158",2019,0,0,109,109
"63158",2020,0,98,155,253
"63159",2015,0,0,58,58
"63159",2017,0,0,14,14
"63159",2019,0,0,109,109
"63159",2020,0,98,103,201
"63160",2015,0,0,58,58
"63160",2017,0,0,14,14
"63160",2019,0,0,109,109
"63160",2020,0,98,155,253
"63161",2017,0,0,14,14
"63161",2019,0,0,109,109
"63161",2020,0,98,155,253
"63162",2017,0,0,14,14
"63162",2019,0,0,109,109
"63162",2020,0,98,155,253
"63163",2015,0,0,58,58
"63163",2017,0,0,14,14
"63163",2019,0,0,109,109
"63163",2020,0,98,155,253
"63164",2015,0,0,58,58
"63164",2017,0,0,14,14
"63164",2019,0,0,109,109
"63164",2020,0,98,155,253
"63165",2015,0,0,58,58
"63165",2017,0,0,14,14
"63165",2019,0,0,109,109
"63165",2020,0,98,103,201
"63166",2015,0,0,58,58
"63166",2017,0,0,14,14
"63166",2019,0,0,109,109
"63166",2020,0,98,155,253
"63167",2015,0,0,58,58
"63167",2017,0,0,14,14
"63167",2019,0,0,109,109
"63167",2020,0,98,155,253
"63168",2015,0,0,58,58
"63168",2017,0,0,14,14
"63168",2019,0,0,109,109
"63168",2020,0,98,155,253
"63169",2015,0,0,58,58
"63169",2017,0,0,14,14
"63169",2019,0,0,109,109
"63169",2020,0,98,103,201
"63170",2015,0,0,58,58
"63170",2017,0,0,14,14
"63170",2019,0,0,109,109
"63170",2020,0,98,155,253
"63171",2015,0,0,15,15
"63171",2019,0,0,109,109
"63171",2020,0,98,103,201
"63172",2015,0,0,58,58
"63172",2017,0,0,14,14
"63172",2019,0,0,109,109
"63172",2020,0,98,155,253
"63173",2017,0,0,14,14
"63173",2019,0,0,109,109
"63173",2020,0,98,117,215
"63174",2017,0,0,14,14
"63174",2019,0,0,109,109
"63174",2020,0,98,155,253
"63175",2015,0,0,58,58
"63175",2017,0,0,14,14
"63175",2019,0,0,109,109
"63175",2020,0,98,103,201
"63176",2015,0,0,58,58
"63176",2017,0,0,14,14
"63176",2019,0,0,109,109
"63176",2020,0,98,103,201
"63177",2017,0,0,14,14
"63177",2019,0,0,109,109
"63177",2020,0,98,155,253
"63178",2015,0,0,58,58
"63178",2017,0,0,14,14
"63178",2019,0,0,109,109
"63178",2020,0,98,155,253
"63179",2017,0,0,14,14
"63179",2019,0,0,109,109
"63179",2020,0,98,155,253
"63180",2015,0,0,58,58
"63180",2017,0,0,14,14
"63180",2019,0,0,109,109
"63180",2020,0,98,155,253
"63181",2015,0,0,58,58
"63181",2017,0,0,14,14
"63181",2019,0,0,109,109
"63181",2020,0,98,155,253
"63182",2015,0,0,58,58
"63182",2017,0,0,14,14
"63182",2019,0,0,109,109
"63182",2020,0,98,155,253
"63183",2015,0,0,58,58
"63183",2017,0,0,14,14
"63183",2019,0,0,109,109
"63183",2020,0,98,103,201
"63184",2017,0,0,14,14
"63184",2019,0,0,109,109
"63184",2020,0,98,155,253
"63185",2015,0,0,58,58
"63185",2017,0,0,14,14
"63185",2019,0,0,109,109
"63185",2020,0,98,155,253
"63186",2015,0,0,58,58
"63186",2017,0,0,14,14
"63186",2019,0,0,109,109
"63186",2020,0,98,155,253
"63187",2015,0,0,58,58
"63187",2017,0,0,14,14
"63187",2019,0,0,109,109
"63187",2020,0,98,155,253
"63188",2015,0,0,58,58
"63188",2017,0,0,14,14
"63188",2019,0,0,109,109
"63188",2020,0,98,155,253
"63189",2015,0,0,58,58
"63189",2017,0,0,14,14
"63189",2019,0,0,109,109
"63189",2020,0,98,103,201
"63190",2015,0,0,58,58
"63190",2017,0,0,14,14
"63190",2019,0,0,109,109
"63190",2020,0,98,103,201
"63191",2015,0,0,58,58
"63191",2017,0,0,14,14
"63191",2019,0,0,109,109
"63191",2020,0,98,103,201
"63192",2015,0,0,58,58
"63192",2017,0,0,14,14
"63192",2019,0,0,109,109
"63192",2020,0,98,103,201
"63193",2015,0,0,58,58
"63193",2017,0,0,14,14
"63193",2019,0,0,109,109
"63193",2020,0,98,155,253
"63194",2015,0,0,58,58
"63194",2017,0,0,14,14
"63194",2019,0,0,109,109
"63194",2020,0,98,155,253
"63195",2017,0,0,14,14
"63195",2019,0,0,109,109
"63195",2020,0,98,155,253
"63196",2017,0,0,14,14
"63196",2019,0,0,109,109
"63196",2020,0,98,155,253
"63197",2015,0,0,58,58
"63197",2017,0,0,14,14
"63197",2019,0,0,109,109
"63197",2020,0,98,155,253
"63198",2015,0,0,58,58
"63198",2017,0,0,14,14
"63198",2019,0,0,109,109
"63198",2020,0,98,155,253
"63199",2015,0,0,58,58
"63199",2017,0,0,14,14
"63199",2019,0,0,109,109
"63199",2020,0,98,155,253
"63200",2015,0,0,58,58
"63200",2017,0,0,14,14
"63200",2019,0,0,109,109
"63200",2020,0,98,155,253
"63201",2015,0,0,58,58
"63201",2017,0,0,14,14
"63201",2019,0,0,109,109
"63201",2020,0,98,155,253
"63202",2015,0,0,58,58
"63202",2017,0,0,14,14
"63202",2019,0,0,109,109
"63202",2020,0,98,155,253
"63203",2015,0,0,58,58
"63203",2017,0,0,14,14
"63203",2019,0,0,109,109
"63203",2020,0,98,155,253
"63204",2015,0,0,58,58
"63204",2017,0,0,14,14
"63204",2019,0,0,109,109
"63204",2020,0,98,155,253
"63205",2015,0,0,58,58
"63205",2017,0,0,14,14
"63205",2019,0,0,109,109
"63205",2020,0,98,155,253
"63206",2015,0,0,58,58
"63206",2017,0,0,14,14
"63206",2019,0,0,109,109
"63206",2020,0,98,155,253
"63207",2017,0,0,14,14
"63207",2019,0,0,109,109
"63207",2020,0,98,155,253
"63208",2015,0,0,58,58
"63208",2017,0,0,14,14
"63208",2019,0,0,109,109
"63208",2020,0,98,155,253
"63209",2015,0,0,58,58
"63209",2017,0,0,14,14
"63209",2019,0,0,109,109
"63209",2020,0,98,155,253
"63210",2015,0,0,58,58
"63210",2017,0,0,14,14
"63210",2019,0,0,109,109
"63210",2020,0,98,155,253
"63211",2017,0,0,14,14
"63211",2019,0,0,109,109
"63211",2020,0,98,155,253
"63212",2015,0,0,58,58
"63212",2017,0,0,14,14
"63212",2019,0,0,109,109
"63212",2020,0,98,155,253
"63213",2015,0,0,58,58
"63213",2017,0,0,14,14
"63213",2019,0,0,109,109
"63213",2020,0,98,155,253
"63214",2015,0,0,58,58
"63214",2017,0,0,14,14
"63214",2019,0,0,109,109
"63214",2020,0,98,155,253
"63215",2015,0,0,58,58
"63215",2017,0,0,14,14
"63215",2019,0,0,109,109
"63215",2020,0,98,155,253
"63216",2017,0,0,14,14
"63216",2019,0,0,109,109
"63216",2020,0,98,155,253
"63218",2017,0,0,14,14
"63218",2019,0,0,109,109
"63218",2020,0,98,155,253
"63219",2015,0,0,58,58
"63219",2017,0,0,14,14
"63219",2019,0,0,109,109
"63219",2020,0,98,155,253
"63220",2017,0,0,14,14
"63220",2019,0,0,109,109
"63220",2020,0,98,117,215
"63221",2017,0,0,14,14
"63221",2019,0,0,109,109
"63221",2020,0,98,117,215
"63222",2015,0,0,58,58
"63222",2017,0,0,14,14
"63222",2019,0,0,109,109
"63222",2020,0,98,155,253
"63223",2015,0,0,58,58
"63223",2017,0,0,14,14
"63223",2019,0,0,109,109
"63223",2020,0,98,155,253
"63224",2015,0,0,58,58
"63224",2017,0,0,14,14
"63224",2019,0,0,109,109
"63224",2020,0,98,155,253
"63225",2015,0,0,58,58
"63225",2017,0,0,14,14
"63225",2019,0,0,109,109
"63225",2020,0,98,103,201
"63226",2015,0,0,58,58
"63226",2017,0,0,14,14
"63226",2019,0,0,109,109
"63226",2020,0,98,155,253
"63227",2015,0,0,58,58
"63227",2017,0,0,14,14
"63227",2019,0,0,109,109
"63227",2020,0,98,155,253
"63228",2015,0,0,58,58
"63228",2017,0,0,14,14
"63228",2019,0,0,109,109
"63228",2020,0,98,155,253
"63229",2015,0,0,58,58
"63229",2017,0,0,14,14
"63229",2019,0,0,109,109
"63229",2020,0,98,155,253
"63230",2017,0,0,14,14
"63230",2019,0,0,109,109
"63230",2020,0,98,155,253
"63231",2017,0,0,14,14
"63231",2019,0,0,109,109
"63231",2020,0,98,155,253
"63232",2017,0,0,14,14
"63232",2019,0,0,109,109
"63232",2020,0,98,155,253
"63233",2015,0,0,15,15
"63233",2019,0,0,109,109
"63233",2020,0,98,103,201
"63234",2015,0,0,58,58
"63234",2017,0,0,14,14
"63234",2019,0,0,109,109
"63234",2020,0,98,155,253
"63235",2015,0,0,58,58
"63235",2017,0,0,14,14
"63235",2019,0,0,109,109
"63235",2020,0,98,155,253
"63236",2015,0,0,58,58
"63236",2017,0,0,14,14
"63236",2019,0,0,109,109
"63236",2020,0,98,103,201
"63237",2015,0,0,58,58
"63237",2017,0,0,14,14
"63237",2019,0,0,109,109
"63237",2020,0,98,155,253
"63238",2015,0,0,58,58
"63238",2017,0,0,14,14
"63238",2019,0,0,109,109
"63238",2020,0,98,155,253
"63239",2015,0,0,58,58
"63239",2017,0,0,14,14
"63239",2019,0,0,109,109
"63239",2020,0,98,155,253
"63240",2015,0,0,58,58
"63240",2017,0,0,14,14
"63240",2019,0,0,109,109
"63240",2020,0,98,155,253
"63241",2015,0,0,58,58
"63241",2017,0,0,14,14
"63241",2019,0,0,109,109
"63241",2020,0,98,155,253
"63242",2017,0,0,14,14
"63242",2019,0,0,109,109
"63242",2020,0,98,117,215
"63243",2015,0,0,58,58
"63243",2017,0,0,14,14
"63243",2019,0,0,109,109
"63243",2020,0,98,155,253
"63244",2015,0,0,58,58
"63244",2017,0,0,14,14
"63244",2019,0,0,109,109
"63244",2020,0,98,155,253
"63245",2015,0,0,58,58
"63245",2017,0,0,14,14
"63245",2019,0,0,109,109
"63245",2020,0,98,155,253
"63246",2015,0,0,58,58
"63246",2017,0,0,14,14
"63246",2019,0,0,109,109
"63246",2020,0,98,103,201
"63247",2015,0,0,58,58
"63247",2017,0,0,14,14
"63247",2019,0,0,109,109
"63247",2020,0,98,155,253
"63248",2015,0,0,58,58
"63248",2017,0,0,14,14
"63248",2019,0,0,109,109
"63248",2020,0,98,155,253
"63249",2017,0,0,14,14
"63249",2019,0,0,109,109
"63249",2020,0,98,155,253
"63250",2015,0,0,58,58
"63250",2017,0,0,14,14
"63250",2019,0,0,109,109
"63250",2020,0,98,155,253
"63251",2015,0,0,58,58
"63251",2017,0,0,14,14
"63251",2019,0,0,109,109
"63251",2020,0,98,155,253
"63252",2017,0,0,14,14
"63252",2019,0,0,109,109
"63252",2020,0,98,155,253
"63253",2017,0,0,14,14
"63253",2019,0,0,109,109
"63253",2020,0,98,155,253
"63254",2015,0,0,58,58
"63254",2017,0,0,14,14
"63254",2019,0,0,109,109
"63254",2020,0,98,155,253
"63255",2017,0,0,14,14
"63255",2019,0,0,109,109
"63255",2020,0,98,117,215
"63256",2017,0,0,14,14
"63256",2019,0,0,109,109
"63256",2020,0,98,155,253
"63257",2015,0,0,58,58
"63257",2017,0,0,14,14
"63257",2019,0,0,109,109
"63257",2020,0,98,155,253
"63258",2017,0,0,14,14
"63258",2019,0,0,109,109
"63258",2020,0,98,155,253
"63259",2015,0,0,58,58
"63259",2017,0,0,14,14
"63259",2019,0,0,109,109
"63259",2020,0,98,155,253
"63260",2017,0,0,14,14
"63260",2019,0,0,109,109
"63260",2020,0,98,155,253
"63261",2015,0,0,58,58
"63261",2017,0,0,14,14
"63261",2019,0,0,109,109
"63261",2020,0,98,155,253
"63262",2015,0,0,58,58
"63262",2017,0,0,14,14
"63262",2019,0,0,109,109
"63262",2020,0,98,155,253
"63263",2015,0,0,58,58
"63263",2017,0,0,14,14
"63263",2019,0,0,109,109
"63263",2020,0,98,155,253
"63264",2015,0,0,58,58
"63264",2017,0,0,14,14
"63264",2019,0,0,109,109
"63264",2020,0,98,155,253
"63265",2017,0,0,14,14
"63265",2019,0,0,109,109
"63265",2020,0,98,155,253
"63267",2017,0,0,14,14
"63267",2019,0,0,109,109
"63267",2020,0,98,155,253
"63268",2015,0,0,58,58
"63268",2017,0,0,14,14
"63268",2019,0,0,109,109
"63268",2020,0,98,155,253
"63269",2015,0,0,58,58
"63269",2017,0,0,14,14
"63269",2019,0,0,109,109
"63269",2020,0,98,155,253
"63270",2015,0,0,58,58
"63270",2017,0,0,14,14
"63270",2019,0,0,109,109
"63270",2020,0,98,155,253
"63271",2017,0,0,14,14
"63271",2019,0,0,109,109
"63271",2020,0,98,155,253
"63272",2015,0,0,58,58
"63272",2017,0,0,14,14
"63272",2019,0,0,109,109
"63272",2020,0,98,155,253
"63273",2015,0,0,58,58
"63273",2017,0,0,14,14
"63273",2019,0,0,109,109
"63273",2020,0,98,155,253
"63274",2015,0,0,58,58
"63274",2017,0,0,14,14
"63274",2019,0,0,109,109
"63274",2020,0,98,103,201
"63275",2015,0,0,58,58
"63275",2017,0,0,14,14
"63275",2019,0,0,109,109
"63275",2020,0,98,155,253
"63276",2017,0,0,14,14
"63276",2019,0,0,109,109
"63276",2020,0,98,155,253
"63277",2015,0,0,58,58
"63277",2017,0,0,14,14
"63277",2019,0,0,109,109
"63277",2020,0,98,155,253
"63278",2015,0,0,58,58
"63278",2017,0,0,14,14
"63278",2019,0,0,109,109
"63278",2020,0,98,155,253
"63279",2015,0,0,58,58
"63279",2017,0,0,14,14
"63279",2019,0,0,109,109
"63279",2020,0,98,103,201
"63280",2015,0,0,58,58
"63280",2017,0,0,14,14
"63280",2019,0,0,109,109
"63280",2020,0,98,155,253
"63281",2015,0,0,15,15
"63281",2019,0,0,109,109
"63281",2020,0,98,103,201
"63282",2015,0,0,58,58
"63282",2017,0,0,14,14
"63282",2019,0,0,109,109
"63282",2020,0,98,155,253
"63283",2015,0,0,58,58
"63283",2017,0,0,14,14
"63283",2019,0,0,109,109
"63283",2020,0,98,155,253
"63284",2015,0,0,58,58
"63284",2017,0,0,14,14
"63284",2019,0,0,109,109
"63284",2020,0,98,155,253
"63285",2015,0,0,58,58
"63285",2017,0,0,14,14
"63285",2019,0,0,109,109
"63285",2020,0,98,155,253
"63286",2015,0,0,58,58
"63286",2017,0,0,14,14
"63286",2019,0,0,109,109
"63286",2020,0,98,155,253
"63287",2015,0,0,58,58
"63287",2017,0,0,14,14
"63287",2019,0,0,109,109
"63287",2020,0,98,155,253
"63288",2015,0,0,58,58
"63288",2017,0,0,14,14
"63288",2019,0,0,109,109
"63288",2020,0,98,155,253
"63289",2015,0,0,58,58
"63289",2017,0,0,14,14
"63289",2019,0,0,109,109
"63289",2020,0,98,155,253
"63290",2015,0,0,58,58
"63290",2017,0,0,14,14
"63290",2019,0,0,109,109
"63290",2020,0,98,155,253
"63291",2017,0,0,14,14
"63291",2019,0,0,109,109
"63291",2020,0,98,155,253
"63292",2015,0,0,58,58
"63292",2017,0,0,14,14
"63292",2019,0,0,109,109
"63292",2020,0,98,155,253
"63293",2015,0,0,15,15
"63293",2019,0,0,109,109
"63293",2020,0,98,103,201
"63294",2015,0,0,58,58
"63294",2017,0,0,14,14
"63294",2019,0,0,109,109
"63294",2020,0,98,155,253
"63295",2015,0,0,58,58
"63295",2017,0,0,14,14
"63295",2019,0,0,109,109
"63295",2020,0,98,155,253
"63296",2015,0,0,58,58
"63296",2017,0,0,14,14
"63296",2019,0,0,109,109
"63296",2020,0,98,155,253
"63297",2015,0,0,58,58
"63297",2017,0,0,14,14
"63297",2019,0,0,109,109
"63297",2020,0,98,155,253
"63298",2017,0,0,14,14
"63298",2019,0,0,109,109
"63298",2020,0,98,155,253
"63299",2015,0,0,58,58
"63299",2017,0,0,14,14
"63299",2019,0,0,109,109
"63299",2020,0,98,155,253
"63300",2015,0,0,58,58
"63300",2017,0,0,14,14
"63300",2019,0,0,109,109
"63300",2020,0,98,155,253
"63301",2017,0,0,14,14
"63301",2019,0,0,109,109
"63301",2020,0,98,155,253
"63302",2015,0,0,58,58
"63302",2017,0,0,14,14
"63302",2019,0,0,109,109
"63302",2020,0,98,155,253
"63303",2015,0,0,58,58
"63303",2017,0,0,14,14
"63303",2019,0,0,109,109
"63303",2020,0,98,155,253
"63304",2015,0,0,15,15
"63304",2019,0,0,109,109
"63304",2020,0,98,103,201
"63305",2015,0,0,58,58
"63305",2017,0,0,14,14
"63305",2019,0,0,109,109
"63305",2020,0,98,155,253
"63306",2015,0,0,58,58
"63306",2017,0,0,14,14
"63306",2019,0,0,109,109
"63306",2020,0,98,155,253
"63307",2015,0,0,58,58
"63307",2017,0,0,14,14
"63307",2019,0,0,109,109
"63307",2020,0,98,155,253
"63308",2015,0,0,58,58
"63308",2017,0,0,14,14
"63308",2019,0,0,109,109
"63308",2020,0,98,155,253
"63309",2017,0,0,14,14
"63309",2019,0,0,109,109
"63309",2020,0,98,117,215
"63310",2017,0,0,14,14
"63310",2019,0,0,109,109
"63310",2020,0,98,155,253
"63311",2015,0,0,58,58
"63311",2017,0,0,14,14
"63311",2019,0,0,109,109
"63311",2020,0,98,155,253
"63312",2017,0,0,14,14
"63312",2019,0,0,109,109
"63312",2020,0,98,155,253
"63313",2017,0,0,14,14
"63313",2019,0,0,109,109
"63313",2020,0,98,103,201
"63314",2017,0,0,14,14
"63314",2019,0,0,109,109
"63314",2020,0,98,155,253
"63315",2015,0,0,58,58
"63315",2017,0,0,14,14
"63315",2019,0,0,109,109
"63315",2020,0,98,155,253
"63317",2015,0,0,58,58
"63317",2017,0,0,14,14
"63317",2019,0,0,109,109
"63317",2020,0,98,155,253
"63318",2015,0,0,58,58
"63318",2017,0,0,14,14
"63318",2019,0,0,109,109
"63318",2020,0,98,155,253
"63319",2017,0,0,14,14
"63319",2019,0,0,109,109
"63319",2020,0,98,117,215
"63320",2015,0,0,58,58
"63320",2017,0,0,14,14
"63320",2019,0,0,109,109
"63320",2020,0,98,155,253
"63321",2015,0,0,58,58
"63321",2017,0,0,14,14
"63321",2019,0,0,109,109
"63321",2020,0,98,155,253
"63322",2015,0,0,58,58
"63322",2017,0,0,14,14
"63322",2019,0,0,109,109
"63322",2020,0,98,155,253
"63323",2017,0,0,14,14
"63323",2019,0,0,109,109
"63323",2020,0,98,155,253
"63324",2017,0,0,14,14
"63324",2019,0,0,109,109
"63324",2020,0,98,155,253
"63325",2015,0,0,58,58
"63325",2017,0,0,14,14
"63325",2019,0,0,109,109
"63325",2020,0,98,155,253
"63326",2015,0,0,58,58
"63326",2017,0,0,14,14
"63326",2019,0,0,109,109
"63326",2020,0,98,155,253
"63327",2015,0,0,58,58
"63327",2017,0,0,14,14
"63327",2019,0,0,109,109
"63327",2020,0,98,155,253
"63328",2015,0,0,58,58
"63328",2017,0,0,14,14
"63328",2019,0,0,109,109
"63328",2020,0,98,155,253
"63329",2015,0,0,58,58
"63329",2017,0,0,14,14
"63329",2019,0,0,109,109
"63329",2020,0,98,155,253
"63330",2015,0,0,58,58
"63330",2017,0,0,14,14
"63330",2019,0,0,109,109
"63330",2020,0,98,155,253
"63331",2017,0,0,14,14
"63331",2019,0,0,109,109
"63331",2020,0,98,117,215
"63332",2015,0,0,58,58
"63332",2017,0,0,14,14
"63332",2019,0,0,109,109
"63332",2020,0,98,155,253
"63333",2015,0,0,58,58
"63333",2017,0,0,14,14
"63333",2019,0,0,109,109
"63333",2020,0,98,155,253
"63334",2017,0,0,14,14
"63334",2019,0,0,109,109
"63334",2020,0,98,155,253
"63335",2015,0,0,58,58
"63335",2017,0,0,14,14
"63335",2019,0,0,109,109
"63335",2020,0,98,155,253
"63336",2015,0,0,58,58
"63336",2017,0,0,14,14
"63336",2019,0,0,109,109
"63336",2020,0,98,103,201
"63337",2017,0,0,14,14
"63337",2019,0,0,109,109
"63337",2020,0,98,155,253
"63338",2015,0,0,15,15
"63338",2019,0,0,109,109
"63338",2020,0,98,103,201
"63339",2015,0,0,58,58
"63339",2017,0,0,14,14
"63339",2019,0,0,109,109
"63339",2020,0,98,103,201
"63340",2015,0,0,58,58
"63340",2017,0,0,14,14
"63340",2019,0,0,109,109
"63340",2020,0,98,155,253
"63341",2017,0,0,14,14
"63341",2019,0,0,109,109
"63341",2020,0,98,155,253
"63342",2015,0,0,58,58
"63342",2017,0,0,14,14
"63342",2019,0,0,109,109
"63342",2020,0,98,155,253
"63343",2017,0,0,14,14
"63343",2019,0,0,109,109
"63343",2020,0,98,155,253
"63344",2015,0,0,58,58
"63344",2017,0,0,14,14
"63344",2019,0,0,109,109
"63344",2020,0,98,155,253
"63345",2015,0,0,58,58
"63345",2017,0,0,14,14
"63345",2019,0,0,109,109
"63345",2020,0,98,155,253
"63346",2015,0,0,58,58
"63346",2017,0,0,14,14
"63346",2019,0,0,109,109
"63346",2020,0,98,103,201
"63347",2015,0,0,58,58
"63347",2017,0,0,14,14
"63347",2019,0,0,109,109
"63347",2020,0,98,155,253
"63348",2015,0,0,58,58
"63348",2017,0,0,14,14
"63348",2019,0,0,109,109
"63348",2020,0,98,155,253
"63349",2015,0,0,58,58
"63349",2017,0,0,14,14
"63349",2019,0,0,109,109
"63349",2020,0,98,155,253
"63350",2015,0,0,58,58
"63350",2017,0,0,14,14
"63350",2019,0,0,109,109
"63350",2020,0,98,155,253
"63351",2015,0,0,58,58
"63351",2017,0,0,14,14
"63351",2019,0,0,109,109
"63351",2020,0,98,103,201
"63352",2017,0,0,14,14
"63352",2019,0,0,109,109
"63352",2020,0,98,117,215
"63353",2017,0,0,14,14
"63353",2019,0,0,109,109
"63353",2020,0,98,155,253
"63354",2015,0,0,58,58
"63354",2017,0,0,14,14
"63354",2019,0,0,109,109
"63354",2020,0,98,155,253
"63355",2017,0,0,14,14
"63355",2019,0,0,109,109
"63355",2020,0,98,155,253
"63356",2017,0,0,14,14
"63356",2019,0,0,109,109
"63356",2020,0,98,117,215
"63357",2015,0,0,58,58
"63357",2017,0,0,14,14
"63357",2019,0,0,109,109
"63357",2020,0,98,155,253
"63358",2015,0,0,58,58
"63358",2017,0,0,14,14
"63358",2019,0,0,109,109
"63358",2020,0,98,155,253
"63359",2015,0,0,58,58
"63359",2017,0,0,14,14
"63359",2019,0,0,109,109
"63359",2020,0,98,155,253
"63360",2015,0,0,15,15
"63360",2019,0,0,109,109
"63360",2020,0,98,103,201
"63362",2015,0,0,58,58
"63362",2017,0,0,14,14
"63362",2019,0,0,109,109
"63362",2020,0,98,155,253
"63363",2015,0,0,58,58
"63363",2017,0,0,14,14
"63363",2019,0,0,109,109
"63363",2020,0,98,155,253
"63364",2017,0,0,14,14
"63364",2019,0,0,109,109
"63364",2020,0,98,155,253
"63365",2017,0,0,14,14
"63365",2019,0,0,109,109
"63365",2020,0,98,155,253
"63366",2015,0,0,58,58
"63366",2017,0,0,14,14
"63366",2019,0,0,109,109
"63366",2020,0,98,155,253
"63367",2015,0,0,58,58
"63367",2017,0,0,14,14
"63367",2019,0,0,109,109
"63367",2020,0,98,155,253
"63368",2015,0,0,58,58
"63368",2017,0,0,14,14
"63368",2019,0,0,109,109
"63368",2020,0,98,155,253
"63369",2015,0,0,15,15
"63369",2019,0,0,109,109
"63369",2020,0,98,103,201
"63370",2015,0,0,58,58
"63370",2017,0,0,14,14
"63370",2019,0,0,109,109
"63370",2020,0,98,103,201
"63371",2017,0,0,14,14
"63371",2019,0,0,109,109
"63371",2020,0,98,117,215
"63372",2015,0,0,58,58
"63372",2017,0,0,14,14
"63372",2019,0,0,109,109
"63372",2020,0,98,155,253
"63373",2015,0,0,15,15
"63373",2019,0,0,109,109
"63373",2020,0,98,103,201
"63374",2017,0,0,14,14
"63374",2019,0,0,109,109
"63374",2020,0,98,155,253
"63375",2015,0,0,58,58
"63375",2017,0,0,14,14
"63375",2019,0,0,109,109
"63375",2020,0,98,155,253
"63376",2015,0,0,58,58
"63376",2017,0,0,14,14
"63376",2019,0,0,109,109
"63376",2020,0,98,155,253
"63377",2015,0,0,15,15
"63377",2019,0,0,109,109
"63377",2020,0,98,103,201
"63378",2015,0,0,58,58
"63378",2017,0,0,14,14
"63378",2019,0,0,109,109
"63378",2020,0,98,155,253
"63379",2015,0,0,58,58
"63379",2017,0,0,14,14
"63379",2019,0,0,109,109
"63379",2020,0,98,155,253
"63380",2015,0,0,58,58
"63380",2017,0,0,14,14
"63380",2019,0,0,109,109
"63380",2020,0,98,155,253
"63381",2015,0,0,58,58
"63381",2017,0,0,14,14
"63381",2019,0,0,109,109
"63381",2020,0,98,155,253
"63382",2015,0,0,58,58
"63382",2017,0,0,14,14
"63382",2019,0,0,109,109
"63382",2020,0,98,155,253
"63383",2015,0,0,58,58
"63383",2017,0,0,14,14
"63383",2019,0,0,109,109
"63383",2020,0,98,155,253
"63384",2017,0,0,14,14
"63384",2019,0,0,109,109
"63384",2020,0,98,155,253
"63385",2015,0,0,58,58
"63385",2017,0,0,14,14
"63385",2019,0,0,109,109
"63385",2020,0,98,155,253
"63386",2015,0,0,58,58
"63386",2017,0,0,14,14
"63386",2019,0,0,109,109
"63386",2020,0,98,155,253
"63387",2015,0,0,58,58
"63387",2017,0,0,14,14
"63387",2019,0,0,109,109
"63387",2020,0,98,155,253
"63388",2015,0,0,58,58
"63388",2017,0,0,14,14
"63388",2019,0,0,109,109
"63388",2020,0,98,155,253
"63389",2015,0,0,58,58
"63389",2017,0,0,14,14
"63389",2019,0,0,109,109
"63389",2020,0,98,155,253
"63390",2015,0,0,58,58
"63390",2017,0,0,14,14
"63390",2019,0,0,109,109
"63390",2020,0,98,155,253
"63391",2015,0,0,58,58
"63391",2017,0,0,14,14
"63391",2019,0,0,109,109
"63391",2020,0,98,155,253
"63392",2015,0,0,58,58
"63392",2017,0,0,14,14
"63392",2019,0,0,109,109
"63392",2020,0,98,155,253
"63393",2017,0,0,14,14
"63393",2019,0,0,109,109
"63393",2020,0,98,155,253
"63394",2017,0,0,14,14
"63394",2019,0,0,109,109
"63394",2020,0,98,117,215
"63395",2015,0,0,58,58
"63395",2017,0,0,14,14
"63395",2019,0,0,109,109
"63395",2020,0,98,155,253
"63396",2015,0,0,58,58
"63396",2017,0,0,14,14
"63396",2019,0,0,109,109
"63396",2020,0,98,155,253
"63397",2015,0,0,58,58
"63397",2017,0,0,14,14
"63397",2019,0,0,109,109
"63397",2020,0,98,103,201
"63398",2017,0,0,14,14
"63398",2019,0,0,109,109
"63398",2020,0,98,155,253
"63399",2015,0,0,58,58
"63399",2017,0,0,14,14
"63399",2019,0,0,109,109
"63399",2020,0,98,103,201
"63400",2015,0,0,58,58
"63400",2017,0,0,14,14
"63400",2019,0,0,109,109
"63400",2020,0,98,155,253
"63401",2015,0,0,58,58
"63401",2017,0,0,14,14
"63401",2019,0,0,109,109
"63401",2020,0,98,155,253
"63402",2017,0,0,14,14
"63402",2019,0,0,109,109
"63402",2020,0,98,155,253
"63403",2015,0,0,58,58
"63403",2017,0,0,14,14
"63403",2019,0,0,109,109
"63403",2020,0,98,155,253
"63404",2015,0,0,58,58
"63404",2017,0,0,14,14
"63404",2019,0,0,109,109
"63404",2020,0,98,155,253
"63405",2015,0,0,58,58
"63405",2017,0,0,14,14
"63405",2019,0,0,109,109
"63405",2020,0,98,155,253
"63406",2015,0,0,58,58
"63406",2017,0,0,14,14
"63406",2019,0,0,109,109
"63406",2020,0,98,155,253
"63407",2015,0,0,58,58
"63407",2017,0,0,14,14
"63407",2019,0,0,109,109
"63407",2020,0,98,103,201
"63408",2015,0,0,58,58
"63408",2017,0,0,14,14
"63408",2019,0,0,109,109
"63408",2020,0,98,155,253
"63409",2015,0,0,58,58
"63409",2017,0,0,14,14
"63409",2019,0,0,109,109
"63409",2020,0,98,155,253
"63410",2015,0,0,58,58
"63410",2017,0,0,14,14
"63410",2019,0,0,109,109
"63410",2020,0,98,103,201
"63411",2015,0,0,58,58
"63411",2017,0,0,14,14
"63411",2019,0,0,109,109
"63411",2020,0,98,155,253
"63412",2017,0,0,14,14
"63412",2019,0,0,109,109
"63412",2020,0,98,117,215
"63413",2015,0,0,58,58
"63413",2017,0,0,14,14
"63413",2019,0,0,109,109
"63413",2020,0,98,155,253
"63414",2017,0,0,14,14
"63414",2019,0,0,109,109
"63414",2020,0,98,155,253
"63415",2015,0,0,58,58
"63415",2017,0,0,14,14
"63415",2019,0,0,109,109
"63415",2020,0,98,155,253
"63416",2015,0,0,58,58
"63416",2017,0,0,14,14
"63416",2019,0,0,109,109
"63416",2020,0,98,103,201
"63417",2015,0,0,58,58
"63417",2017,0,0,14,14
"63417",2019,0,0,109,109
"63417",2020,0,98,155,253
"63418",2017,0,0,14,14
"63418",2019,0,0,109,109
"63418",2020,0,98,155,253
"63419",2015,0,0,58,58
"63419",2017,0,0,14,14
"63419",2019,0,0,109,109
"63419",2020,0,98,155,253
"63420",2015,0,0,58,58
"63420",2017,0,0,14,14
"63420",2019,0,0,109,109
"63420",2020,0,98,155,253
"63421",2015,0,0,58,58
"63421",2017,0,0,14,14
"63421",2019,0,0,109,109
"63421",2020,0,98,103,201
"63422",2015,0,0,58,58
"63422",2017,0,0,14,14
"63422",2019,0,0,109,109
"63422",2020,0,98,155,253
"63423",2017,0,0,14,14
"63423",2019,0,0,109,109
"63423",2020,0,98,155,253
"63424",2015,0,0,58,58
"63424",2017,0,0,14,14
"63424",2019,0,0,109,109
"63424",2020,0,98,155,253
"63425",2015,0,0,58,58
"63425",2017,0,0,14,14
"63425",2019,0,0,109,109
"63425",2020,0,98,155,253
"63426",2015,0,0,58,58
"63426",2017,0,0,14,14
"63426",2019,0,0,109,109
"63426",2020,0,98,103,201
"63427",2015,0,0,58,58
"63427",2017,0,0,14,14
"63427",2019,0,0,109,109
"63427",2020,0,98,155,253
"63428",2015,0,0,15,15
"63428",2019,0,0,109,109
"63428",2020,0,98,103,201
"63429",2015,0,0,58,58
"63429",2017,0,0,14,14
"63429",2019,0,0,109,109
"63429",2020,0,98,155,253
"63430",2017,0,0,14,14
"63430",2019,0,0,109,109
"63430",2020,0,98,155,253
"63431",2017,0,0,14,14
"63431",2019,0,0,109,109
"63431",2020,0,98,155,253
"63432",2015,0,0,58,58
"63432",2017,0,0,14,14
"63432",2019,0,0,109,109
"63432",2020,0,98,155,253
"63433",2015,0,0,58,58
"63433",2017,0,0,14,14
"63433",2019,0,0,109,109
"63433",2020,0,98,103,201
"63434",2017,0,0,14,14
"63434",2019,0,0,109,109
"63434",2020,0,98,155,253
"63435",2015,0,0,58,58
"63435",2017,0,0,14,14
"63435",2019,0,0,109,109
"63435",2020,0,98,155,253
"63436",2015,0,0,58,58
"63436",2017,0,0,14,14
"63436",2019,0,0,109,109
"63436",2020,0,98,155,253
"63437",2015,0,0,58,58
"63437",2017,0,0,14,14
"63437",2019,0,0,109,109
"63437",2020,0,98,103,201
"63438",2017,0,0,14,14
"63438",2019,0,0,109,109
"63438",2020,0,98,155,253
"63439",2015,0,0,58,58
"63439",2017,0,0,14,14
"63439",2019,0,0,109,109
"63439",2020,0,98,155,253
"63440",2015,0,0,58,58
"63440",2017,0,0,14,14
"63440",2019,0,0,109,109
"63440",2020,0,98,155,253
"63441",2017,0,0,14,14
"63441",2019,0,0,109,109
"63441",2020,0,98,117,215
"63442",2015,0,0,58,58
"63442",2017,0,0,14,14
"63442",2019,0,0,109,109
"63442",2020,0,98,155,253
"63443",2015,0,0,58,58
"63443",2017,0,0,14,14
"63443",2019,0,0,109,109
"63443",2020,0,98,155,253
"63444",2015,0,0,58,58
"63444",2017,0,0,14,14
"63444",2019,0,0,109,109
"63444",2020,0,98,155,253
"63445",2015,0,0,58,58
"63445",2017,0,0,14,14
"63445",2019,0,0,109,109
"63445",2020,0,98,155,253
"63446",2015,0,0,58,58
"63446",2017,0,0,14,14
"63446",2019,0,0,109,109
"63446",2020,0,98,155,253
"63447",2015,0,0,15,15
"63447",2019,0,0,109,109
"63447",2020,0,98,103,201
"63448",2015,0,0,58,58
"63448",2017,0,0,14,14
"63448",2019,0,0,109,109
"63448",2020,0,98,155,253
"63449",2015,0,0,58,58
"63449",2017,0,0,14,14
"63449",2019,0,0,109,109
"63449",2020,0,98,155,253
"63450",2015,0,0,58,58
"63450",2017,0,0,14,14
"63450",2019,0,0,109,109
"63450",2020,0,98,103,201
"63451",2015,0,0,58,58
"63451",2017,0,0,14,14
"63451",2019,0,0,109,109
"63451",2020,0,98,155,253
"63452",2015,0,0,58,58
"63452",2017,0,0,14,14
"63452",2019,0,0,109,109
"63452",2020,0,98,155,253
"63453",2015,0,0,58,58
"63453",2017,0,0,14,14
"63453",2019,0,0,109,109
"63453",2020,0,98,155,253
"63454",2017,0,0,14,14
"63454",2019,0,0,109,109
"63454",2020,0,98,155,253
"63455",2015,0,0,58,58
"63455",2017,0,0,14,14
"63455",2019,0,0,109,109
"63455",2020,0,98,155,253
"63456",2017,0,0,14,14
"63456",2019,0,0,109,109
"63456",2020,0,98,117,215
"63457",2015,0,0,58,58
"63457",2017,0,0,14,14
"63457",2019,0,0,109,109
"63457",2020,0,98,155,253
"63458",2015,0,0,58,58
"63458",2017,0,0,14,14
"63458",2019,0,0,109,109
"63458",2020,0,98,155,253
"63459",2015,0,0,58,58
"63459",2017,0,0,14,14
"63459",2019,0,0,109,109
"63459",2020,0,98,155,253
"63460",2015,0,0,58,58
"63460",2017,0,0,14,14
"63460",2019,0,0,109,109
"63460",2020,0,98,155,253
"63461",2017,0,0,14,14
"63461",2019,0,0,109,109
"63461",2020,0,98,155,253
"63462",2015,0,0,15,15
"63462",2019,0,0,109,109
"63462",2020,0,98,103,201
"63463",2017,0,0,14,14
"63463",2019,0,0,109,109
"63463",2020,0,98,155,253
"63464",2015,0,0,58,58
"63464",2017,0,0,14,14
"63464",2019,0,0,109,109
"63464",2020,0,98,155,253
"63465",2017,0,0,14,14
"63465",2019,0,0,109,109
"63465",2020,0,98,117,215
"63466",2015,0,0,58,58
"63466",2017,0,0,14,14
"63466",2019,0,0,109,109
"63466",2020,0,98,155,253
"63467",2015,0,0,58,58
"63467",2017,0,0,14,14
"63467",2019,0,0,109,109
"63467",2020,0,98,103,201
"63468",2017,0,0,14,14
"63468",2019,0,0,109,109
"63468",2020,0,98,155,253
"63469",2017,0,0,14,14
"63469",2019,0,0,109,109
"63469",2020,0,98,155,253
"63470",2015,0,0,58,58
"63470",2017,0,0,14,14
"63470",2019,0,0,109,109
"63470",2020,0,98,155,253
"63471",2015,0,0,15,15
"63471",2019,0,0,109,109
"63471",2020,0,98,103,201
"63472",2015,0,0,58,58
"63472",2017,0,0,14,14
"63472",2019,0,0,109,109
"63472",2020,0,98,155,253
"63473",2015,0,0,58,58
"63473",2017,0,0,14,14
"63473",2019,0,0,109,109
"63473",2020,0,98,155,253
"64012",2020,0,0,24,24
"64015",2020,0,0,24,24
"64017",2020,0,0,24,24
"64034",2020,0,0,24,24
"64036",2020,0,0,24,24
"64040",2020,0,0,24,24
"64049",2020,0,0,24,24
"64071",2020,0,0,24,24
"64075",2020,0,0,18,18
"64081",2020,0,0,24,24
"64083",2020,0,0,24,24
"64096",2020,0,0,24,24
"64099",2020,0,0,18,18
"64112",2020,0,0,18,18
"64115",2020,0,0,24,24
"64149",2020,0,0,18,18
"64162",2020,0,0,24,24
"64176",2020,0,0,18,18
"64187",2020,0,0,24,24
"64202",2020,0,0,24,24
"64214",2020,0,0,24,24
"64215",2020,0,0,24,24
"64221",2020,0,0,24,24
"64222",2020,0,0,24,24
"64231",2020,0,0,24,24
"64242",2020,0,0,24,24
"64251",2020,0,0,24,24
"64258",2020,0,0,24,24
"64268",2020,0,0,24,24
"64298",2020,0,0,24,24
"64303",2020,0,0,24,24
"64310",2020,0,0,24,24
"64312",2020,0,0,18,18
"64316",2020,0,0,24,24
"64340",2020,0,0,24,24
"64341",2020,0,0,24,24
"64342",2020,0,0,24,24
"64345",2020,0,0,24,24
"64349",2020,0,0,18,18
"64381",2020,0,0,18,18
"64403",2020,0,0,24,24
"64404",2020,0,0,24,24
"64411",2020,0,0,24,24
"64412",2020,0,0,24,24
"64416",2020,0,0,18,18
"64420",2020,0,0,18,18
"64424",2020,0,0,24,24
"64428",2020,0,0,18,18
"64432",2020,0,0,24,24
"64434",2020,0,0,18,18
"64435",2020,0,0,24,24
"64440",2020,0,0,18,18
"64475",2020,0,0,24,24
"64480",2020,0,0,24,24
"64500",2020,0,0,18,18
"64512",2020,0,0,18,18
"64531",2020,0,0,24,24
"64533",2020,0,0,24,24
"64556",2020,0,0,18,18
"64559",2020,0,0,24,24
"65002",2015,0,0,24,24
"65002",2017,0,0,26,26
"65005",2015,0,0,24,24
"65005",2017,0,0,50,50
"65005",2019,0,0,45,45
"65006",2015,0,0,24,24
"65006",2017,0,0,50,50
"65006",2019,0,0,45,45
"65006",2020,0,0,27,27
"65007",2015,0,0,24,24
"65007",2017,0,0,50,50
"65010",2015,0,0,24,24
"65010",2017,0,0,50,50
"65010",2019,0,0,45,45
"65011",2015,0,0,24,24
"65011",2017,0,0,26,26
"65013",2015,0,0,24,24
"65013",2017,0,0,50,50
"65013",2019,0,0,45,45
"65013",2020,0,0,27,27
"65016",2015,0,0,24,24
"65016",2017,0,0,50,50
"65016",2019,0,0,45,45
"65019",2015,0,0,24,24
"65019",2017,0,0,50,50
"65020",2015,0,0,24,24
"65020",2017,0,0,26,26
"65026",2020,0,0,76,76
"65028",2020,0,0,76,76
"65031",2015,0,0,24,24
"65031",2017,0,0,50,50
"65031",2019,0,0,45,45
"65031",2020,0,0,27,27
"65033",2015,0,0,24,24
"65033",2017,0,0,50,50
"65035",2015,0,0,24,24
"65035",2017,0,0,50,50
"65035",2019,0,0,45,45
"65035",2020,0,0,27,27
"65038",2015,0,0,24,24
"65038",2017,0,0,26,26
"65039",2015,0,0,24,24
"65039",2017,0,0,50,50
"65039",2019,0,0,45,45
"65039",2020,0,0,27,27
"65041",2015,0,0,24,24
"65041",2017,0,0,50,50
"65041",2019,0,0,45,45
"65042",2015,0,0,24,24
"65042",2017,0,0,50,50
"65042",2019,0,0,45,45
"65043",2015,0,0,24,24
"65043",2017,0,0,50,50
"65046",2015,0,0,24,24
"65046",2017,0,0,50,50
"65046",2019,0,0,45,45
"65046",2020,0,0,27,27
"65047",2015,0,0,24,24
"65047",2017,0,0,50,50
"65047",2019,0,0,45,45
"65047",2020,0,0,27,27
"65048",2015,0,0,24,24
"65048",2017,0,0,50,50
"65049",2015,0,0,24,24
"65049",2017,0,0,50,50
"65049",2019,0,0,45,45
"65052",2015,0,0,24,24
"65052",2017,0,0,26,26
"65054",2020,0,0,61,61
"65057",2015,0,0,24,24
"65057",2017,0,0,26,26
"65059",2015,0,0,24,24
"65059",2017,0,0,50,50
"65059",2019,0,0,45,45
"65061",2015,0,0,24,24
"65061",2017,0,0,50,50
"65061",2019,0,0,45,45
"65062",2015,0,0,24,24
"65062",2017,0,0,50,50
"65062",2019,0,0,45,45
"65063",2015,0,0,24,24
"65063",2017,0,0,50,50
"65063",2019,0,0,45,45
"65066",2015,0,0,24,24
"65066",2017,0,0,50,50
"65066",2019,0,0,45,45
"65066",2020,0,0,27,27
"65067",2015,0,0,24,24
"65067",2017,0,0,26,26
"65068",2020,0,0,76,76
"65069",2020,0,0,76,76
"65070",2015,0,0,24,24
"65070",2017,0,0,26,26
"65072",2015,0,0,24,24
"65072",2017,0,0,50,50
"65073",2015,0,0,24,24
"65073",2017,0,0,50,50
"65073",2019,0,0,45,45
"65073",2020,0,0,27,27
"65074",2020,0,0,76,76
"65077",2015,0,0,24,24
"65077",2017,0,0,50,50
"65077",2019,0,0,45,45
"65077",2020,0,0,27,27
"65078",2015,0,0,24,24
"65078",2017,0,0,50,50
"65078",2019,0,0,45,45
"65078",2020,0,0,27,27
"65079",2020,0,0,61,61
"65080",2015,0,0,24,24
"65080",2017,0,0,26,26
"65083",2015,0,0,24,24
"65083",2017,0,0,50,50
"65083",2019,0,0,45,45
"65083",2020,0,0,27,27
"65084",2015,0,0,24,24
"65084",2017,0,0,50,50
"65084",2019,0,0,45,45
"65085",2020,0,0,76,76
"65086",2020,0,0,61,61
"65088",2020,0,0,76,76
"65090",2020,0,0,76,76
"65092",2015,0,0,24,24
"65092",2017,0,0,50,50
"65092",2019,0,0,45,45
"65095",2020,0,0,76,76
"65097",2020,0,0,76,76
"65100",2015,0,0,24,24
"65100",2017,0,0,50,50
"65104",2015,0,0,24,24
"65104",2017,0,0,50,50
"65104",2019,0,0,45,45
"65104",2020,0,0,27,27
"65107",2015,0,0,24,24
"65107",2017,0,0,26,26
"65108",2015,0,0,24,24
"65108",2017,0,0,50,50
"65108",2019,0,0,45,45
"65108",2020,0,0,27,27
"65110",2020,0,0,76,76
"65113",2020,0,0,61,61
"65116",2015,0,0,24,24
"65116",2017,0,0,50,50
"65116",2019,0,0,45,45
"65116",2020,0,0,27,27
"65119",2015,0,0,24,24
"65119",2017,0,0,26,26
"65120",2015,0,0,24,24
"65120",2017,0,0,50,50
"65120",2019,0,0,45,45
"65121",2015,0,0,24,24
"65121",2017,0,0,50,50
"65123",2015,0,0,24,24
"65123",2017,0,0,50,50
"65123",2019,0,0,45,45
"65123",2020,0,0,27,27
"65125",2020,0,0,76,76
"65126",2020,0,0,76,76
"65127",2020,0,0,61,61
"65128",2020,0,0,76,76
"65129",2020,0,0,76,76
"65130",2015,0,0,56,56
"65130",2017,0,0,50,50
"65130",2019,0,0,45,45
"65130",2020,0,0,27,27
"65133",2015,0,0,24,24
"65133",2017,0,0,50,50
"65133",2019,0,0,45,45
"65134",2020,0,0,76,76
"65136",2020,0,0,76,76
"65137",2015,0,0,24,24
"65137",2017,0,0,50,50
"65137",2019,0,0,45,45
"65137",2020,0,0,27,27
"65144",2015,0,0,24,24
"65144",2017,0,0,26,26
"65146",2015,0,0,24,24
"65146",2017,0,0,50,50
"65146",2019,0,0,45,45
"65146",2020,0,0,27,27
"65148",2020,0,0,76,76
"65150",2020,0,0,76,76
"65155",2020,0,0,76,76
"65156",2015,0,0,24,24
"65156",2017,0,0,50,50
"65156",2019,0,0,45,45
"65156",2020,0,0,27,27
"65159",2020,0,0,76,76
"65161",2015,0,0,24,24
"65161",2017,0,0,50,50
"65161",2019,0,0,45,45
"65161",2020,0,0,27,27
"65164",2015,0,0,24,24
"65164",2017,0,0,26,26
"65165",2015,0,0,24,24
"65165",2017,0,0,50,50
"65165",2019,0,0,45,45
"65174",2015,0,0,24,24
"65174",2017,0,0,50,50
"65174",2019,0,0,45,45
"65174",2020,0,0,27,27
"65177",2020,0,0,76,76
"65183",2020,0,0,76,76
"65184",2020,0,0,76,76
"65187",2020,0,0,76,76
"65189",2015,0,0,24,24
"65189",2017,0,0,26,26
"65191",2015,0,0,24,24
"65191",2017,0,0,50,50
"65191",2019,0,0,45,45
"65191",2020,0,0,27,27
"65196",2015,0,0,24,24
"65196",2017,0,0,50,50
"65196",2019,0,0,45,45
"65196",2020,0,0,27,27
"65198",2015,0,0,24,24
"65198",2017,0,0,50,50
"65198",2019,0,0,45,45
"65200",2015,0,0,24,24
"65200",2017,0,0,50,50
"65203",2015,0,0,24,24
"65203",2017,0,0,26,26
"65213",2020,0,0,76,76
"65214",2020,0,0,76,76
"65219",2015,0,0,69,69
"65219",2017,0,0,50,50
"65219",2019,0,0,45,45
"65219",2020,0,0,27,27
"65220",2015,0,0,24,24
"65220",2017,0,0,26,26
"65221",2015,0,0,24,24
"65221",2017,0,0,50,50
"65223",2015,0,0,24,24
"65223",2017,0,0,50,50
"65224",2020,0,0,76,76
"65225",2015,0,0,24,24
"65225",2017,0,0,50,50
"65225",2019,0,0,45,45
"65226",2015,0,0,24,24
"65226",2017,0,0,26,26
"65233",2015,0,0,24,24
"65233",2017,0,0,26,26
"65235",2015,0,0,24,24
"65235",2017,0,0,26,26
"65236",2015,0,0,24,24
"65236",2017,0,0,26,26
"65237",2015,0,0,24,24
"65237",2017,0,0,26,26
"65238",2015,0,0,24,24
"65238",2017,0,0,50,50
"65238",2019,0,0,45,45
"65238",2020,0,0,27,27
"65240",2015,0,0,69,69
"65240",2017,0,0,50,50
"65240",2019,0,0,45,45
"65242",2015,0,0,24,24
"65242",2017,0,0,50,50
"65242",2019,0,0,45,45
"65243",2015,0,0,24,24
"65243",2017,0,0,50,50
"65243",2019,0,0,45,45
"65243",2020,0,0,27,27
"65244",2015,0,0,24,24
"65244",2017,0,0,26,26
"65245",2020,0,0,76,76
"65247",2015,0,0,24,24
"65247",2017,0,0,26,26
"65249",2020,0,0,76,76
"65250",2020,0,0,76,76
"65251",2015,0,0,24,24
"65251",2017,0,0,50,50
"65257",2015,0,0,24,24
"65257",2017,0,0,26,26
"65258",2020,0,0,76,76
"65259",2015,0,0,24,24
"65259",2017,0,0,50,50
"65259",2019,0,0,45,45
"65260",2020,0,0,76,76
"65261",2020,0,0,76,76
"65262",2015,0,0,24,24
"65262",2017,0,0,26,26
"65263",2020,0,0,76,76
"65265",2015,0,0,24,24
"65265",2017,0,0,50,50
"65265",2019,0,0,45,45
"65266",2020,0,0,76,76
"65268",2015,0,0,24,24
"65268",2017,0,0,26,26
"65269",2015,0,0,24,24
"65269",2017,0,0,50,50
"65269",2019,0,0,45,45
"65270",2015,0,0,24,24
"65270",2017,0,0,50,50
"65270",2019,0,0,45,45
"65271",2015,0,0,24,24
"65271",2017,0,0,26,26
"65273",2015,0,0,24,24
"65273",2017,0,0,50,50
"65273",2019,0,0,45,45
"65273",2020,0,0,27,27
"65274",2020,0,0,76,76
"65276",2015,0,0,24,24
"65276",2017,0,0,50,50
"65276",2019,0,0,45,45
"65281",2015,0,0,24,24
"65281",2017,0,0,50,50
"65284",2015,0,0,24,24
"65284",2017,0,0,26,26
"65285",2015,0,0,24,24
"65285",2017,0,0,50,50
"65285",2019,0,0,45,45
"65286",2015,0,0,24,24
"65286",2017,0,0,26,26
"65293",2020,0,0,76,76
"65294",2020,0,0,61,61
"65299",2015,0,0,24,24
"65299",2017,0,0,50,50
"65299",2019,0,0,45,45
"65299",2020,0,0,27,27
"65304",2015,0,0,24,24
"65304",2017,0,0,50,50
"65313",2015,0,0,24,24
"65313",2017,0,0,50,50
"65314",2015,0,0,24,24
"65314",2017,0,0,50,50
"65314",2019,0,0,45,45
"65315",2020,0,0,76,76
"65316",2020,0,0,76,76
"65318",2020,0,0,76,76
"65320",2015,0,0,24,24
"65320",2017,0,0,50,50
"65328",2015,0,0,24,24
"65328",2017,0,0,50,50
"65330",2015,0,0,24,24
"65330",2017,0,0,50,50
"65331",2015,0,0,24,24
"65331",2017,0,0,26,26
"65332",2015,0,0,24,24
"65332",2017,0,0,50,50
"65332",2019,0,0,45,45
"65332",2020,0,0,27,27
"65335",2015,0,0,24,24
"65335",2017,0,0,50,50
"65335",2019,0,0,45,45
"65336",2020,0,0,76,76
"65337",2020,0,0,61,61
"65339",2015,0,0,24,24
"65339",2017,0,0,26,26
"65340",2015,0,0,24,24
"65340",2017,0,0,50,50
"65340",2019,0,0,45,45
"65340",2020,0,0,27,27
"65341",2015,0,0,24,24
"65341",2017,0,0,26,26
"65344",2015,0,0,24,24
"65344",2017,0,0,26,26
"65345",2015,0,0,24,24
"65345",2017,0,0,26,26
"65350",2015,0,0,24,24
"65350",2017,0,0,26,26
"65355",2015,0,0,24,24
"65355",2017,0,0,26,26
"65358",2020,0,0,76,76
"65363",2020,0,0,76,76
"65364",2015,0,0,24,24
"65364",2017,0,0,26,26
"65368",2020,0,0,76,76
"65369",2015,0,0,24,24
"65369",2017,0,0,50,50
"65369",2019,0,0,45,45
"65370",2015,0,0,24,24
"65370",2017,0,0,50,50
"65370",2019,0,0,45,45
"65372",2015,0,0,24,24
"65372",2017,0,0,50,50
"65373",2020,0,0,76,76
"65374",2020,0,0,76,76
"65375",2015,0,0,24,24
"65375",2017,0,0,50,50
"65375",2019,0,0,45,45
"65376",2020,0,0,76,76
"65377",2020,0,0,76,76
"65380",2015,0,0,24,24
"65380",2017,0,0,50,50
"65380",2019,0,0,45,45
"65381",2020,0,0,76,76
"65383",2020,0,0,76,76
"65386",2015,0,0,24,24
"65386",2017,0,0,26,26
"65390",2015,0,0,24,24
"65390",2017,0,0,26,26
"65392",2015,0,0,24,24
"65392",2017,0,0,50,50
"65401",2015,0,0,24,24
"65401",2017,0,0,50,50
"65401",2019,0,0,45,45
"65401",2020,0,0,27,27
"65403",2015,0,0,24,24
"65403",2017,0,0,26,26
"65404",2020,0,0,76,76
"65406",2015,0,0,24,24
"65406",2017,0,0,50,50
"65409",2015,0,0,24,24
"65409",2017,0,0,50,50
"65409",2019,0,0,45,45
"65409",2020,0,0,27,27
"65410",2015,0,0,24,24
"65410",2017,0,0,50,50
"65410",2019,0,0,45,45
"65410",2020,0,0,27,27
"65412",2015,0,0,24,24
"65412",2017,0,0,50,50
"65412",2019,0,0,45,45
"65414",2015,0,0,24,24
"65414",2017,0,0,50,50
"65414",2019,0,0,45,45
"65417",2015,0,0,24,24
"65417",2017,0,0,50,50
"65417",2019,0,0,45,45
"65417",2020,0,0,27,27
"65419",2020,0,0,76,76
"65421",2015,0,0,24,24
"65421",2017,0,0,26,26
"65424",2015,0,0,24,24
"65424",2017,0,0,50,50
"65424",2019,0,0,45,45
"65424",2020,0,0,27,27
"65425",2015,0,0,24,24
"65425",2017,0,0,26,26
"65429",2015,0,0,24,24
"65429",2017,0,0,50,50
"65430",2015,0,0,24,24
"65430",2017,0,0,50,50
"65430",2019,0,0,45,45
"65433",2015,0,0,24,24
"65433",2017,0,0,50,50
"65433",2019,0,0,45,45
"65433",2020,0,0,27,27
"65436",2015,0,0,24,24
"65436",2017,0,0,50,50
"65436",2019,0,0,45,45
"65437",2020,0,0,76,76
"65438",2015,0,0,24,24
"65438",2017,0,0,26,26
"65439",2015,0,0,24,24
"65439",2017,0,0,26,26
"65440",2015,0,0,24,24
"65440",2017,0,0,50,50
"65442",2020,0,0,76,76
"65445",2020,0,0,61,61
"65446",2015,0,0,24,24
"65446",2017,0,0,50,50
"65446",2019,0,0,45,45
"65446",2020,0,0,27,27
"65448",2020,0,0,76,76
"65449",2020,0,0,76,76
"65451",2015,0,0,24,24
"65451",2017,0,0,50,50
"65451",2019,0,0,45,45
"65451",2020,0,0,27,27
"65452",2020,0,0,76,76
"65456",2020,0,0,76,76
"65457",2015,0,0,24,24
"65457",2017,0,0,50,50
"65457",2019,0,0,45,45
"65457",2020,0,0,27,27
"65460",2015,0,0,24,24
"65460",2017,0,0,50,50
"65461",2020,0,0,76,76
"65464",2015,0,0,24,24
"65464",2017,0,0,50,50
"65464",2019,0,0,45,45
"65465",2015,0,0,24,24
"65465",2017,0,0,50,50
"65465",2019,0,0,45,45
"65465",2020,0,0,27,27
"65468",2020,0,0,76,76
"65474",2020,0,0,76,76
"65475",2020,0,0,76,76
"65477",2015,0,0,24,24
"65477",2017,0,0,50,50
"65477",2019,0,0,45,45
"65477",2020,0,0,27,27
"65479",2015,0,0,24,24
"65479",2017,0,0,26,26
"65481",2015,0,0,24,24
"65481",2017,0,0,50,50
"65481",2019,0,0,45,45
"65481",2020,0,0,27,27
"66001",2018,0,0,63,63
"66001",2019,0,0,72,72
"66002",2019,0,0,200,200
"66003",2018,0,0,63,63
"66003",2019,0,0,72,72
"66004",2019,0,0,151,151
"66005",2019,0,0,151,151
"66006",2019,0,0,35,35
"66007",2019,0,0,35,35
"66008",2018,0,0,63,63
"66008",2019,0,0,72,72
"66009",2018,0,0,63,63
"66009",2019,0,0,72,72
"66010",2019,0,0,200,200
"66011",2018,0,0,63,63
"66011",2019,0,0,72,72
"66012",2019,0,0,35,35
"66013",2019,0,0,200,200
"66014",2019,0,0,35,35
"66015",2018,0,0,63,63
"66015",2019,0,0,72,72
"66016",2018,0,0,63,63
"66016",2019,0,0,72,72
"66017",2019,0,0,35,35
"66018",2018,0,0,63,63
"66018",2019,0,0,72,72
"66019",2019,0,0,35,35
"66020",2019,0,0,151,151
"66021",2019,0,0,35,35
"66022",2019,0,0,200,200
"66023",2019,0,0,200,200
"66024",2018,0,0,63,63
"66024",2019,0,0,72,72
"66025",2019,0,0,151,151
"66026",2018,0,0,63,63
"66026",2019,0,0,72,72
"66027",2019,0,0,151,151
"66028",2019,0,0,200,200
"66029",2019,0,0,200,200
"66030",2019,0,0,35,35
"66032",2018,0,0,63,63
"66032",2019,0,0,72,72
"66033",2019,0,0,200,200
"66034",2019,0,0,200,200
"66035",2019,0,0,35,35
"66036",2019,0,0,200,200
"66037",2019,0,0,35,35
"66038",2019,0,0,200,200
"66039",2019,0,0,35,35
"66040",2019,0,0,200,200
"66041",2019,0,0,35,35
"66042",2019,0,0,35,35
"66043",2018,0,0,63,63
"66043",2019,0,0,72,72
"66044",2019,0,0,200,200
"66045",2019,0,0,200,200
"66046",2019,0,0,35,35
"66047",2019,0,0,200,200
"66048",2018,0,0,63,63
"66048",2019,0,0,72,72
"66049",2018,0,0,63,63
"66049",2019,0,0,72,72
"66050",2019,0,0,35,35
"66051",2019,0,0,200,200
"66052",2019,0,0,200,200
"66053",2018,0,0,63,63
"66053",2019,0,0,72,72
"66054",2019,0,0,200,200
"66055",2019,0,0,200,200
"66056",2019,0,0,200,200
"66057",2019,0,0,200,200
"66058",2019,0,0,35,35
"66059",2019,0,0,200,200
"66060",2018,0,0,63,63
"66060",2019,0,0,72,72
"66061",2018,0,0,63,63
"66061",2019,0,0,72,72
"66062",2019,0,0,151,151
"66063",2018,0,0,63,63
"66063",2019,0,0,72,72
"66064",2019,0,0,151,151
"66065",2018,0,0,63,63
"66065",2019,0,0,72,72
"66066",2019,0,0,151,151
"66067",2019,0,0,151,151
"66068",2019,0,0,200,200
"66069",2019,0,0,35,35
"66070",2019,0,0,200,200
"66071",2019,0,0,35,35
"66072",2019,0,0,151,151
"66073",2019,0,0,200,200
"66074",2019,0,0,35,35
"66075",2019,0,0,151,151
"66076",2019,0,0,35,35
"66077",2019,0,0,35,35
"66078",2019,0,0,200,200
"66079",2019,0,0,200,200
"66080",2019,0,0,151,151
"66081",2019,0,0,172,172
"66082",2019,0,0,151,151
"66083",2019,0,0,35,35
"66084",2019,0,0,200,200
"66085",2019,0,0,200,200
"66086",2019,0,0,200,200
"66088",2019,0,0,200,200
"66089",2019,0,0,200,200
"66090",2019,0,0,200,200
"66091",2018,0,0,63,63
"66091",2019,0,0,72,72
"66092",2019,0,0,35,35
"66093",2018,0,0,63,63
"66093",2019,0,0,72,72
"66094",2019,0,0,200,200
"66095",2019,0,0,151,151
"66096",2019,0,0,35,35
"66097",2019,0,0,35,35
"66098",2019,0,0,151,151
"66099",2018,0,0,63,63
"66099",2019,0,0,72,72
"66100",2019,0,0,151,151
"66101",2019,0,0,200,200
"66102",2018,0,0,63,63
"66102",2019,0,0,72,72
"66103",2019,0,0,200,200
"66104",2019,0,0,200,200
"66105",2019,0,0,200,200
"66106",2018,0,0,63,63
"66106",2019,0,0,72,72
"66107",2019,0,0,35,35
"66108",2019,0,0,35,35
"66109",2019,0,0,35,35
"66111",2019,0,0,35,35
"66112",2018,0,0,63,63
"66112",2019,0,0,72,72
"66113",2018,0,0,63,63
"66113",2019,0,0,72,72
"66114",2019,0,0,200,200
"66115",2018,0,0,63,63
"66115",2019,0,0,72,72
"66116",2018,0,0,63,63
"66116",2019,0,0,72,72
"66117",2019,0,0,200,200
"66118",2019,0,0,35,35
"66119",2019,0,0,35,35
"66120",2019,0,0,151,151
"66121",2019,0,0,200,200
"66122",2019,0,0,200,200
"66123",2019,0,0,200,200
"66124",2019,0,0,151,151
"66125",2019,0,0,200,200
"66126",2018,0,0,63,63
"66126",2019,0,0,72,72
"66127",2019,0,0,35,35
"66128",2019,0,0,200,200
"66129",2018,0,0,63,63
"66129",2019,0,0,72,72
"66130",2019,0,0,151,151
"66132",2019,0,0,151,151
"66133",2018,0,0,63,63
"66133",2019,0,0,72,72
"66134",2018,0,0,63,63
"66134",2019,0,0,72,72
"66136",2019,0,0,35,35
"66137",2018,0,0,63,63
"66137",2019,0,0,72,72
"66138",2019,0,0,35,35
"66139",2019,0,0,35,35
"66140",2019,0,0,35,35
"66141",2019,0,0,35,35
"66142",2019,0,0,151,151
"66143",2019,0,0,35,35
"66144",2019,0,0,200,200
"66145",2019,0,0,200,200
"66146",2019,0,0,151,151
"66147",2019,0,0,151,151
"66148",2018,0,0,63,63
"66148",2019,0,0,72,72
"66149",2019,0,0,200,200
"66150",2018,0,0,63,63
"66150",2019,0,0,72,72
"66151",2019,0,0,35,35
"66152",2019,0,0,35,35
"66153",2018,0,0,63,63
"66153",2019,0,0,72,72
"66154",2019,0,0,172,172
"66155",2018,0,0,63,63
"66155",2019,0,0,72,72
"66156",2019,0,0,35,35
"66157",2019,0,0,200,200
"66158",2019,0,0,35,35
"66159",2019,0,0,200,200
"66160",2018,0,0,63,63
"66160",2019,0,0,72,72
"66161",2019,0,0,200,200
"66162",2019,0,0,200,200
"66164",2019,0,0,35,35
"66165",2019,0,0,200,200
"66166",2019,0,0,200,200
"66167",2019,0,0,151,151
"66168",2018,0,0,63,63
"66168",2019,0,0,72,72
"66169",2019,0,0,35,35
"66170",2019,0,0,200,200
"66171",2019,0,0,200,200
"66172",2019,0,0,35,35
"66173",2019,0,0,200,200
"66174",2019,0,0,200,200
"66175",2018,0,0,63,63
"66175",2019,0,0,72,72
"66176",2019,0,0,35,35
"66177",2018,0,0,63,63
"66177",2019,0,0,72,72
"66178",2018,0,0,63,63
"66178",2019,0,0,72,72
"66179",2018,0,0,63,63
"66179",2019,0,0,72,72
"66180",2019,0,0,35,35
"66181",2019,0,0,151,151
"66182",2019,0,0,35,35
"66183",2018,0,0,63,63
"66183",2019,0,0,72,72
"66184",2019,0,0,35,35
"66185",2019,0,0,200,200
"66186",2019,0,0,200,200
"66187",2019,0,0,35,35
"66188",2019,0,0,151,151
"66189",2019,0,0,200,200
"66190",2019,0,0,35,35
"66191",2019,0,0,200,200
"66192",2019,0,0,200,200
"66193",2019,0,0,200,200
"66194",2018,0,0,63,63
"66194",2019,0,0,72,72
"66195",2019,0,0,200,200
"66196",2018,0,0,63,63
"66196",2019,0,0,72,72
"66197",2019,0,0,200,200
"66198",2019,0,0,35,35
"66199",2018,0,0,63,63
"66199",2019,0,0,72,72
"66201",2019,0,0,35,35
"66202",2019,0,0,151,151
"66203",2018,0,0,63,63
"66203",2019,0,0,72,72
"66204",2019,0,0,200,200
"66205",2019,0,0,35,35
"66206",2018,0,0,63,63
"66206",2019,0,0,72,72
"66207",2019,0,0,200,200
"66208",2019,0,0,200,200
"66209",2019,0,0,200,200
"66210",2019,0,0,200,200
"66211",2019,0,0,200,200
"66212",2019,0,0,35,35
"66213",2019,0,0,200,200
"66214",2018,0,0,63,63
"66214",2019,0,0,72,72
"66215",2019,0,0,35,35
"66216",2019,0,0,35,35
"66217",2019,0,0,200,200
"66218",2019,0,0,151,151
"66219",2019,0,0,200,200
"66220",2019,0,0,151,151
"66221",2018,0,0,63,63
"66221",2019,0,0,72,72
"66222",2019,0,0,200,200
"66223",2019,0,0,200,200
"66224",2019,0,0,35,35
"66225",2018,0,0,63,63
"66225",2019,0,0,72,72
"66226",2018,0,0,63,63
"66226",2019,0,0,72,72
"66227",2019,0,0,200,200
"66228",2019,0,0,35,35
"66230",2019,0,0,200,200
"66231",2019,0,0,35,35
"66232",2019,0,0,35,35
"66233",2018,0,0,63,63
"66233",2019,0,0,72,72
"66234",2019,0,0,35,35
"67001",2017,0,0,136,136
"67001",2020,0,0,11,11
"67002",2017,0,0,136,136
"67002",2020,0,0,15,15
"67003",2017,0,0,136,136
"67003",2020,0,0,11,11
"67004",2017,0,0,136,136
"67004",2020,0,0,11,11
"67005",2017,0,0,136,136
"67005",2020,0,0,11,11
"67006",2017,0,0,136,136
"67006",2020,0,0,11,11
"67008",2017,0,0,136,136
"67008",2020,0,0,11,11
"67009",2017,0,0,136,136
"67009",2020,0,0,15,15
"67010",2017,0,0,136,136
"67010",2020,0,0,11,11
"67011",2017,0,0,136,136
"67011",2020,0,0,11,11
"67012",2017,0,0,136,136
"67012",2020,0,0,11,11
"67013",2017,0,0,136,136
"67013",2020,0,0,15,15
"67016",2017,0,0,136,136
"67016",2020,0,0,11,11
"67017",2017,0,0,136,136
"67017",2020,0,0,15,15
"67018",2017,0,0,136,136
"67018",2020,0,0,11,11
"67019",2017,0,0,136,136
"67019",2020,0,0,11,11
"67020",2017,0,0,136,136
"67020",2020,0,0,11,11
"67021",2017,0,0,136,136
"67021",2020,0,0,11,11
"67022",2017,0,0,136,136
"67022",2020,0,0,11,11
"67023",2017,0,0,136,136
"67023",2020,0,0,11,11
"67025",2017,0,0,136,136
"67025",2020,0,0,11,11
"67026",2017,0,0,136,136
"67026",2020,0,0,11,11
"67027",2017,0,0,136,136
"67027",2020,0,0,11,11
"67028",2017,0,0,136,136
"67028",2020,0,0,11,11
"67029",2017,0,0,136,136
"67029",2020,0,0,15,15
"67030",2017,0,0,136,136
"67030",2020,0,0,11,11
"67031",2017,0,0,136,136
"67031",2020,0,0,11,11
"67032",2017,0,0,136,136
"67032",2020,0,0,11,11
"67033",2017,0,0,136,136
"67033",2020,0,0,11,11
"67034",2017,0,0,136,136
"67034",2020,0,0,11,11
"67035",2017,0,0,136,136
"67035",2020,0,0,11,11
"67036",2017,0,0,136,136
"67036",2020,0,0,15,15
"67037",2017,0,0,136,136
"67037",2020,0,0,11,11
"67038",2017,0,0,136,136
"67038",2020,0,0,11,11
"67039",2017,0,0,136,136
"67039",2020,0,0,11,11
"67040",2017,0,0,136,136
"67040",2020,0,0,11,11
"67043",2017,0,0,136,136
"67043",2020,0,0,11,11
"67044",2017,0,0,136,136
"67044",2020,0,0,11,11
"67045",2017,0,0,136,136
"67045",2020,0,0,11,11
"67046",2017,0,0,136,136
"67046",2020,0,0,11,11
"67047",2017,0,0,136,136
"67047",2020,0,0,15,15
"67048",2017,0,0,136,136
"67048",2020,0,0,11,11
"67049",2017,0,0,136,136
"67049",2020,0,0,11,11
"67050",2017,0,0,136,136
"67050",2020,0,0,11,11
"67051",2017,0,0,136,136
"67051",2020,0,0,11,11
"67052",2017,0,0,136,136
"67052",2020,0,0,11,11
"67053",2017,0,0,136,136
"67053",2020,0,0,11,11
"67054",2017,0,0,136,136
"67054",2020,0,0,11,11
"67055",2017,0,0,136,136
"67055",2020,0,0,11,11
"67056",2017,0,0,136,136
"67056",2020,0,0,11,11
"67057",2017,0,0,136,136
"67057",2020,0,0,11,11
"67058",2017,0,0,136,136
"67058",2020,0,0,11,11
"67059",2017,0,0,136,136
"67059",2020,0,0,11,11
"67060",2017,0,0,136,136
"67060",2020,0,0,11,11
"67061",2017,0,0,136,136
"67061",2020,0,0,11,11
"67062",2017,0,0,136,136
"67062",2020,0,0,11,11
"67063",2017,0,0,136,136
"67063",2020,0,0,11,11
"67065",2017,0,0,136,136
"67065",2020,0,0,11,11
"67066",2017,0,0,136,136
"67066",2020,0,0,11,11
"67067",2017,0,0,136,136
"67067",2020,0,0,11,11
"67068",2017,0,0,136,136
"67068",2020,0,0,11,11
"67069",2017,0,0,136,136
"67069",2020,0,0,11,11
"67070",2017,0,0,136,136
"67070",2020,0,0,15,15
"67071",2017,0,0,136,136
"67071",2020,0,0,15,15
"67072",2017,0,0,136,136
"67072",2020,0,0,15,15
"67073",2017,0,0,136,136
"67073",2020,0,0,11,11
"67074",2017,0,0,136,136
"67074",2020,0,0,11,11
"67075",2017,0,0,136,136
"67075",2020,0,0,11,11
"67076",2017,0,0,136,136
"67076",2020,0,0,11,11
"67077",2017,0,0,136,136
"67077",2020,0,0,11,11
"67078",2017,0,0,136,136
"67078",2020,0,0,11,11
"67079",2017,0,0,136,136
"67079",2020,0,0,11,11
"67080",2017,0,0,136,136
"67080",2020,0,0,11,11
"67081",2017,0,0,136,136
"67081",2020,0,0,11,11
"67082",2017,0,0,136,136
"67082",2020,0,0,11,11
"67083",2017,0,0,136,136
"67083",2020,0,0,11,11
"67084",2017,0,0,136,136
"67084",2020,0,0,11,11
"67085",2017,0,0,136,136
"67085",2020,0,0,11,11
"67086",2017,0,0,136,136
"67086",2020,0,0,11,11
"67087",2017,0,0,136,136
"67087",2020,0,0,11,11
"67088",2017,0,0,136,136
"67088",2020,0,0,15,15
"67089",2017,0,0,136,136
"67089",2020,0,0,11,11
"67090",2017,0,0,136,136
"67090",2020,0,0,11,11
"67091",2017,0,0,136,136
"67091",2020,0,0,15,15
"67092",2017,0,0,136,136
"67092",2020,0,0,11,11
"67093",2017,0,0,136,136
"67093",2020,0,0,11,11
"67094",2017,0,0,136,136
"67094",2020,0,0,11,11
"67095",2017,0,0,136,136
"67095",2020,0,0,15,15
"67096",2017,0,0,136,136
"67096",2020,0,0,11,11
"67097",2017,0,0,136,136
"67097",2020,0,0,11,11
"67098",2017,0,0,136,136
"67098",2020,0,0,11,11
"67099",2017,0,0,136,136
"67099",2020,0,0,15,15
"67100",2017,0,0,136,136
"67100",2020,0,0,11,11
"67101",2017,0,0,136,136
"67101",2020,0,0,11,11
"67102",2017,0,0,136,136
"67102",2020,0,0,11,11
"67103",2017,0,0,136,136
"67103",2020,0,0,11,11
"67104",2017,0,0,136,136
"67104",2020,0,0,11,11
"67105",2017,0,0,136,136
"67105",2020,0,0,15,15
"67106",2017,0,0,136,136
"67106",2020,0,0,11,11
"67107",2017,0,0,136,136
"67107",2020,0,0,11,11
"67108",2017,0,0,136,136
"67108",2020,0,0,11,11
"67109",2017,0,0,136,136
"67109",2020,0,0,11,11
"67110",2017,0,0,136,136
"67110",2020,0,0,11,11
"67111",2017,0,0,136,136
"67111",2020,0,0,15,15
"67112",2017,0,0,136,136
"67112",2020,0,0,11,11
"67113",2017,0,0,136,136
"67113",2020,0,0,11,11
"67115",2017,0,0,136,136
"67115",2020,0,0,11,11
"67116",2017,0,0,136,136
"67116",2020,0,0,11,11
"67117",2017,0,0,136,136
"67117",2020,0,0,11,11
"67118",2017,0,0,136,136
"67118",2020,0,0,11,11
"67119",2017,0,0,136,136
"67119",2020,0,0,11,11
"67120",2017,0,0,136,136
"67120",2020,0,0,11,11
"67121",2017,0,0,136,136
"67121",2020,0,0,11,11
"67122",2017,0,0,136,136
"67122",2020,0,0,11,11
"67123",2017,0,0,136,136
"67123",2020,0,0,11,11
"67124",2017,0,0,136,136
"67124",2020,0,0,11,11
"67125",2017,0,0,136,136
"67125",2020,0,0,11,11
"67126",2017,0,0,136,136
"67126",2020,0,0,15,15
"67127",2017,0,0,136,136
"67127",2020,0,0,11,11
"67128",2017,0,0,136,136
"67128",2020,0,0,11,11
"67129",2017,0,0,136,136
"67129",2020,0,0,11,11
"67130",2017,0,0,136,136
"67130",2020,0,0,11,11
"67131",2017,0,0,136,136
"67131",2020,0,0,11,11
"67132",2017,0,0,136,136
"67132",2020,0,0,11,11
"67133",2017,0,0,136,136
"67133",2020,0,0,11,11
"67134",2017,0,0,136,136
"67134",2020,0,0,15,15
"67135",2017,0,0,136,136
"67135",2020,0,0,11,11
"67136",2017,0,0,136,136
"67136",2020,0,0,15,15
"67137",2017,0,0,136,136
"67137",2020,0,0,11,11
"67138",2017,0,0,136,136
"67138",2020,0,0,11,11
"67139",2017,0,0,136,136
"67139",2020,0,0,11,11
"67140",2017,0,0,136,136
"67140",2020,0,0,11,11
"67141",2017,0,0,136,136
"67141",2020,0,0,11,11
"67142",2017,0,0,136,136
"67142",2020,0,0,11,11
"67143",2017,0,0,136,136
"67143",2020,0,0,11,11
"67144",2017,0,0,136,136
"67144",2020,0,0,11,11
"67145",2017,0,0,136,136
"67145",2020,0,0,11,11
"67146",2017,0,0,136,136
"67146",2020,0,0,11,11
"67147",2017,0,0,136,136
"67147",2020,0,0,11,11
"67148",2017,0,0,136,136
"67148",2020,0,0,15,15
"67149",2017,0,0,136,136
"67149",2020,0,0,11,11
"67150",2017,0,0,136,136
"67150",2020,0,0,11,11
"67151",2017,0,0,136,136
"67151",2020,0,0,11,11
"67152",2017,0,0,136,136
"67152",2020,0,0,11,11
"67153",2017,0,0,136,136
"67153",2020,0,0,11,11
"67154",2017,0,0,136,136
"67154",2020,0,0,11,11
"67155",2017,0,0,136,136
"67155",2020,0,0,11,11
"67156",2017,0,0,136,136
"67156",2020,0,0,11,11
"67159",2017,0,0,136,136
"67159",2020,0,0,15,15
"67160",2017,0,0,136,136
"67160",2020,0,0,11,11
"67161",2017,0,0,136,136
"67161",2020,0,0,11,11
"67162",2017,0,0,136,136
"67162",2020,0,0,11,11
"67163",2017,0,0,136,136
"67163",2020,0,0,11,11
"67164",2017,0,0,136,136
"67164",2020,0,0,11,11
"67165",2017,0,0,136,136
"67165",2020,0,0,11,11
"67166",2017,0,0,136,136
"67166",2020,0,0,11,11
"67167",2017,0,0,136,136
"67167",2020,0,0,11,11
"67168",2017,0,0,136,136
"67168",2020,0,0,11,11
"67169",2017,0,0,136,136
"67169",2020,0,0,11,11
"67172",2017,0,0,136,136
"67172",2020,0,0,11,11
"67173",2017,0,0,136,136
"67173",2020,0,0,11,11
"67174",2017,0,0,136,136
"67174",2020,0,0,11,11
"67176",2017,0,0,136,136
"67176",2020,0,0,11,11
"67177",2017,0,0,136,136
"67177",2020,0,0,11,11
"67178",2017,0,0,136,136
"67178",2020,0,0,15,15
"67179",2017,0,0,136,136
"67179",2020,0,0,11,11
"67180",2017,0,0,136,136
"67180",2020,0,0,11,11
"67181",2017,0,0,136,136
"67181",2020,0,0,11,11
"67182",2017,0,0,136,136
"67182",2020,0,0,11,11
"67183",2017,0,0,136,136
"67183",2020,0,0,15,15
"67184",2017,0,0,136,136
"67184",2020,0,0,11,11
"67185",2017,0,0,136,136
"67185",2020,0,0,11,11
"67186",2017,0,0,136,136
"67186",2020,0,0,11,11
"67187",2017,0,0,136,136
"67187",2020,0,0,11,11
"67188",2017,0,0,136,136
"67188",2020,0,0,11,11
"67189",2017,0,0,136,136
"67189",2020,0,0,11,11
"67190",2017,0,0,136,136
"67190",2020,0,0,11,11
"67191",2017,0,0,136,136
"67191",2020,0,0,15,15
"67192",2017,0,0,136,136
"67192",2020,0,0,11,11
"67194",2017,0,0,136,136
"67194",2020,0,0,11,11
"67195",2017,0,0,136,136
"67195",2020,0,0,11,11
"67196",2017,0,0,136,136
"67196",2020,0,0,11,11
"67197",2017,0,0,136,136
"67197",2020,0,0,11,11
"67198",2017,0,0,136,136
"67198",2020,0,0,15,15
"67199",2017,0,0,136,136
"67199",2020,0,0,15,15
"67200",2017,0,0,136,136
"67200",2020,0,0,11,11
"67201",2017,0,0,136,136
"67201",2020,0,0,15,15
"67202",2017,0,0,136,136
"67202",2020,0,0,11,11
"67203",2017,0,0,136,136
"67203",2020,0,0,11,11
"67204",2017,0,0,136,136
"67204",2020,0,0,11,11
"67205",2017,0,0,136,136
"67205",2020,0,0,11,11
"67206",2017,0,0,136,136
"67206",2020,0,0,11,11
"67208",2017,0,0,136,136
"67208",2020,0,0,11,11
"67209",2017,0,0,136,136
"67209",2020,0,0,11,11
"67210",2017,0,0,136,136
"67210",2020,0,0,11,11
"67212",2017,0,0,136,136
"67212",2020,0,0,11,11
"67213",2017,0,0,136,136
"67213",2020,0,0,11,11
"67214",2017,0,0,136,136
"67214",2020,0,0,11,11
"67215",2017,0,0,136,136
"67215",2020,0,0,11,11
"67216",2017,0,0,136,136
"67216",2020,0,0,11,11
"67217",2017,0,0,136,136
"67217",2020,0,0,11,11
"67218",2017,0,0,136,136
"67218",2020,0,0,11,11
"67220",2017,0,0,136,136
"67220",2020,0,0,11,11
"67221",2017,0,0,136,136
"67221",2020,0,0,11,11
"67222",2017,0,0,136,136
"67222",2020,0,0,11,11
"67223",2017,0,0,136,136
"67223",2020,0,0,11,11
"67225",2017,0,0,136,136
"67225",2020,0,0,11,11
"67226",2017,0,0,136,136
"67226",2020,0,0,11,11
"67227",2017,0,0,136,136
"67227",2020,0,0,11,11
"67228",2017,0,0,136,136
"67228",2020,0,0,11,11
"67229",2017,0,0,136,136
"67229",2020,0,0,11,11
"67230",2017,0,0,136,136
"67230",2020,0,0,11,11
"67231",2017,0,0,136,136
"67231",2020,0,0,11,11
"67232",2017,0,0,136,136
"67232",2020,0,0,11,11
"67233",2017,0,0,136,136
"67233",2020,0,0,11,11
"67234",2017,0,0,136,136
"67234",2020,0,0,15,15
"67235",2017,0,0,136,136
"67235",2020,0,0,11,11
"67236",2017,0,0,136,136
"67236",2020,0,0,11,11
"67237",2017,0,0,136,136
"67237",2020,0,0,11,11
"67238",2017,0,0,136,136
"67238",2020,0,0,11,11
"67239",2017,0,0,136,136
"67239",2020,0,0,11,11
"67240",2017,0,0,136,136
"67240",2020,0,0,11,11
"67241",2017,0,0,136,136
"67241",2020,0,0,15,15
"67242",2017,0,0,136,136
"67242",2020,0,0,11,11
"67244",2017,0,0,136,136
"67244",2020,0,0,11,11
"67245",2017,0,0,136,136
"67245",2020,0,0,11,11
"67246",2017,0,0,136,136
"67246",2020,0,0,11,11
"67247",2017,0,0,136,136
"67247",2020,0,0,11,11
"67248",2017,0,0,136,136
"67248",2020,0,0,11,11
"67249",2017,0,0,136,136
"67249",2020,0,0,11,11
"67250",2017,0,0,136,136
"67250",2020,0,0,11,11
"67252",2017,0,0,136,136
"67252",2020,0,0,11,11
"67253",2017,0,0,136,136
"67253",2020,0,0,11,11
"67254",2017,0,0,136,136
"67254",2020,0,0,11,11
"67255",2017,0,0,136,136
"67255",2020,0,0,11,11
"67256",2017,0,0,136,136
"67256",2020,0,0,11,11
"67257",2017,0,0,136,136
"67257",2020,0,0,11,11
"67258",2017,0,0,136,136
"67258",2020,0,0,11,11
"67259",2017,0,0,136,136
"67259",2020,0,0,11,11
"67260",2017,0,0,136,136
"67260",2020,0,0,11,11
"67261",2017,0,0,136,136
"67261",2020,0,0,11,11
"67263",2017,0,0,136,136
"67263",2020,0,0,11,11
"67264",2017,0,0,136,136
"67264",2020,0,0,11,11
"67265",2017,0,0,136,136
"67265",2020,0,0,11,11
"67266",2017,0,0,136,136
"67266",2020,0,0,11,11
"67267",2017,0,0,136,136
"67267",2020,0,0,11,11
"67268",2017,0,0,136,136
"67268",2020,0,0,11,11
"67269",2017,0,0,136,136
"67269",2020,0,0,11,11
"67270",2017,0,0,136,136
"67270",2020,0,0,11,11
"67271",2017,0,0,136,136
"67271",2020,0,0,11,11
"67272",2017,0,0,136,136
"67272",2020,0,0,11,11
"67273",2017,0,0,136,136
"67273",2020,0,0,15,15
"67274",2017,0,0,136,136
"67274",2020,0,0,15,15
"67275",2017,0,0,136,136
"67275",2020,0,0,11,11
"67276",2017,0,0,136,136
"67276",2020,0,0,11,11
"67277",2017,0,0,136,136
"67277",2020,0,0,11,11
"67278",2017,0,0,136,136
"67278",2020,0,0,15,15
"67279",2017,0,0,136,136
"67279",2020,0,0,11,11
"67280",2017,0,0,136,136
"67280",2020,0,0,11,11
"67281",2017,0,0,136,136
"67281",2020,0,0,11,11
"67282",2017,0,0,136,136
"67282",2020,0,0,11,11
"67283",2017,0,0,136,136
"67283",2020,0,0,11,11
"67285",2017,0,0,136,136
"67285",2020,0,0,11,11
"67286",2017,0,0,136,136
"67286",2020,0,0,11,11
"67287",2017,0,0,136,136
"67287",2020,0,0,11,11
"67288",2017,0,0,136,136
"67288",2020,0,0,11,11
"67289",2017,0,0,136,136
"67289",2020,0,0,11,11
"67290",2017,0,0,136,136
"67290",2020,0,0,11,11
"67291",2017,0,0,136,136
"67291",2020,0,0,11,11
"67292",2017,0,0,136,136
"67292",2020,0,0,11,11
"67293",2017,0,0,136,136
"67293",2020,0,0,11,11
"67295",2017,0,0,136,136
"67295",2020,0,0,11,11
"67296",2017,0,0,136,136
"67296",2020,0,0,11,11
"67298",2017,0,0,136,136
"67298",2020,0,0,11,11
"67299",2017,0,0,136,136
"67299",2020,0,0,11,11
"67300",2017,0,0,136,136
"67300",2020,0,0,11,11
"67301",2017,0,0,136,136
"67301",2020,0,0,11,11
"67302",2017,0,0,136,136
"67302",2020,0,0,11,11
"67303",2017,0,0,136,136
"67303",2020,0,0,11,11
"67304",2017,0,0,136,136
"67304",2020,0,0,11,11
"67305",2017,0,0,136,136
"67305",2020,0,0,11,11
"67306",2017,0,0,136,136
"67306",2020,0,0,11,11
"67307",2017,0,0,136,136
"67307",2020,0,0,11,11
"67308",2017,0,0,136,136
"67308",2020,0,0,11,11
"67309",2017,0,0,136,136
"67309",2020,0,0,11,11
"67310",2017,0,0,136,136
"67310",2020,0,0,11,11
"67311",2017,0,0,136,136
"67311",2020,0,0,11,11
"67312",2017,0,0,136,136
"67312",2020,0,0,11,11
"67313",2017,0,0,136,136
"67313",2020,0,0,11,11
"67314",2017,0,0,136,136
"67314",2020,0,0,11,11
"67315",2017,0,0,136,136
"67315",2020,0,0,11,11
"67317",2017,0,0,136,136
"67317",2020,0,0,11,11
"67319",2017,0,0,136,136
"67319",2020,0,0,11,11
"67320",2017,0,0,136,136
"67320",2020,0,0,11,11
"67321",2017,0,0,136,136
"67321",2020,0,0,11,11
"67322",2017,0,0,136,136
"67322",2020,0,0,11,11
"67324",2017,0,0,136,136
"67324",2020,0,0,11,11
"67325",2017,0,0,136,136
"67325",2020,0,0,11,11
"67326",2017,0,0,136,136
"67326",2020,0,0,11,11
"67327",2017,0,0,136,136
"67327",2020,0,0,11,11
"67328",2017,0,0,136,136
"67328",2020,0,0,11,11
"67329",2017,0,0,136,136
"67329",2020,0,0,11,11
"67330",2017,0,0,136,136
"67330",2020,0,0,11,11
"67331",2017,0,0,136,136
"67331",2020,0,0,11,11
"67333",2017,0,0,136,136
"67333",2020,0,0,11,11
"67334",2017,0,0,136,136
"67334",2020,0,0,11,11
"67335",2017,0,0,136,136
"67335",2020,0,0,11,11
"67336",2017,0,0,136,136
"67336",2020,0,0,11,11
"67337",2017,0,0,136,136
"67337",2020,0,0,11,11
"67338",2017,0,0,136,136
"67338",2020,0,0,11,11
"67339",2017,0,0,136,136
"67339",2020,0,0,11,11
"67340",2017,0,0,136,136
"67340",2020,0,0,11,11
"67341",2017,0,0,136,136
"67341",2020,0,0,11,11
"67342",2017,0,0,136,136
"67342",2020,0,0,11,11
"67343",2017,0,0,136,136
"67343",2020,0,0,11,11
"67344",2017,0,0,136,136
"67344",2020,0,0,11,11
"67345",2017,0,0,136,136
"67345",2020,0,0,11,11
"67346",2017,0,0,136,136
"67346",2020,0,0,11,11
"67347",2017,0,0,136,136
"67347",2020,0,0,11,11
"67348",2017,0,0,136,136
"67348",2020,0,0,11,11
"67349",2017,0,0,136,136
"67349",2020,0,0,11,11
"67350",2017,0,0,136,136
"67350",2020,0,0,11,11
"67351",2017,0,0,136,136
"67351",2020,0,0,11,11
"67352",2017,0,0,136,136
"67352",2020,0,0,11,11
"67353",2017,0,0,136,136
"67353",2020,0,0,11,11
"67354",2017,0,0,136,136
"67354",2020,0,0,11,11
"67355",2017,0,0,136,136
"67355",2020,0,0,15,15
"67356",2017,0,0,136,136
"67356",2020,0,0,11,11
"67358",2017,0,0,136,136
"67358",2020,0,0,11,11
"67359",2017,0,0,136,136
"67359",2020,0,0,11,11
"67360",2017,0,0,136,136
"67360",2020,0,0,11,11
"67361",2017,0,0,136,136
"67361",2020,0,0,11,11
"67362",2017,0,0,136,136
"67362",2020,0,0,11,11
"67363",2017,0,0,136,136
"67363",2020,0,0,11,11
"67364",2017,0,0,136,136
"67364",2020,0,0,11,11
"67365",2017,0,0,136,136
"67365",2020,0,0,11,11
"67366",2017,0,0,136,136
"67366",2020,0,0,11,11
"67367",2017,0,0,136,136
"67367",2020,0,0,11,11
"67368",2017,0,0,136,136
"67368",2020,0,0,11,11
"67369",2017,0,0,136,136
"67369",2020,0,0,15,15
"67370",2017,0,0,136,136
"67370",2020,0,0,15,15
"67371",2017,0,0,136,136
"67371",2020,0,0,15,15
"67372",2017,0,0,136,136
"67372",2020,0,0,11,11
"67373",2017,0,0,136,136
"67373",2020,0,0,11,11
"67375",2017,0,0,136,136
"67375",2020,0,0,11,11
"67377",2017,0,0,136,136
"67377",2020,0,0,11,11
"67378",2017,0,0,136,136
"67378",2020,0,0,11,11
"67379",2017,0,0,136,136
"67379",2020,0,0,11,11
"67380",2017,0,0,136,136
"67380",2020,0,0,11,11
"67381",2017,0,0,136,136
"67381",2020,0,0,15,15
"67382",2017,0,0,136,136
"67382",2020,0,0,11,11
"67383",2017,0,0,136,136
"67383",2020,0,0,11,11
"67384",2017,0,0,136,136
"67384",2020,0,0,11,11
"67385",2017,0,0,136,136
"67385",2020,0,0,15,15
"67386",2017,0,0,136,136
"67386",2020,0,0,15,15
"67387",2017,0,0,136,136
"67387",2020,0,0,11,11
"67388",2017,0,0,136,136
"67388",2020,0,0,11,11
"67389",2017,0,0,136,136
"67389",2020,0,0,11,11
"67391",2017,0,0,136,136
"67391",2020,0,0,11,11
"67392",2017,0,0,136,136
"67392",2020,0,0,11,11
"67394",2017,0,0,136,136
"67394",2020,0,0,11,11
"67395",2017,0,0,136,136
"67395",2020,0,0,11,11
"67396",2017,0,0,136,136
"67396",2020,0,0,15,15
"67397",2017,0,0,136,136
"67397",2020,0,0,11,11
"67398",2017,0,0,136,136
"67398",2020,0,0,11,11
"67400",2017,0,0,136,136
"67400",2020,0,0,11,11
"67401",2017,0,0,136,136
"67401",2020,0,0,15,15
"67403",2017,0,0,136,136
"67403",2020,0,0,11,11
"67404",2017,0,0,136,136
"67404",2020,0,0,11,11
"67405",2017,0,0,136,136
"67405",2020,0,0,11,11
"67406",2017,0,0,136,136
"67406",2020,0,0,11,11
"67407",2017,0,0,136,136
"67407",2020,0,0,11,11
"67408",2017,0,0,136,136
"67408",2020,0,0,11,11
"67409",2017,0,0,136,136
"67409",2020,0,0,11,11
"67410",2017,0,0,136,136
"67410",2020,0,0,11,11
"67411",2017,0,0,136,136
"67411",2020,0,0,11,11
"67412",2017,0,0,136,136
"67412",2020,0,0,11,11
"67413",2017,0,0,136,136
"67413",2020,0,0,15,15
"67414",2017,0,0,136,136
"67414",2020,0,0,11,11
"67415",2017,0,0,136,136
"67415",2020,0,0,11,11
"67416",2017,0,0,136,136
"67416",2020,0,0,11,11
"67417",2017,0,0,136,136
"67417",2020,0,0,11,11
"67418",2017,0,0,136,136
"67418",2020,0,0,11,11
"67420",2017,0,0,136,136
"67420",2020,0,0,11,11
"67421",2017,0,0,136,136
"67421",2020,0,0,11,11
"67422",2017,0,0,136,136
"67422",2020,0,0,11,11
"67423",2017,0,0,136,136
"67423",2020,0,0,11,11
"67424",2017,0,0,136,136
"67424",2020,0,0,11,11
"67425",2017,0,0,136,136
"67425",2020,0,0,11,11
"67426",2017,0,0,136,136
"67426",2020,0,0,11,11
"67427",2017,0,0,136,136
"67427",2020,0,0,11,11
"67428",2017,0,0,136,136
"67428",2020,0,0,11,11
"67429",2017,0,0,136,136
"67429",2020,0,0,11,11
"67430",2017,0,0,136,136
"67430",2020,0,0,11,11
"67432",2017,0,0,136,136
"67432",2020,0,0,11,11
"67433",2017,0,0,136,136
"67433",2020,0,0,11,11
"67434",2017,0,0,136,136
"67434",2020,0,0,15,15
"67435",2017,0,0,136,136
"67435",2020,0,0,15,15
"67436",2017,0,0,136,136
"67436",2020,0,0,11,11
"67437",2017,0,0,136,136
"67437",2020,0,0,11,11
"67438",2017,0,0,136,136
"67438",2020,0,0,11,11
"67440",2017,0,0,136,136
"67440",2020,0,0,11,11
"67441",2017,0,0,136,136
"67441",2020,0,0,11,11
"67442",2017,0,0,136,136
"67442",2020,0,0,11,11
"67443",2017,0,0,136,136
"67443",2020,0,0,11,11
"67444",2017,0,0,136,136
"67444",2020,0,0,11,11
"67445",2017,0,0,136,136
"67445",2020,0,0,11,11
"67446",2017,0,0,136,136
"67446",2020,0,0,11,11
"67447",2017,0,0,136,136
"67447",2020,0,0,11,11
"67448",2017,0,0,136,136
"67448",2020,0,0,11,11
"67449",2017,0,0,136,136
"67449",2020,0,0,11,11
"67450",2017,0,0,136,136
"67450",2020,0,0,11,11
"67451",2017,0,0,136,136
"67451",2020,0,0,11,11
"67452",2017,0,0,136,136
"67452",2020,0,0,11,11
"67453",2017,0,0,136,136
"67453",2020,0,0,11,11
"67454",2017,0,0,136,136
"67454",2020,0,0,11,11
"67455",2017,0,0,136,136
"67455",2020,0,0,11,11
"67456",2017,0,0,136,136
"67456",2020,0,0,15,15
"67458",2017,0,0,136,136
"67458",2020,0,0,11,11
"67459",2017,0,0,136,136
"67459",2020,0,0,11,11
"67460",2017,0,0,136,136
"67460",2020,0,0,11,11
"67461",2017,0,0,136,136
"67461",2020,0,0,11,11
"67462",2017,0,0,136,136
"67462",2020,0,0,11,11
"67463",2017,0,0,136,136
"67463",2020,0,0,11,11
"67464",2017,0,0,136,136
"67464",2020,0,0,11,11
"67465",2017,0,0,136,136
"67465",2020,0,0,11,11
"67466",2017,0,0,136,136
"67466",2020,0,0,11,11
"67467",2017,0,0,136,136
"67467",2020,0,0,15,15
"67468",2017,0,0,136,136
"67468",2020,0,0,15,15
"67470",2017,0,0,136,136
"67470",2020,0,0,11,11
"67471",2017,0,0,136,136
"67471",2020,0,0,11,11
"67472",2017,0,0,136,136
"67472",2020,0,0,11,11
"67473",2017,0,0,136,136
"67473",2020,0,0,11,11
"67474",2017,0,0,136,136
"67474",2020,0,0,11,11
"67475",2017,0,0,136,136
"67475",2020,0,0,11,11
"67476",2017,0,0,136,136
"67476",2020,0,0,11,11
"67477",2017,0,0,136,136
"67477",2020,0,0,11,11
"67478",2017,0,0,136,136
"67478",2020,0,0,11,11
"67479",2017,0,0,136,136
"67479",2020,0,0,11,11
"67480",2017,0,0,136,136
"67480",2020,0,0,11,11
"67481",2017,0,0,136,136
"67481",2020,0,0,11,11
"67482",2017,0,0,136,136
"67482",2020,0,0,11,11
"67483",2017,0,0,136,136
"67483",2020,0,0,15,15
"67484",2017,0,0,136,136
"67484",2020,0,0,11,11
"67485",2017,0,0,136,136
"67485",2020,0,0,11,11
"67486",2017,0,0,136,136
"67486",2020,0,0,11,11
"67487",2017,0,0,136,136
"67487",2020,0,0,11,11
"67488",2017,0,0,136,136
"67488",2020,0,0,15,15
"67489",2017,0,0,136,136
"67489",2020,0,0,11,11
"67490",2017,0,0,136,136
"67490",2020,0,0,11,11
"67491",2017,0,0,136,136
"67491",2020,0,0,15,15
"67492",2017,0,0,136,136
"67492",2020,0,0,11,11
"67493",2017,0,0,136,136
"67493",2020,0,0,11,11
"67494",2017,0,0,136,136
"67494",2020,0,0,11,11
"67495",2017,0,0,136,136
"67495",2020,0,0,11,11
"67497",2017,0,0,136,136
"67497",2020,0,0,11,11
"67498",2017,0,0,136,136
"67498",2020,0,0,11,11
"67499",2017,0,0,136,136
"67499",2020,0,0,11,11
"67500",2017,0,0,136,136
"67500",2020,0,0,11,11
"67501",2017,0,0,136,136
"67501",2020,0,0,11,11
"67502",2017,0,0,136,136
"67502",2020,0,0,11,11
"67503",2017,0,0,136,136
"67503",2020,0,0,11,11
"67504",2017,0,0,136,136
"67504",2020,0,0,11,11
"67505",2017,0,0,136,136
"67505",2020,0,0,11,11
"67506",2017,0,0,136,136
"67506",2020,0,0,11,11
"67507",2017,0,0,136,136
"67507",2020,0,0,11,11
"67508",2017,0,0,136,136
"67508",2020,0,0,15,15
"67509",2017,0,0,136,136
"67509",2020,0,0,15,15
"67510",2017,0,0,136,136
"67510",2020,0,0,11,11
"67511",2017,0,0,136,136
"67511",2020,0,0,11,11
"67513",2017,0,0,136,136
"67513",2020,0,0,11,11
"67514",2017,0,0,136,136
"67514",2020,0,0,15,15
"67515",2017,0,0,136,136
"67515",2020,0,0,11,11
"67516",2017,0,0,136,136
"67516",2020,0,0,11,11
"67517",2017,0,0,136,136
"67517",2020,0,0,11,11
"67519",2017,0,0,136,136
"67519",2020,0,0,11,11
"67520",2017,0,0,136,136
"67520",2020,0,0,11,11
"67521",2017,0,0,136,136
"67521",2020,0,0,11,11
"67522",2017,0,0,136,136
"67522",2020,0,0,15,15
"67523",2017,0,0,136,136
"67523",2020,0,0,11,11
"67524",2017,0,0,136,136
"67524",2020,0,0,11,11
"67525",2017,0,0,136,136
"67525",2020,0,0,11,11
"67526",2017,0,0,136,136
"67526",2020,0,0,11,11
"67527",2017,0,0,136,136
"67527",2020,0,0,11,11
"67528",2017,0,0,136,136
"67528",2020,0,0,15,15
"67529",2017,0,0,136,136
"67529",2020,0,0,11,11
"67530",2017,0,0,136,136
"67530",2020,0,0,11,11
"67531",2017,0,0,136,136
"67531",2020,0,0,11,11
"67532",2017,0,0,136,136
"67532",2020,0,0,11,11
"67534",2017,0,0,136,136
"67534",2020,0,0,11,11
"67535",2017,0,0,136,136
"67535",2020,0,0,11,11
"67536",2017,0,0,136,136
"67536",2020,0,0,11,11
"67537",2017,0,0,136,136
"67537",2020,0,0,11,11
"67538",2017,0,0,136,136
"67538",2020,0,0,11,11
"67539",2017,0,0,136,136
"67539",2020,0,0,11,11
"67540",2017,0,0,136,136
"67540",2020,0,0,11,11
"67541",2017,0,0,136,136
"67541",2020,0,0,11,11
"67542",2017,0,0,136,136
"67542",2020,0,0,11,11
"67543",2017,0,0,136,136
"67543",2020,0,0,11,11
"67544",2017,0,0,136,136
"67544",2020,0,0,11,11
"67545",2017,0,0,136,136
"67545",2020,0,0,11,11
"67546",2017,0,0,136,136
"67546",2020,0,0,11,11
"67547",2017,0,0,136,136
"67547",2020,0,0,11,11
"67548",2017,0,0,136,136
"67548",2020,0,0,11,11
"67550",2017,0,0,136,136
"67550",2020,0,0,11,11
"67551",2017,0,0,136,136
"67551",2020,0,0,11,11
"67552",2017,0,0,136,136
"67552",2020,0,0,15,15
"67553",2017,0,0,136,136
"67553",2020,0,0,11,11
"67554",2017,0,0,136,136
"67554",2020,0,0,11,11
"67555",2017,0,0,136,136
"67555",2020,0,0,11,11
"67556",2017,0,0,136,136
"67556",2020,0,0,11,11
"67557",2017,0,0,136,136
"67557",2020,0,0,11,11
"67558",2017,0,0,136,136
"67558",2020,0,0,11,11
"67559",2017,0,0,136,136
"67559",2020,0,0,15,15
"68001",2017,0,0,127,127
"68002",2015,0,0,34,34
"68002",2017,0,0,127,127
"68004",2015,0,0,34,34
"68004",2017,0,0,127,127
"68005",2015,0,0,72,72
"68005",2017,0,0,127,127
"68006",2015,0,0,19,19
"68006",2017,0,0,127,127
"68007",2017,0,0,127,127
"68008",2017,0,0,127,127
"68009",2017,0,0,127,127
"68010",2015,0,0,34,34
"68010",2017,0,0,127,127
"68011",2015,0,0,57,57
"68011",2017,0,0,127,127
"68012",2015,0,0,57,57
"68012",2017,0,0,127,127
"68013",2017,0,0,127,127
"68014",2015,0,0,53,53
"68014",2017,0,0,127,127
"68015",2015,0,0,34,34
"68015",2017,0,0,127,127
"68016",2017,0,0,127,127
"68017",2015,0,0,34,34
"68017",2017,0,0,127,127
"68018",2015,0,0,34,34
"68018",2017,0,0,127,127
"68019",2017,0,0,127,127
"68020",2017,0,0,127,127
"68021",2017,0,0,127,127
"68022",2015,0,0,34,34
"68022",2017,0,0,127,127
"68023",2015,0,0,72,72
"68023",2017,0,0,127,127
"68024",2015,0,0,34,34
"68024",2017,0,0,127,127
"68025",2015,0,0,34,34
"68025",2017,0,0,127,127
"68026",2015,0,0,72,72
"68026",2017,0,0,127,127
"68027",2015,0,0,34,34
"68027",2017,0,0,127,127
"68028",2015,0,0,72,72
"68028",2017,0,0,127,127
"68029",2015,0,0,72,72
"68029",2017,0,0,127,127
"68030",2015,0,0,72,72
"68030",2017,0,0,127,127
"68032",2015,0,0,72,72
"68032",2017,0,0,127,127
"68033",2015,0,0,34,34
"68033",2017,0,0,127,127
"68034",2015,0,0,34,34
"68034",2017,0,0,127,127
"68035",2017,0,0,57,57
"68036",2017,0,0,127,127
"68037",2015,0,0,72,72
"68037",2017,0,0,127,127
"68038",2017,0,0,127,127
"68039",2015,0,0,34,34
"68039",2017,0,0,127,127
"68040",2015,0,0,57,57
"68040",2017,0,0,127,127
"68041",2017,0,0,127,127
"68042",2017,0,0,127,127
"68043",2015,0,0,72,72
"68043",2017,0,0,127,127
"68044",2015,0,0,53,53
"68044",2017,0,0,127,127
"68045",2015,0,0,57,57
"68045",2017,0,0,127,127
"68046",2015,0,0,57,57
"68046",2017,0,0,127,127
"68049",2015,0,0,34,34
"68049",2017,0,0,127,127
"68050",2015,0,0,34,34
"68050",2017,0,0,127,127
"68051",2015,0,0,72,72
"68051",2017,0,0,127,127
"68052",2015,0,0,34,34
"68052",2017,0,0,127,127
"68054",2017,0,0,127,127
"68055",2015,0,0,34,34
"68055",2017,0,0,127,127
"68056",2015,0,0,34,34
"68056",2017,0,0,127,127
"68057",2015,0,0,34,34
"68057",2017,0,0,127,127
"68058",2015,0,0,72,72
"68058",2017,0,0,127,127
"68059",2015,0,0,19,19
"68059",2017,0,0,127,127
"68060",2015,0,0,57,57
"68060",2017,0,0,127,127
"68061",2017,0,0,127,127
"68062",2015,0,0,34,34
"68062",2017,0,0,127,127
"68063",2015,0,0,19,19
"68063",2017,0,0,127,127
"68064",2017,0,0,127,127
"68065",2015,0,0,34,34
"68065",2017,0,0,127,127
"68066",2015,0,0,72,72
"68066",2017,0,0,127,127
"68067",2015,0,0,34,34
"68067",2017,0,0,127,127
"68068",2015,0,0,34,34
"68068",2017,0,0,127,127
"68069",2017,0,0,127,127
"68071",2015,0,0,34,34
"68071",2017,0,0,127,127
"68072",2017,0,0,127,127
"68073",2015,0,0,57,57
"68073",2017,0,0,127,127
"68074",2015,0,0,34,34
"68074",2017,0,0,127,127
"68075",2015,0,0,34,34
"68075",2017,0,0,127,127
"68076",2017,0,0,127,127
"68077",2015,0,0,34,34
"68077",2017,0,0,127,127
"68078",2015,0,0,72,72
"68078",2017,0,0,127,127
"68079",2015,0,0,34,34
"68079",2017,0,0,127,127
"68080",2015,0,0,34,34
"68080",2017,0,0,127,127
"68081",2015,0,0,34,34
"68081",2017,0,0,127,127
"68082",2015,0,0,72,72
"68082",2017,0,0,127,127
"68083",2015,0,0,72,72
"68083",2017,0,0,127,127
"68084",2017,0,0,127,127
"68085",2015,0,0,34,34
"68085",2017,0,0,127,127
"68086",2015,0,0,34,34
"68086",2017,0,0,127,127
"68087",2015,0,0,34,34
"68087",2017,0,0,127,127
"68088",2015,0,0,72,72
"68088",2017,0,0,127,127
"68089",2015,0,0,72,72
"68089",2017,0,0,127,127
"68090",2015,0,0,34,34
"68090",2017,0,0,127,127
"68091",2017,0,0,127,127
"68092",2015,0,0,34,34
"68092",2017,0,0,127,127
"68093",2015,0,0,34,34
"68093",2017,0,0,127,127
"68094",2015,0,0,34,34
"68094",2017,0,0,127,127
"68095",2017,0,0,127,127
"68096",2015,0,0,34,34
"68096",2017,0,0,127,127
"68097",2015,0,0,53,53
"68097",2017,0,0,127,127
"68098",2015,0,0,34,34
"68098",2017,0,0,127,127
"68099",2015,0,0,34,34
"68099",2017,0,0,127,127
"68100",2015,0,0,34,34
"68100",2017,0,0,127,127
"68101",2015,0,0,19,19
"68101",2017,0,0,127,127
"68102",2015,0,0,72,72
"68102",2017,0,0,127,127
"68103",2017,0,0,127,127
"68104",2017,0,0,127,127
"68105",2015,0,0,34,34
"68105",2017,0,0,127,127
"68106",2015,0,0,72,72
"68106",2017,0,0,127,127
"68107",2015,0,0,34,34
"68107",2017,0,0,127,127
"68109",2015,0,0,72,72
"68109",2017,0,0,127,127
"68110",2017,0,0,127,127
"68111",2015,0,0,72,72
"68111",2017,0,0,127,127
"68112",2015,0,0,72,72
"68112",2017,0,0,127,127
"68113",2015,0,0,72,72
"68113",2017,0,0,127,127
"68114",2015,0,0,34,34
"68114",2017,0,0,127,127
"68115",2015,0,0,57,57
"68115",2017,0,0,127,127
"68116",2015,0,0,72,72
"68116",2017,0,0,127,127
"68117",2015,0,0,72,72
"68117",2017,0,0,127,127
"68118",2017,0,0,127,127
"68119",2015,0,0,34,34
"68119",2017,0,0,127,127
"68120",2017,0,0,127,127
"68121",2015,0,0,34,34
"68121",2017,0,0,127,127
"68122",2015,0,0,72,72
"68122",2017,0,0,127,127
"68123",2015,0,0,72,72
"68123",2017,0,0,127,127
"68124",2015,0,0,34,34
"68124",2017,0,0,127,127
"68125",2015,0,0,34,34
"68125",2017,0,0,127,127
"68126",2017,0,0,127,127
"68127",2015,0,0,34,34
"68127",2017,0,0,127,127
"68128",2015,0,0,34,34
"68128",2017,0,0,127,127
"68129",2015,0,0,19,19
"68129",2017,0,0,127,127
"68130",2017,0,0,127,127
"68131",2015,0,0,34,34
"68131",2017,0,0,127,127
"68132",2015,0,0,34,34
"68132",2017,0,0,127,127
"68134",2015,0,0,72,72
"68134",2017,0,0,127,127
"68135",2017,0,0,127,127
"68136",2017,0,0,127,127
"68137",2015,0,0,34,34
"68137",2017,0,0,127,127
"68138",2015,0,0,34,34
"68138",2017,0,0,127,127
"68139",2015,0,0,34,34
"68139",2017,0,0,127,127
"68140",2017,0,0,127,127
"68141",2015,0,0,19,19
"68141",2017,0,0,127,127
"68142",2015,0,0,72,72
"68142",2017,0,0,127,127
"68143",2017,0,0,127,127
"68144",2017,0,0,127,127
"68145",2015,0,0,72,72
"68145",2017,0,0,127,127
"68146",2015,0,0,72,72
"68146",2017,0,0,127,127
"68147",2015,0,0,72,72
"68147",2017,0,0,127,127
"68148",2015,0,0,34,34
"68148",2017,0,0,127,127
"68149",2017,0,0,127,127
"68150",2015,0,0,15,15
"68150",2017,0,0,127,127
"68151",2017,0,0,127,127
"68152",2015,0,0,34,34
"68152",2017,0,0,127,127
"68153",2015,0,0,72,72
"68153",2017,0,0,127,127
"68154",2015,0,0,34,34
"68154",2017,0,0,127,127
"68155",2015,0,0,72,72
"68155",2017,0,0,127,127
"68156",2015,0,0,72,72
"68156",2017,0,0,127,127
"68157",2017,0,0,127,127
"68158",2015,0,0,34,34
"68158",2017,0,0,127,127
"68159",2015,0,0,72,72
"68159",2017,0,0,127,127
"68160",2017,0,0,127,127
"68161",2015,0,0,72,72
"68161",2017,0,0,127,127
"68162",2015,0,0,72,72
"68162",2017,0,0,127,127
"68163",2017,0,0,127,127
"68165",2015,0,0,15,15
"68165",2017,0,0,57,57
"68166",2015,0,0,34,34
"68166",2017,0,0,127,127
"68167",2015,0,0,57,57
"68167",2017,0,0,127,127
"68168",2015,0,0,34,34
"68168",2017,0,0,127,127
"68169",2015,0,0,34,34
"68169",2017,0,0,127,127
"68170",2017,0,0,127,127
"68171",2015,0,0,72,72
"68171",2017,0,0,127,127
"68172",2017,0,0,127,127
"68173",2015,0,0,72,72
"68173",2017,0,0,127,127
"68174",2017,0,0,127,127
"68175",2015,0,0,53,53
"68175",2017,0,0,127,127
"68176",2015,0,0,34,34
"68176",2017,0,0,127,127
"68177",2015,0,0,72,72
"68177",2017,0,0,127,127
"68178",2015,0,0,72,72
"68178",2017,0,0,127,127
"68179",2015,0,0,57,57
"68179",2017,0,0,127,127
"68180",2017,0,0,127,127
"68181",2015,0,0,34,34
"68181",2017,0,0,127,127
"68182",2017,0,0,127,127
"68183",2017,0,0,127,127
"68184",2015,0,0,34,34
"68184",2017,0,0,127,127
"68185",2015,0,0,53,53
"68185",2017,0,0,127,127
"68186",2015,0,0,34,34
"68186",2017,0,0,127,127
"68187",2015,0,0,34,34
"68187",2017,0,0,127,127
"68188",2015,0,0,72,72
"68188",2017,0,0,127,127
"68189",2017,0,0,127,127
"68190",2015,0,0,34,34
"68190",2017,0,0,127,127
"68191",2015,0,0,34,34
"68191",2017,0,0,127,127
"68192",2015,0,0,34,34
"68192",2017,0,0,127,127
"68193",2015,0,0,72,72
"68193",2017,0,0,127,127
"68194",2015,0,0,34,34
"68194",2017,0,0,127,127
"68195",2015,0,0,19,19
"68195",2017,0,0,127,127
"68196",2017,0,0,57,57
"68197",2017,0,0,127,127
"68198",2015,0,0,34,34
"68198",2017,0,0,127,127
"68199",2017,0,0,127,127
"68200",2015,0,0,34,34
"68200",2017,0,0,127,127
"68201",2015,0,0,57,57
"68201",2017,0,0,127,127
"68202",2015,0,0,34,34
"68202",2017,0,0,127,127
"68203",2015,0,0,72,72
"68203",2017,0,0,127,127
"68204",2015,0,0,72,72
"68204",2017,0,0,127,127
"68205",2015,0,0,72,72
"68205",2017,0,0,127,127
"68207",2017,0,0,127,127
"68208",2015,0,0,34,34
"68208",2017,0,0,127,127
"68209",2015,0,0,72,72
"68209",2017,0,0,127,127
"68210",2015,0,0,72,72
"68210",2017,0,0,127,127
"68211",2015,0,0,57,57
"68211",2017,0,0,127,127
"68212",2015,0,0,34,34
"68212",2017,0,0,127,127
"68213",2015,0,0,57,57
"68213",2017,0,0,127,127
"68214",2017,0,0,57,57
"68215",2017,0,0,57,57
"68216",2015,0,0,34,34
"68216",2017,0,0,127,127
"68217",2015,0,0,57,57
"68217",2017,0,0,127,127
"68218",2015,0,0,19,19
"68218",2017,0,0,127,127
"68219",2015,0,0,57,57
"68219",2017,0,0,127,127
"68221",2015,0,0,34,34
"68221",2017,0,0,127,127
"68222",2015,0,0,34,34
"68222",2017,0,0,127,127
"68223",2015,0,0,72,72
"68223",2017,0,0,127,127
"68224",2015,0,0,19,19
"68224",2017,0,0,127,127
"68225",2017,0,0,127,127
"68226",2015,0,0,72,72
"68226",2017,0,0,127,127
"68227",2017,0,0,127,127
"68228",2015,0,0,72,72
"68228",2017,0,0,127,127
"68229",2015,0,0,72,72
"68229",2017,0,0,127,127
"68230",2017,0,0,127,127
"68231",2017,0,0,127,127
"68232",2017,0,0,127,127
"68234",2015,0,0,72,72
"68234",2017,0,0,127,127
"68235",2015,0,0,72,72
"68235",2017,0,0,127,127
"68237",2015,0,0,72,72
"68237",2017,0,0,127,127
"68238",2017,0,0,127,127
"68239",2015,0,0,57,57
"68239",2017,0,0,127,127
"68240",2015,0,0,34,34
"68240",2017,0,0,127,127
"68241",2015,0,0,72,72
"68241",2017,0,0,127,127
"68242",2015,0,0,72,72
"68242",2017,0,0,127,127
"68243",2015,0,0,34,34
"68243",2017,0,0,127,127
"68244",2015,0,0,72,72
"68244",2017,0,0,127,127
"68245",2015,0,0,34,34
"68245",2017,0,0,127,127
"68246",2017,0,0,127,127
"68247",2015,0,0,72,72
"68247",2017,0,0,127,127
"68248",2015,0,0,34,34
"68248",2017,0,0,127,127
"68249",2015,0,0,72,72
"68249",2017,0,0,127,127
"68250",2015,0,0,72,72
"68250",2017,0,0,127,127
"68251",2015,0,0,72,72
"68251",2017,0,0,127,127
"68252",2015,0,0,72,72
"68252",2017,0,0,127,127
"68253",2017,0,0,127,127
"68254",2017,0,0,127,127
"68255",2015,0,0,72,72
"68255",2017,0,0,127,127
"68256",2015,0,0,19,19
"68256",2017,0,0,127,127
"68257",2015,0,0,34,34
"68257",2017,0,0,127,127
"68258",2015,0,0,72,72
"68258",2017,0,0,127,127
"68259",2015,0,0,34,34
"68259",2017,0,0,127,127
"68260",2015,0,0,72,72
"68260",2017,0,0,127,127
"68261",2015,0,0,57,57
"68261",2017,0,0,127,127
"68262",2015,0,0,72,72
"68262",2017,0,0,127,127
"68263",2017,0,0,127,127
"68264",2015,0,0,34,34
"68264",2017,0,0,127,127
"68265",2015,0,0,34,34
"68265",2017,0,0,127,127
"68266",2015,0,0,72,72
"68266",2017,0,0,127,127
"68267",2015,0,0,19,19
"68267",2017,0,0,127,127
"68268",2015,0,0,34,34
"68268",2017,0,0,127,127
"68269",2015,0,0,53,53
"68269",2017,0,0,127,127
"68270",2015,0,0,34,34
"68270",2017,0,0,127,127
"68271",2015,0,0,34,34
"68271",2017,0,0,127,127
"68273",2015,0,0,34,34
"68273",2017,0,0,127,127
"68274",2015,0,0,72,72
"68274",2017,0,0,127,127
"68275",2015,0,0,57,57
"68275",2017,0,0,127,127
"68276",2015,0,0,72,72
"68276",2017,0,0,127,127
"68277",2015,0,0,72,72
"68277",2017,0,0,127,127
"68278",2015,0,0,34,34
"68278",2017,0,0,127,127
"68279",2015,0,0,57,57
"68279",2017,0,0,127,127
"68280",2015,0,0,53,53
"68280",2017,0,0,127,127
"68281",2017,0,0,127,127
"68282",2017,0,0,57,57
"68283",2015,0,0,53,53
"68283",2017,0,0,127,127
"68284",2015,0,0,34,34
"68284",2017,0,0,127,127
"68285",2017,0,0,127,127
"68286",2017,0,0,127,127
"68287",2015,0,0,72,72
"68287",2017,0,0,127,127
"68288",2015,0,0,34,34
"68288",2017,0,0,127,127
"68289",2015,0,0,34,34
"68289",2017,0,0,127,127
"68290",2017,0,0,127,127
"68291",2017,0,0,127,127
"68292",2015,0,0,72,72
"68292",2017,0,0,127,127
"68293",2015,0,0,34,34
"68293",2017,0,0,127,127
"68294",2015,0,0,53,53
"68294",2017,0,0,127,127
"68295",2015,0,0,72,72
"68295",2017,0,0,127,127
"68296",2015,0,0,53,53
"68296",2017,0,0,127,127
"68297",2017,0,0,127,127
"68298",2015,0,0,53,53
"68298",2017,0,0,127,127
"68299",2015,0,0,34,34
"68299",2017,0,0,127,127
"68300",2015,0,0,34,34
"68300",2017,0,0,127,127
"68301",2017,0,0,127,127
"68302",2017,0,0,127,127
"68303",2015,0,0,34,34
"68303",2017,0,0,127,127
"68304",2015,0,0,57,57
"68304",2017,0,0,127,127
"68305",2015,0,0,34,34
"68305",2017,0,0,127,127
"68306",2015,0,0,34,34
"68306",2017,0,0,127,127
"68307",2015,0,0,57,57
"68307",2017,0,0,127,127
"68308",2015,0,0,57,57
"68308",2017,0,0,127,127
"68309",2017,0,0,127,127
"68311",2015,0,0,72,72
"68311",2017,0,0,127,127
"68312",2015,0,0,34,34
"68312",2017,0,0,127,127
"68313",2015,0,0,19,19
"68313",2017,0,0,127,127
"68315",2015,0,0,72,72
"68315",2017,0,0,127,127
"68316",2015,0,0,72,72
"68316",2017,0,0,127,127
"68317",2015,0,0,72,72
"68317",2017,0,0,127,127
"68318",2015,0,0,72,72
"68318",2017,0,0,127,127
"68320",2015,0,0,34,34
"68320",2017,0,0,127,127
"68321",2015,0,0,72,72
"68321",2017,0,0,127,127
"68322",2017,0,0,127,127
"68323",2017,0,0,127,127
"68324",2015,0,0,34,34
"68324",2017,0,0,127,127
"68325",2015,0,0,34,34
"68325",2017,0,0,127,127
"68326",2015,0,0,34,34
"68326",2017,0,0,127,127
"68327",2015,0,0,34,34
"68327",2017,0,0,127,127
"68328",2015,0,0,57,57
"68328",2017,0,0,127,127
"68329",2015,0,0,72,72
"68329",2017,0,0,127,127
"68330",2015,0,0,34,34
"68330",2017,0,0,127,127
"68331",2015,0,0,72,72
"68331",2017,0,0,127,127
"68332",2015,0,0,34,34
"68332",2017,0,0,127,127
"68333",2015,0,0,34,34
"68333",2017,0,0,127,127
"68334",2015,0,0,57,57
"68334",2017,0,0,127,127
"68335",2015,0,0,53,53
"68335",2017,0,0,127,127
"68336",2015,0,0,34,34
"68336",2017,0,0,127,127
"68337",2015,0,0,34,34
"68337",2017,0,0,127,127
"68338",2015,0,0,72,72
"68338",2017,0,0,127,127
"68340",2015,0,0,34,34
"68340",2017,0,0,127,127
"68341",2017,0,0,127,127
"68342",2015,0,0,72,72
"68342",2017,0,0,127,127
"68343",2015,0,0,72,72
"68343",2017,0,0,127,127
"68344",2017,0,0,127,127
"68345",2017,0,0,127,127
"68347",2015,0,0,34,34
"68347",2017,0,0,127,127
"68348",2017,0,0,127,127
"68349",2017,0,0,127,127
"68350",2015,0,0,72,72
"68350",2017,0,0,127,127
"68351",2017,0,0,127,127
"68352",2017,0,0,127,127
"68353",2015,0,0,34,34
"68353",2017,0,0,127,127
"68354",2015,0,0,72,72
"68354",2017,0,0,127,127
"68355",2015,0,0,34,34
"68355",2017,0,0,127,127
"68356",2015,0,0,34,34
"68356",2017,0,0,127,127
"68357",2017,0,0,127,127
"68358",2015,0,0,72,72
"68358",2017,0,0,127,127
"68359",2015,0,0,72,72
"68359",2017,0,0,127,127
"68360",2017,0,0,127,127
"68361",2015,0,0,57,57
"68361",2017,0,0,127,127
"68362",2017,0,0,127,127
"68363",2015,0,0,34,34
"68363",2017,0,0,127,127
"68364",2015,0,0,72,72
"68364",2017,0,0,127,127
"68365",2015,0,0,72,72
"68365",2017,0,0,127,127
"68366",2017,0,0,127,127
"68367",2017,0,0,127,127
"68368",2015,0,0,72,72
"68368",2017,0,0,127,127
"68370",2015,0,0,72,72
"68370",2017,0,0,127,127
"68371",2015,0,0,34,34
"68371",2017,0,0,127,127
"68372",2015,0,0,72,72
"68372",2017,0,0,127,127
"68373",2015,0,0,34,34
"68373",2017,0,0,127,127
"68374",2015,0,0,72,72
"68374",2017,0,0,127,127
"68375",2015,0,0,57,57
"68375",2017,0,0,127,127
"68376",2015,0,0,34,34
"68376",2017,0,0,127,127
"68377",2015,0,0,34,34
"68377",2017,0,0,127,127
"68378",2015,0,0,34,34
"68378",2017,0,0,127,127
"68379",2017,0,0,127,127
"68380",2017,0,0,57,57
"68381",2015,0,0,72,72
"68381",2017,0,0,127,127
"68382",2015,0,0,34,34
"68382",2017,0,0,127,127
"68383",2015,0,0,72,72
"68383",2017,0,0,127,127
"68384",2015,0,0,34,34
"68384",2017,0,0,127,127
"68385",2015,0,0,72,72
"68385",2017,0,0,127,127
"68386",2017,0,0,127,127
"69001",2016,0,0,53,53
"69001",2017,0,0,168,168
"69001",2018,0,0,14,14
"69001",2019,0,0,147,147
"69001",2020,0,0,99,99
"69002",2016,0,0,53,53
"69002",2017,0,0,51,51
"69002",2018,0,0,14,14
"69002",2019,0,0,116,116
"69002",2020,0,0,99,99
"69003",2015,0,5,0,5
"69003",2016,0,0,53,53
"69003",2017,0,0,168,168
"69003",2018,0,0,14,14
"69003",2019,0,0,147,147
"69003",2020,0,0,99,99
"69004",2016,0,0,53,53
"69004",2017,0,0,51,51
"69004",2018,0,0,14,14
"69004",2019,0,0,116,116
"69004",2020,0,0,99,99
"69005",2015,0,100,0,100
"69005",2016,0,0,53,53
"69005",2017,0,51,51,102
"69005",2018,0,0,14,14
"69005",2019,0,31,116,147
"69005",2020,0,39,99,138
"69006",2016,0,0,53,53
"69006",2017,0,0,51,51
"69006",2018,0,0,14,14
"69006",2019,0,0,116,116
"69006",2020,0,0,99,99
"69007",2016,0,0,53,53
"69007",2017,0,0,168,168
"69007",2018,0,0,14,14
"69007",2019,0,0,147,147
"69007",2020,0,0,99,99
"69008",2016,0,0,53,53
"69008",2017,0,0,168,168
"69008",2018,0,0,14,14
"69008",2019,0,0,147,147
"69008",2020,0,0,99,99
"69009",2015,0,100,0,100
"69009",2016,0,0,53,53
"69009",2017,0,51,51,102
"69009",2018,0,0,14,14
"69009",2019,0,31,116,147
"69009",2020,0,39,99,138
"69010",2016,0,0,53,53
"69010",2017,0,0,168,168
"69010",2018,0,0,14,14
"69010",2019,0,0,147,147
"69010",2020,0,0,99,99
"69012",2016,0,0,53,53
"69012",2017,0,0,51,51
"69012",2018,0,0,14,14
"69012",2019,0,0,116,116
"69012",2020,0,0,99,99
"69013",2015,0,100,0,100
"69013",2016,0,0,53,53
"69013",2017,0,51,51,102
"69013",2018,0,0,14,14
"69013",2019,0,31,116,147
"69013",2020,0,39,99,138
"69014",2016,0,0,53,53
"69014",2017,0,0,168,168
"69014",2018,0,0,14,14
"69014",2019,0,0,147,147
"69014",2020,0,0,99,99
"69016",2016,0,0,53,53
"69016",2017,0,0,51,51
"69016",2018,0,0,14,14
"69016",2019,0,0,116,116
"69016",2020,0,0,99,99
"69017",2016,0,0,53,53
"69017",2017,0,0,51,51
"69017",2018,0,0,14,14
"69017",2019,0,0,116,116
"69017",2020,0,0,99,99
"69018",2016,0,0,53,53
"69018",2017,0,0,51,51
"69018",2018,0,0,14,14
"69018",2019,0,0,116,116
"69018",2020,0,0,99,99
"69019",2015,0,100,0,100
"69019",2016,0,0,53,53
"69019",2017,0,51,51,102
"69019",2018,0,0,14,14
"69019",2019,0,31,116,147
"69019",2020,0,39,99,138
"69020",2016,0,0,53,53
"69020",2017,0,0,51,51
"69020",2018,0,0,14,14
"69020",2019,0,0,116,116
"69020",2020,0,0,99,99
"69021",2016,0,0,53,53
"69021",2017,0,0,168,168
"69021",2018,0,0,14,14
"69021",2019,0,0,147,147
"69021",2020,0,0,99,99
"69022",2016,0,0,53,53
"69022",2017,0,0,168,168
"69022",2018,0,0,14,14
"69022",2019,0,0,147,147
"69022",2020,0,0,99,99
"69023",2015,0,95,0,95
"69023",2016,0,0,53,53
"69023",2017,0,51,51,102
"69023",2018,0,0,14,14
"69023",2019,0,31,116,147
"69023",2020,0,39,99,138
"69024",2016,0,0,53,53
"69024",2017,0,0,51,51
"69024",2018,0,0,14,14
"69024",2019,0,0,116,116
"69024",2020,0,0,99,99
"69026",2016,0,0,53,53
"69026",2017,0,0,51,51
"69026",2018,0,0,14,14
"69026",2019,0,0,116,116
"69026",2020,0,0,99,99
"69027",2015,0,100,0,100
"69027",2016,0,0,53,53
"69027",2017,0,168,168,336
"69027",2018,0,15,14,29
"69027",2019,0,31,147,178
"69027",2020,0,234,99,333
"69028",2016,0,0,53,53
"69028",2017,0,168,168,336
"69028",2018,0,15,14,29
"69028",2019,0,31,147,178
"69028",2020,0,234,99,333
"69029",2015,0,100,0,100
"69029",2016,0,0,53,53
"69029",2017,0,168,168,336
"69029",2018,0,185,14,199
"69029",2019,0,31,147,178
"69029",2020,0,234,99,333
"69030",2016,0,0,53,53
"69030",2017,0,0,168,168
"69030",2018,0,0,14,14
"69030",2019,0,0,147,147
"69030",2020,0,0,99,99
"69031",2016,0,0,53,53
"69031",2017,0,0,168,168
"69031",2018,0,0,14,14
"69031",2019,0,0,147,147
"69031",2020,0,0,99,99
"69032",2016,0,0,53,53
"69032",2017,0,0,51,51
"69032",2018,0,0,14,14
"69032",2019,0,0,116,116
"69032",2020,0,0,99,99
"69033",2016,0,0,53,53
"69033",2017,0,0,168,168
"69033",2018,0,0,14,14
"69033",2019,0,0,147,147
"69033",2020,0,0,99,99
"69034",2015,0,5,0,5
"69034",2016,0,0,53,53
"69034",2017,0,168,168,336
"69034",2018,0,185,14,199
"69034",2019,0,31,147,178
"69034",2020,0,234,99,333
"69035",2016,0,0,53,53
"69035",2017,0,0,51,51
"69035",2018,0,0,14,14
"69035",2019,0,0,116,116
"69035",2020,0,0,99,99
"69036",2015,0,95,0,95
"69036",2016,0,0,53,53
"69036",2017,0,51,51,102
"69036",2018,0,0,14,14
"69036",2019,0,31,116,147
"69036",2020,0,39,99,138
"69037",2016,0,0,53,53
"69037",2017,0,0,51,51
"69037",2018,0,0,14,14
"69037",2019,0,0,116,116
"69037",2020,0,0,99,99
"69038",2016,0,0,53,53
"69038",2017,0,0,168,168
"69038",2018,0,0,14,14
"69038",2019,0,0,147,147
"69038",2020,0,0,99,99
"69039",2016,0,0,53,53
"69039",2017,0,0,51,51
"69039",2018,0,0,14,14
"69039",2019,0,0,116,116
"69039",2020,0,0,99,99
"69040",2016,0,0,53,53
"69040",2017,0,0,168,168
"69040",2018,0,0,14,14
"69040",2019,0,0,147,147
"69040",2020,0,0,99,99
"69042",2016,0,0,53,53
"69042",2017,0,0,168,168
"69042",2018,0,0,14,14
"69042",2019,0,0,147,147
"69042",2020,0,0,99,99
"69043",2015,0,100,0,100
"69043",2016,0,0,53,53
"69043",2017,0,168,168,336
"69043",2018,0,15,14,29
"69043",2019,0,31,147,178
"69043",2020,0,234,99,333
"69044",2016,0,0,53,53
"69044",2017,0,168,168,336
"69044",2018,0,15,14,29
"69044",2019,0,31,147,178
"69044",2020,0,234,99,333
"69045",2015,0,100,0,100
"69045",2016,0,0,53,53
"69045",2017,0,51,51,102
"69045",2018,0,0,14,14
"69045",2019,0,31,116,147
"69045",2020,0,39,99,138
"69046",2016,0,0,53,53
"69046",2017,0,168,168,336
"69046",2018,0,15,14,29
"69046",2019,0,31,147,178
"69046",2020,0,234,99,333
"69047",2016,0,0,53,53
"69047",2017,0,0,51,51
"69047",2018,0,0,14,14
"69047",2019,0,0,116,116
"69047",2020,0,0,99,99
"69049",2015,0,100,0,100
"69049",2016,0,0,53,53
"69049",2017,0,51,51,102
"69049",2018,0,0,14,14
"69049",2019,0,31,116,147
"69049",2020,0,39,99,138
"69050",2016,0,0,53,53
"69050",2017,0,0,51,51
"69050",2018,0,0,14,14
"69050",2019,0,0,116,116
"69050",2020,0,0,99,99
"69051",2016,0,0,53,53
"69051",2017,0,168,168,336
"69051",2018,0,15,14,29
"69051",2019,0,31,147,178
"69051",2020,0,234,99,333
"69052",2015,0,5,0,5
"69052",2016,0,0,53,53
"69052",2017,0,0,51,51
"69052",2018,0,0,14,14
"69052",2019,0,0,116,116
"69052",2020,0,0,99,99
"69053",2015,0,95,0,95
"69053",2016,0,0,53,53
"69053",2017,0,0,51,51
"69053",2018,0,0,14,14
"69053",2019,0,0,116,116
"69053",2020,0,0,99,99
"69054",2016,0,0,53,53
"69054",2017,0,0,51,51
"69054",2018,0,0,14,14
"69054",2019,0,0,116,116
"69054",2020,0,0,99,99
"69055",2015,0,100,0,100
"69055",2016,0,0,53,53
"69055",2017,0,51,51,102
"69055",2018,0,0,14,14
"69055",2019,0,31,116,147
"69055",2020,0,39,99,138
"69056",2016,0,0,53,53
"69056",2017,0,0,51,51
"69056",2018,0,0,14,14
"69056",2019,0,0,116,116
"69056",2020,0,0,99,99
"69057",2016,0,0,53,53
"69057",2017,0,168,168,336
"69057",2018,0,15,14,29
"69057",2019,0,31,147,178
"69057",2020,0,234,99,333
"69058",2016,0,0,53,53
"69058",2017,0,0,51,51
"69058",2018,0,0,14,14
"69058",2019,0,0,116,116
"69058",2020,0,0,99,99
"69059",2015,0,5,0,5
"69059",2016,0,0,53,53
"69059",2017,0,0,51,51
"69059",2018,0,0,14,14
"69059",2019,0,0,116,116
"69059",2020,0,0,99,99
"69060",2016,0,0,53,53
"69060",2017,0,0,51,51
"69060",2018,0,0,14,14
"69060",2019,0,0,116,116
"69060",2020,0,0,99,99
"69061",2016,0,0,53,53
"69061",2017,0,0,51,51
"69061",2018,0,0,14,14
"69061",2019,0,0,116,116
"69061",2020,0,0,99,99
"69062",2016,0,0,53,53
"69062",2017,0,0,168,168
"69062",2018,0,0,14,14
"69062",2019,0,0,147,147
"69062",2020,0,0,99,99
"69063",2015,0,5,0,5
"69063",2016,0,0,53,53
"69063",2017,0,0,168,168
"69063",2018,0,0,14,14
"69063",2019,0,0,147,147
"69063",2020,0,0,99,99
"69064",2016,0,0,53,53
"69064",2017,0,0,168,168
"69064",2018,0,0,14,14
"69064",2019,0,0,147,147
"69064",2020,0,0,99,99
"69065",2015,0,100,0,100
"69065",2016,0,0,53,53
"69065",2017,0,51,51,102
"69065",2018,0,0,14,14
"69065",2019,0,31,116,147
"69065",2020,0,39,99,138
"69066",2016,0,0,53,53
"69066",2017,0,0,51,51
"69066",2018,0,0,14,14
"69066",2019,0,0,116,116
"69066",2020,0,0,99,99
"69067",2016,0,0,53,53
"69067",2017,0,168,168,336
"69067",2018,0,15,14,29
"69067",2019,0,31,147,178
"69067",2020,0,234,99,333
"69068",2015,0,5,0,5
"69068",2016,0,0,53,53
"69068",2017,0,0,168,168
"69068",2018,0,0,14,14
"69068",2019,0,0,147,147
"69068",2020,0,0,99,99
"69069",2016,0,0,53,53
"69069",2017,0,168,168,336
"69069",2018,0,15,14,29
"69069",2019,0,31,147,178
"69069",2020,0,234,99,333
"69070",2016,0,0,53,53
"69070",2017,0,0,51,51
"69070",2018,0,0,14,14
"69070",2019,0,0,116,116
"69070",2020,0,0,99,99
"69071",2015,0,5,0,5
"69071",2016,0,0,53,53
"69071",2017,0,0,168,168
"69071",2018,0,0,14,14
"69071",2019,0,0,147,147
"69071",2020,0,0,99,99
"69072",2016,0,0,53,53
"69072",2017,0,168,51,219
"69072",2018,0,15,14,29
"69072",2019,0,31,116,147
"69072",2020,0,234,99,333
"69074",2015,0,95,0,95
"69074",2016,0,0,53,53
"69074",2017,0,51,51,102
"69074",2018,0,0,14,14
"69074",2019,0,31,116,147
"69074",2020,0,39,99,138
"69075",2016,0,0,53,53
"69075",2017,0,0,51,51
"69075",2018,0,0,14,14
"69075",2019,0,0,116,116
"69075",2020,0,0,99,99
"69076",2016,0,0,53,53
"69076",2017,0,168,51,219
"69076",2018,0,15,14,29
"69076",2019,0,31,116,147
"69076",2020,0,234,99,333
"69077",2015,0,100,0,100
"69077",2016,0,0,53,53
"69077",2017,0,51,51,102
"69077",2018,0,0,14,14
"69077",2019,0,31,116,147
"69077",2020,0,39,99,138
"69078",2016,0,0,53,53
"69078",2017,0,0,168,168
"69078",2018,0,0,14,14
"69078",2019,0,0,147,147
"69078",2020,0,0,99,99
"69080",2016,0,0,53,53
"69080",2017,0,0,168,168
"69080",2018,0,0,14,14
"69080",2019,0,0,147,147
"69080",2020,0,0,99,99
"69081",2015,0,5,0,5
"69081",2016,0,0,53,53
"69081",2017,0,168,168,336
"69081",2018,0,15,14,29
"69081",2019,0,31,147,178
"69081",2020,0,234,99,333
"69082",2016,0,0,53,53
"69082",2017,0,0,51,51
"69082",2018,0,0,14,14
"69082",2019,0,0,116,116
"69082",2020,0,0,99,99
"69083",2016,0,0,53,53
"69083",2017,0,168,168,336
"69083",2018,0,15,14,29
"69083",2019,0,31,147,178
"69083",2020,0,234,99,333
"69084",2015,0,95,0,95
"69084",2016,0,0,53,53
"69084",2017,0,51,51,102
"69084",2018,0,0,14,14
"69084",2019,0,31,116,147
"69084",2020,0,39,99,138
"69085",2015,0,5,0,5
"69085",2016,0,0,53,53
"69085",2017,0,0,168,168
"69085",2018,0,0,14,14
"69085",2019,0,0,147,147
"69085",2020,0,0,99,99
"69086",2016,0,0,53,53
"69086",2017,0,168,51,219
"69086",2018,0,15,14,29
"69086",2019,0,31,116,147
"69086",2020,0,234,99,333
"69087",2015,0,5,0,5
"69087",2016,0,0,53,53
"69087",2017,0,0,168,168
"69087",2018,0,0,14,14
"69087",2019,0,0,147,147
"69087",2020,0,0,99,99
"69088",2015,0,5,0,5
"69088",2016,0,0,53,53
"69088",2017,0,0,168,168
"69088",2018,0,0,14,14
"69088",2019,0,0,147,147
"69088",2020,0,0,99,99
"69089",2016,0,0,53,53
"69089",2017,0,168,168,336
"69089",2018,0,15,14,29
"69089",2019,0,31,147,178
"69089",2020,0,234,99,333
"69090",2016,0,0,53,53
"69090",2017,0,0,51,51
"69090",2018,0,0,14,14
"69090",2019,0,0,116,116
"69090",2020,0,0,99,99
"69091",2015,0,100,0,100
"69091",2016,0,0,53,53
"69091",2017,0,168,168,336
"69091",2018,0,15,14,29
"69091",2019,0,31,147,178
"69091",2020,0,234,99,333
"69092",2015,0,100,0,100
"69092",2016,0,0,53,53
"69092",2017,0,51,51,102
"69092",2018,0,0,14,14
"69092",2019,0,31,116,147
"69092",2020,0,39,99,138
"69093",2016,0,0,53,53
"69093",2017,0,0,51,51
"69093",2018,0,0,14,14
"69093",2019,0,0,116,116
"69093",2020,0,0,99,99
"69094",2016,0,0,53,53
"69094",2017,0,168,168,336
"69094",2018,0,15,14,29
"69094",2019,0,31,147,178
"69094",2020,0,234,99,333
"69095",2016,0,0,53,53
"69095",2017,0,0,168,168
"69095",2018,0,0,14,14
"69095",2019,0,0,147,147
"69095",2020,0,0,99,99
"69096",2015,0,100,0,100
"69096",2016,0,0,53,53
"69096",2017,0,51,168,219
"69096",2018,0,15,14,29
"69096",2019,0,31,147,178
"69096",2020,0,39,99,138
"69097",2016,0,0,53,53
"69097",2017,0,0,168,168
"69097",2018,0,0,14,14
"69097",2019,0,0,147,147
"69097",2020,0,0,99,99
"69098",2016,0,0,53,53
"69098",2017,0,0,168,168
"69098",2018,0,0,14,14
"69098",2019,0,0,147,147
"69098",2020,0,0,99,99
"69099",2016,0,0,53,53
"69099",2017,0,0,168,168
"69099",2018,0,0,14,14
"69099",2019,0,0,147,147
"69099",2020,0,0,99,99
"69100",2015,0,0,20,20
"69100",2016,0,0,53,53
"69100",2017,0,51,168,219
"69100",2018,0,15,14,29
"69100",2019,0,31,147,178
"69100",2020,0,39,99,138
"69102",2016,0,0,53,53
"69102",2017,0,0,51,51
"69102",2018,0,0,14,14
"69102",2019,0,0,116,116
"69102",2020,0,0,99,99
"69103",2016,0,0,53,53
"69103",2017,0,0,51,51
"69103",2018,0,0,14,14
"69103",2019,0,0,116,116
"69103",2020,0,0,99,99
"69104",2016,0,0,53,53
"69104",2017,0,0,51,51
"69104",2018,0,0,14,14
"69104",2019,0,0,116,116
"69104",2020,0,0,99,99
"69105",2016,0,0,53,53
"69105",2017,0,51,51,102
"69105",2018,0,0,14,14
"69105",2019,0,31,116,147
"69105",2020,0,39,99,138
"69106",2015,0,95,0,95
"69106",2016,0,0,53,53
"69106",2017,0,51,51,102
"69106",2018,0,0,14,14
"69106",2019,0,31,116,147
"69106",2020,0,39,99,138
"69107",2016,0,0,53,53
"69107",2017,0,0,51,51
"69107",2018,0,0,14,14
"69107",2019,0,0,116,116
"69107",2020,0,0,99,99
"69108",2015,0,100,0,100
"69108",2016,0,0,53,53
"69108",2017,0,51,51,102
"69108",2018,0,0,14,14
"69108",2019,0,31,116,147
"69108",2020,0,39,99,138
"69109",2016,0,0,53,53
"69109",2017,0,0,51,51
"69109",2018,0,0,14,14
"69109",2019,0,0,116,116
"69109",2020,0,0,99,99
"69110",2016,0,0,53,53
"69110",2017,0,0,168,168
"69110",2018,0,0,14,14
"69110",2019,0,0,147,147
"69110",2020,0,0,99,99
"69111",2016,0,0,53,53
"69111",2017,0,0,51,51
"69111",2018,0,0,14,14
"69111",2019,0,0,116,116
"69111",2020,0,0,99,99
"69112",2016,0,0,53,53
"69112",2017,0,168,51,219
"69112",2018,0,15,14,29
"69112",2019,0,31,116,147
"69112",2020,0,234,99,333
"69113",2016,0,0,53,53
"69113",2017,0,0,51,51
"69113",2018,0,0,14,14
"69113",2019,0,0,116,116
"69113",2020,0,0,99,99
"69115",2015,0,100,0,100
"69115",2016,0,0,53,53
"69115",2017,0,51,51,102
"69115",2018,0,0,14,14
"69115",2019,0,31,116,147
"69115",2020,0,39,99,138
"69116",2016,0,0,53,53
"69116",2017,0,0,51,51
"69116",2018,0,0,14,14
"69116",2019,0,0,116,116
"69116",2020,0,0,99,99
"69117",2015,0,5,0,5
"69117",2016,0,0,53,53
"69117",2017,0,51,51,102
"69117",2018,0,0,14,14
"69117",2019,0,31,116,147
"69117",2020,0,39,99,138
"69118",2016,0,0,53,53
"69118",2017,0,0,168,168
"69118",2018,0,0,14,14
"69118",2019,0,0,147,147
"69118",2020,0,0,99,99
"69119",2016,0,0,53,53
"69119",2017,0,0,168,168
"69119",2018,0,0,14,14
"69119",2019,0,0,147,147
"69119",2020,0,0,99,99
"69120",2016,0,0,53,53
"69120",2017,0,0,168,168
"69120",2018,0,0,14,14
"69120",2019,0,0,147,147
"69120",2020,0,0,99,99
"69121",2015,0,5,0,5
"69121",2016,0,0,53,53
"69121",2017,0,168,51,219
"69121",2018,0,15,14,29
"69121",2019,0,31,116,147
"69121",2020,0,234,99,333
"69122",2015,0,100,0,100
"69122",2016,0,0,53,53
"69122",2017,0,51,51,102
"69122",2018,0,0,14,14
"69122",2019,0,31,116,147
"69122",2020,0,39,99,138
"69123",2015,0,100,0,100
"69123",2016,0,0,53,53
"69123",2017,0,51,168,219
"69123",2018,0,15,14,29
"69123",2019,0,31,147,178
"69123",2020,0,39,99,138
"69124",2016,0,0,53,53
"69124",2017,0,0,51,51
"69124",2018,0,0,14,14
"69124",2019,0,0,116,116
"69124",2020,0,0,99,99
"69125",2015,0,5,0,5
"69125",2016,0,0,53,53
"69125",2017,0,51,51,102
"69125",2018,0,0,14,14
"69125",2019,0,31,116,147
"69125",2020,0,39,99,138
"69126",2016,0,0,53,53
"69126",2017,0,51,51,102
"69126",2018,0,0,14,14
"69126",2019,0,31,116,147
"69126",2020,0,39,99,138
"69127",2016,0,0,53,53
"69127",2017,0,168,168,336
"69127",2018,0,15,14,29
"69127",2019,0,31,147,178
"69127",2020,0,234,99,333
"69130",2016,0,0,53,53
"69130",2017,0,0,51,51
"69130",2018,0,0,14,14
"69130",2019,0,0,116,116
"69130",2020,0,0,99,99
"69131",2016,0,0,53,53
"69131",2017,0,168,168,336
"69131",2018,0,15,14,29
"69131",2019,0,31,147,178
"69131",2020,0,234,99,333
"69132",2016,0,0,53,53
"69132",2017,0,0,168,168
"69132",2018,0,0,14,14
"69132",2019,0,0,147,147
"69132",2020,0,0,99,99
"69133",2015,0,100,0,100
"69133",2016,0,0,53,53
"69133",2017,0,168,168,336
"69133",2018,0,15,14,29
"69133",2019,0,31,147,178
"69133",2020,0,234,99,333
"69134",2016,0,0,53,53
"69134",2017,0,0,51,51
"69134",2018,0,0,14,14
"69134",2019,0,0,116,116
"69134",2020,0,0,99,99
"69135",2016,0,0,53,53
"69135",2017,0,0,51,51
"69135",2018,0,0,14,14
"69135",2019,0,0,116,116
"69135",2020,0,0,99,99
"69136",2015,0,100,0,100
"69136",2016,0,0,53,53
"69136",2017,0,168,168,336
"69136",2018,0,15,14,29
"69136",2019,0,31,147,178
"69136",2020,0,234,99,333
"69137",2016,0,0,53,53
"69137",2017,0,0,51,51
"69137",2018,0,0,14,14
"69137",2019,0,0,116,116
"69137",2020,0,0,99,99
"69138",2016,0,0,53,53
"69138",2017,0,168,168,336
"69138",2018,0,15,14,29
"69138",2019,0,31,147,178
"69138",2020,0,234,99,333
"69139",2016,0,0,53,53
"69139",2017,0,0,168,168
"69139",2018,0,0,14,14
"69139",2019,0,0,147,147
"69139",2020,0,0,99,99
"69140",2015,0,100,0,100
"69140",2016,0,0,53,53
"69140",2017,0,51,51,102
"69140",2018,0,0,14,14
"69140",2019,0,31,116,147
"69140",2020,0,39,99,138
"69141",2016,0,0,53,53
"69141",2017,0,168,168,336
"69141",2018,0,15,14,29
"69141",2019,0,31,147,178
"69141",2020,0,234,99,333
"69142",2016,0,0,53,53
"69142",2017,0,168,168,336
"69142",2018,0,15,14,29
"69142",2019,0,31,147,178
"69142",2020,0,234,99,333
"69143",2015,0,5,0,5
"69143",2016,0,0,53,53
"69143",2017,0,0,168,168
"69143",2018,0,0,14,14
"69143",2019,0,0,147,147
"69143",2020,0,0,99,99
"69145",2016,0,0,53,53
"69145",2017,0,51,51,102
"69145",2018,0,0,14,14
"69145",2019,0,31,116,147
"69145",2020,0,39,99,138
"69148",2016,0,0,53,53
"69148",2017,0,168,168,336
"69148",2018,0,15,14,29
"69148",2019,0,31,147,178
"69148",2020,0,234,99,333
"69149",2016,0,0,53,53
"69149",2017,0,168,168,336
"69149",2018,0,15,14,29
"69149",2019,0,31,147,178
"69149",2020,0,234,99,333
"69151",2016,0,0,53,53
"69151",2017,0,0,51,51
"69151",2018,0,0,14,14
"69151",2019,0,0,116,116
"69151",2020,0,0,99,99
"69153",2016,0,0,53,53
"69153",2017,0,0,51,51
"69153",2018,0,0,14,14
"69153",2019,0,0,116,116
"69153",2020,0,0,99,99
"69154",2016,0,0,53,53
"69154",2017,0,168,168,336
"69154",2018,0,15,14,29
"69154",2019,0,31,147,178
"69154",2020,0,234,99,333
"69155",2016,0,0,53,53
"69155",2017,0,0,168,168
"69155",2018,0,0,14,14
"69155",2019,0,0,147,147
"69155",2020,0,0,99,99
"69156",2015,0,100,0,100
"69156",2016,0,0,53,53
"69156",2017,0,51,51,102
"69156",2018,0,0,14,14
"69156",2019,0,31,116,147
"69156",2020,0,39,99,138
"69157",2016,0,0,53,53
"69157",2017,0,0,51,51
"69157",2018,0,0,14,14
"69157",2019,0,0,116,116
"69157",2020,0,0,99,99
"69159",2015,0,95,0,95
"69159",2016,0,0,53,53
"69159",2017,0,51,51,102
"69159",2018,0,0,14,14
"69159",2019,0,31,116,147
"69159",2020,0,39,99,138
"69160",2016,0,0,53,53
"69160",2017,0,0,51,51
"69160",2018,0,0,14,14
"69160",2019,0,0,116,116
"69160",2020,0,0,99,99
"69161",2016,0,0,53,53
"69161",2017,0,0,51,51
"69161",2018,0,0,14,14
"69161",2019,0,0,116,116
"69161",2020,0,0,99,99
"69162",2016,0,0,53,53
"69162",2017,0,0,51,51
"69162",2018,0,0,14,14
"69162",2019,0,0,116,116
"69162",2020,0,0,99,99
"69163",2015,0,100,0,100
"69163",2016,0,0,53,53
"69163",2017,0,51,51,102
"69163",2018,0,0,14,14
"69163",2019,0,31,116,147
"69163",2020,0,39,99,138
"69164",2016,0,0,53,53
"69164",2017,0,0,51,51
"69164",2018,0,0,14,14
"69164",2019,0,0,116,116
"69164",2020,0,0,99,99
"69165",2016,0,0,53,53
"69165",2017,0,0,51,51
"69165",2018,0,0,14,14
"69165",2019,0,0,116,116
"69165",2020,0,0,99,99
"69166",2016,0,0,53,53
"69166",2017,0,0,168,168
"69166",2018,0,0,14,14
"69166",2019,0,0,147,147
"69166",2020,0,0,99,99
"69167",2016,0,0,53,53
"69167",2017,0,0,51,51
"69167",2018,0,0,14,14
"69167",2019,0,0,116,116
"69167",2020,0,0,99,99
"69168",2015,0,5,0,5
"69168",2016,0,0,53,53
"69168",2017,0,0,168,168
"69168",2018,0,0,14,14
"69168",2019,0,0,147,147
"69168",2020,0,0,99,99
"69169",2016,0,0,53,53
"69169",2017,0,0,51,51
"69169",2018,0,0,14,14
"69169",2019,0,0,116,116
"69169",2020,0,0,99,99
"69170",2016,0,0,53,53
"69170",2017,0,168,168,336
"69170",2018,0,15,14,29
"69170",2019,0,31,147,178
"69170",2020,0,234,99,333
"69171",2016,0,0,53,53
"69171",2017,0,0,168,168
"69171",2018,0,0,14,14
"69171",2019,0,0,147,147
"69171",2020,0,0,99,99
"69172",2016,0,0,53,53
"69172",2017,0,0,51,51
"69172",2018,0,0,14,14
"69172",2019,0,0,116,116
"69172",2020,0,0,99,99
"69173",2016,0,0,53,53
"69173",2017,0,0,51,51
"69173",2018,0,0,14,14
"69173",2019,0,0,116,116
"69173",2020,0,0,99,99
"69174",2016,0,0,53,53
"69174",2017,0,0,51,51
"69174",2018,0,0,14,14
"69174",2019,0,0,116,116
"69174",2020,0,0,99,99
"69175",2016,0,0,53,53
"69175",2017,0,0,168,168
"69175",2018,0,0,14,14
"69175",2019,0,0,147,147
"69175",2020,0,0,99,99
"69176",2015,0,100,0,100
"69176",2016,0,0,53,53
"69176",2017,0,168,168,336
"69176",2018,0,15,14,29
"69176",2019,0,31,147,178
"69176",2020,0,234,99,333
"69177",2016,0,0,53,53
"69177",2017,0,168,168,336
"69177",2018,0,15,14,29
"69177",2019,0,31,147,178
"69177",2020,0,234,99,333
"69178",2016,0,0,53,53
"69178",2017,0,0,168,168
"69178",2018,0,0,14,14
"69178",2019,0,0,147,147
"69178",2020,0,0,99,99
"69179",2016,0,0,53,53
"69179",2017,0,168,168,336
"69179",2018,0,15,14,29
"69179",2019,0,31,147,178
"69179",2020,0,234,99,333
"69180",2016,0,0,53,53
"69180",2017,0,168,168,336
"69180",2018,0,15,14,29
"69180",2019,0,31,147,178
"69180",2020,0,234,99,333
"69181",2016,0,0,53,53
"69181",2017,0,0,51,51
"69181",2018,0,0,14,14
"69181",2019,0,0,116,116
"69181",2020,0,0,99,99
"69182",2016,0,0,53,53
"69182",2017,0,0,51,51
"69182",2018,0,0,14,14
"69182",2019,0,0,116,116
"69182",2020,0,0,99,99
"69183",2016,0,0,53,53
"69183",2017,0,0,51,51
"69183",2018,0,0,14,14
"69183",2019,0,0,116,116
"69183",2020,0,0,99,99
"69184",2016,0,0,53,53
"69184",2017,0,0,168,168
"69184",2018,0,0,14,14
"69184",2019,0,0,147,147
"69184",2020,0,0,99,99
"69186",2016,0,0,53,53
"69186",2017,0,0,51,51
"69186",2018,0,0,14,14
"69186",2019,0,0,116,116
"69186",2020,0,0,99,99
"69187",2016,0,0,53,53
"69187",2017,0,0,168,168
"69187",2018,0,0,14,14
"69187",2019,0,0,147,147
"69187",2020,0,0,99,99
"69188",2016,0,0,53,53
"69188",2017,0,0,51,51
"69188",2018,0,0,14,14
"69188",2019,0,0,116,116
"69188",2020,0,0,99,99
"69189",2016,0,0,53,53
"69189",2017,0,0,168,168
"69189",2018,0,0,14,14
"69189",2019,0,0,147,147
"69189",2020,0,0,99,99
"69190",2016,0,0,53,53
"69190",2017,0,168,168,336
"69190",2018,0,15,14,29
"69190",2019,0,31,147,178
"69190",2020,0,234,99,333
"69191",2016,0,0,53,53
"69191",2017,0,0,168,168
"69191",2018,0,0,14,14
"69191",2019,0,0,147,147
"69191",2020,0,0,99,99
"69192",2016,0,0,53,53
"69192",2017,0,0,51,51
"69192",2018,0,0,14,14
"69192",2019,0,0,116,116
"69192",2020,0,0,99,99
"69193",2016,0,0,53,53
"69193",2017,0,0,168,168
"69193",2018,0,0,14,14
"69193",2019,0,0,147,147
"69193",2020,0,0,99,99
"69194",2016,0,0,53,53
"69194",2017,0,0,168,168
"69194",2018,0,0,14,14
"69194",2019,0,0,147,147
"69194",2020,0,0,99,99
"69196",2016,0,0,53,53
"69196",2017,0,0,51,51
"69196",2018,0,0,14,14
"69196",2019,0,0,116,116
"69196",2020,0,0,99,99
"69197",2015,0,100,0,100
"69197",2016,0,0,53,53
"69197",2017,0,51,51,102
"69197",2018,0,0,14,14
"69197",2019,0,31,116,147
"69197",2020,0,39,99,138
"69198",2016,0,0,53,53
"69198",2017,0,0,51,51
"69198",2018,0,0,14,14
"69198",2019,0,0,116,116
"69198",2020,0,0,99,99
"69199",2015,0,100,20,120
"69199",2016,0,0,53,53
"69199",2017,0,51,168,219
"69199",2018,0,15,14,29
"69199",2019,0,31,147,178
"69199",2020,0,39,99,138
"69200",2016,0,0,53,53
"69200",2017,0,0,168,168
"69200",2018,0,0,14,14
"69200",2019,0,0,147,147
"69200",2020,0,0,99,99
"69201",2016,0,0,53,53
"69201",2017,0,0,168,168
"69201",2018,0,0,14,14
"69201",2019,0,0,147,147
"69201",2020,0,0,99,99
"69202",2016,0,0,53,53
"69202",2017,0,168,168,336
"69202",2018,0,15,14,29
"69202",2019,0,31,147,178
"69202",2020,0,234,99,333
"69203",2016,0,0,53,53
"69203",2017,0,0,168,168
"69203",2018,0,0,14,14
"69203",2019,0,0,147,147
"69203",2020,0,0,99,99
"69204",2016,0,0,53,53
"69204",2017,0,168,168,336
"69204",2018,0,15,14,29
"69204",2019,0,31,147,178
"69204",2020,0,234,99,333
"69205",2016,0,0,53,53
"69205",2017,0,168,168,336
"69205",2018,0,15,14,29
"69205",2019,0,31,147,178
"69205",2020,0,234,99,333
"69206",2015,0,100,0,100
"69206",2016,0,0,53,53
"69206",2017,0,51,51,102
"69206",2018,0,0,14,14
"69206",2019,0,31,116,147
"69206",2020,0,39,99,138
"69207",2015,0,100,0,100
"69207",2016,0,0,53,53
"69207",2017,0,51,51,102
"69207",2018,0,0,14,14
"69207",2019,0,31,116,147
"69207",2020,0,39,99,138
"69208",2016,0,0,53,53
"69208",2017,0,0,51,51
"69208",2018,0,0,14,14
"69208",2019,0,0,116,116
"69208",2020,0,0,99,99
"69209",2016,0,0,53,53
"69209",2017,0,0,51,51
"69209",2018,0,0,14,14
"69209",2019,0,0,116,116
"69209",2020,0,0,99,99
"69212",2016,0,0,53,53
"69212",2017,0,0,51,51
"69212",2018,0,0,14,14
"69212",2019,0,0,116,116
"69212",2020,0,0,99,99
"69214",2016,0,0,53,53
"69214",2017,0,0,51,51
"69214",2018,0,0,14,14
"69214",2019,0,0,116,116
"69214",2020,0,0,99,99
"69215",2015,0,95,0,95
"69215",2016,0,0,53,53
"69215",2017,0,51,51,102
"69215",2018,0,0,14,14
"69215",2019,0,31,116,147
"69215",2020,0,39,99,138
"69216",2016,0,0,53,53
"69216",2017,0,0,168,168
"69216",2018,0,0,14,14
"69216",2019,0,0,147,147
"69216",2020,0,0,99,99
"69217",2016,0,0,53,53
"69217",2017,0,0,51,51
"69217",2018,0,0,14,14
"69217",2019,0,0,116,116
"69217",2020,0,0,99,99
"69218",2015,0,100,0,100
"69218",2016,0,0,53,53
"69218",2017,0,51,51,102
"69218",2018,0,0,14,14
"69218",2019,0,31,116,147
"69218",2020,0,39,99,138
"69219",2016,0,0,53,53
"69219",2017,0,168,168,336
"69219",2018,0,15,14,29
"69219",2019,0,31,147,178
"69219",2020,0,234,99,333
"69220",2016,0,0,53,53
"69220",2017,0,0,168,168
"69220",2018,0,0,14,14
"69220",2019,0,0,147,147
"69220",2020,0,0,99,99
"69225",2016,0,0,53,53
"69225",2017,0,0,168,168
"69225",2018,0,0,14,14
"69225",2019,0,0,147,147
"69225",2020,0,0,99,99
"69227",2016,0,0,53,53
"69227",2017,0,168,168,336
"69227",2018,0,15,14,29
"69227",2019,0,31,147,178
"69227",2020,0,234,99,333
"69228",2016,0,0,53,53
"69228",2017,0,168,168,336
"69228",2018,0,15,14,29
"69228",2019,0,31,147,178
"69228",2020,0,234,99,333
"69229",2016,0,0,53,53
"69229",2017,0,0,51,51
"69229",2018,0,0,14,14
"69229",2019,0,0,116,116
"69229",2020,0,0,99,99
"69230",2016,0,0,53,53
"69230",2017,0,0,51,51
"69230",2018,0,0,14,14
"69230",2019,0,0,116,116
"69230",2020,0,0,99,99
"69231",2016,0,0,53,53
"69231",2017,0,168,168,336
"69231",2018,0,15,14,29
"69231",2019,0,31,147,178
"69231",2020,0,234,99,333
"69233",2015,0,5,0,5
"69233",2016,0,0,53,53
"69233",2017,0,0,168,168
"69233",2018,0,0,14,14
"69233",2019,0,0,147,147
"69233",2020,0,0,99,99
"69234",2016,0,0,53,53
"69234",2017,0,0,168,168
"69234",2018,0,0,14,14
"69234",2019,0,0,147,147
"69234",2020,0,0,99,99
"69235",2016,0,0,53,53
"69235",2017,0,0,168,168
"69235",2018,0,0,14,14
"69235",2019,0,0,147,147
"69235",2020,0,0,99,99
"69236",2016,0,0,53,53
"69236",2017,0,0,168,168
"69236",2018,0,0,14,14
"69236",2019,0,0,147,147
"69236",2020,0,0,99,99
"69238",2016,0,0,53,53
"69238",2017,0,0,168,168
"69238",2018,0,0,14,14
"69238",2019,0,0,147,147
"69238",2020,0,0,99,99
"69239",2016,0,0,53,53
"69239",2017,0,0,51,51
"69239",2018,0,0,14,14
"69239",2019,0,0,116,116
"69239",2020,0,0,99,99
"69240",2016,0,0,53,53
"69240",2017,0,0,51,51
"69240",2018,0,0,14,14
"69240",2019,0,0,116,116
"69240",2020,0,0,99,99
"69241",2016,0,0,53,53
"69241",2017,0,168,168,336
"69241",2018,0,15,14,29
"69241",2019,0,31,147,178
"69241",2020,0,234,99,333
"69242",2015,0,100,0,100
"69242",2016,0,0,53,53
"69242",2017,0,51,51,102
"69242",2018,0,0,14,14
"69242",2019,0,31,116,147
"69242",2020,0,39,99,138
"69243",2016,0,0,53,53
"69243",2017,0,0,51,51
"69243",2018,0,0,14,14
"69243",2019,0,0,116,116
"69243",2020,0,0,99,99
"69244",2016,0,0,53,53
"69244",2017,0,168,168,336
"69244",2018,0,15,14,29
"69244",2019,0,31,147,178
"69244",2020,0,234,99,333
"69245",2016,0,0,53,53
"69245",2017,0,0,51,51
"69245",2018,0,0,14,14
"69245",2019,0,0,116,116
"69245",2020,0,0,99,99
"69246",2016,0,0,53,53
"69246",2017,0,51,51,102
"69246",2018,0,0,14,14
"69246",2019,0,31,116,147
"69246",2020,0,39,99,138
"69248",2016,0,0,53,53
"69248",2017,0,0,51,51
"69248",2018,0,0,14,14
"69248",2019,0,0,116,116
"69248",2020,0,0,99,99
"69249",2016,0,0,53,53
"69249",2017,0,168,168,336
"69249",2018,0,15,14,29
"69249",2019,0,31,147,178
"69249",2020,0,234,99,333
"69250",2016,0,0,53,53
"69250",2017,0,168,51,219
"69250",2018,0,15,14,29
"69250",2019,0,31,116,147
"69250",2020,0,234,99,333
"69252",2016,0,0,53,53
"69252",2017,0,0,168,168
"69252",2018,0,0,14,14
"69252",2019,0,0,147,147
"69252",2020,0,0,99,99
"69253",2016,0,0,53,53
"69253",2017,0,0,168,168
"69253",2018,0,0,14,14
"69253",2019,0,0,147,147
"69253",2020,0,0,99,99
"69254",2016,0,0,53,53
"69254",2017,0,0,51,51
"69254",2018,0,0,14,14
"69254",2019,0,0,116,116
"69254",2020,0,0,99,99
"69255",2016,0,0,53,53
"69255",2017,0,168,168,336
"69255",2018,0,15,14,29
"69255",2019,0,31,147,178
"69255",2020,0,234,99,333
"69256",2015,0,100,0,100
"69256",2016,0,0,53,53
"69256",2017,0,168,168,336
"69256",2018,0,185,14,199
"69256",2019,0,31,147,178
"69256",2020,0,234,99,333
"69257",2016,0,0,53,53
"69257",2017,0,0,51,51
"69257",2018,0,0,14,14
"69257",2019,0,0,116,116
"69257",2020,0,0,99,99
"69258",2016,0,0,53,53
"69258",2017,0,0,51,51
"69258",2018,0,0,14,14
"69258",2019,0,0,116,116
"69258",2020,0,0,99,99
"69259",2015,0,100,20,120
"69259",2016,0,0,53,53
"69259",2017,0,51,168,219
"69259",2018,0,15,14,29
"69259",2019,0,31,147,178
"69259",2020,0,39,99,138
"69260",2016,0,0,53,53
"69260",2017,0,51,168,219
"69260",2018,0,15,14,29
"69260",2019,0,31,147,178
"69260",2020,0,39,99,138
"69261",2016,0,0,53,53
"69261",2017,0,0,51,51
"69261",2018,0,0,14,14
"69261",2019,0,0,116,116
"69261",2020,0,0,99,99
"69263",2016,0,0,53,53
"69263",2017,0,0,168,168
"69263",2018,0,0,14,14
"69263",2019,0,0,147,147
"69263",2020,0,0,99,99
"69264",2015,0,100,0,100
"69264",2016,0,0,53,53
"69264",2017,0,51,51,102
"69264",2018,0,0,14,14
"69264",2019,0,31,116,147
"69264",2020,0,39,99,138
"69265",2016,0,0,53,53
"69265",2017,0,0,51,51
"69265",2018,0,0,14,14
"69265",2019,0,0,116,116
"69265",2020,0,0,99,99
"69266",2015,0,100,0,100
"69266",2016,0,0,53,53
"69266",2017,0,168,168,336
"69266",2018,0,185,14,199
"69266",2019,0,31,147,178
"69266",2020,0,234,99,333
"69267",2015,0,95,0,95
"69267",2016,0,0,53,53
"69267",2017,0,51,51,102
"69267",2018,0,0,14,14
"69267",2019,0,31,116,147
"69267",2020,0,39,99,138
"69268",2015,0,100,0,100
"69268",2016,0,0,53,53
"69268",2017,0,168,168,336
"69268",2018,0,15,14,29
"69268",2019,0,31,147,178
"69268",2020,0,234,99,333
"69269",2016,0,0,53,53
"69269",2017,0,168,168,336
"69269",2018,0,15,14,29
"69269",2019,0,31,147,178
"69269",2020,0,234,99,333
"69270",2015,0,100,115,215
"69270",2016,0,0,53,53
"69270",2017,0,51,168,219
"69270",2018,0,15,14,29
"69270",2019,0,31,147,178
"69270",2020,0,39,99,138
"69271",2015,0,100,0,100
"69271",2017,0,51,168,219
"69271",2018,0,15,14,29
"69271",2019,0,31,147,178
"69271",2020,0,39,99,138
"69272",2015,0,95,95,190
"69272",2016,0,0,53,53
"69272",2017,0,51,168,219
"69272",2018,0,15,14,29
"69272",2019,0,31,147,178
"69272",2020,0,39,99,138
"69273",2015,0,100,115,215
"69273",2016,0,0,53,53
"69273",2017,0,51,168,219
"69273",2018,0,15,14,29
"69273",2019,0,31,147,178
"69273",2020,0,39,99,138
"69275",2015,0,100,0,100
"69275",2017,0,51,168,219
"69275",2018,0,15,14,29
"69275",2019,0,31,147,178
"69275",2020,0,39,99,138
"69276",2015,0,95,20,115
"69276",2016,0,0,53,53
"69276",2017,0,51,168,219
"69276",2018,0,15,14,29
"69276",2019,0,31,147,178
"69276",2020,0,39,99,138
"69277",2015,0,100,0,100
"69277",2017,0,51,168,219
"69277",2018,0,15,14,29
"69277",2019,0,31,147,178
"69277",2020,0,39,99,138
"69278",2015,0,100,0,100
"69278",2016,0,0,53,53
"69278",2017,0,0,168,168
"69278",2018,0,0,14,14
"69278",2019,0,0,147,147
"69278",2020,0,0,99,99
"69279",2015,0,100,0,100
"69279",2017,0,51,168,219
"69279",2018,0,15,14,29
"69279",2019,0,31,147,178
"69279",2020,0,39,99,138
"69280",2015,0,100,0,100
"69280",2017,0,51,168,219
"69280",2018,0,15,14,29
"69280",2019,0,31,147,178
"69280",2020,0,39,99,138
"69281",2015,0,100,115,215
"69281",2016,0,0,53,53
"69281",2017,0,51,168,219
"69281",2018,0,15,14,29
"69281",2019,0,31,147,178
"69281",2020,0,39,99,138
"69282",2015,0,100,0,100
"69282",2017,0,51,168,219
"69282",2018,0,15,14,29
"69282",2019,0,31,147,178
"69282",2020,0,39,99,138
"69283",2015,0,100,20,120
"69283",2016,0,0,53,53
"69283",2017,0,51,168,219
"69283",2018,0,15,14,29
"69283",2019,0,31,147,178
"69283",2020,0,39,99,138
"69284",2016,0,0,53,53
"69284",2017,0,0,168,168
"69284",2018,0,0,14,14
"69284",2019,0,0,147,147
"69284",2020,0,0,99,99
"69285",2015,0,100,0,100
"69285",2017,0,51,168,219
"69285",2018,0,15,14,29
"69285",2019,0,31,147,178
"69285",2020,0,39,99,138
"69286",2016,0,0,53,53
"69286",2017,0,168,168,336
"69286",2018,0,185,14,199
"69286",2019,0,31,147,178
"69286",2020,0,234,99,333
"69287",2015,0,100,20,120
"69287",2016,0,0,53,53
"69287",2017,0,51,168,219
"69287",2018,0,15,14,29
"69287",2019,0,31,147,178
"69287",2020,0,39,99,138
"69288",2015,0,100,20,120
"69288",2016,0,0,53,53
"69288",2017,0,51,168,219
"69288",2018,0,15,14,29
"69288",2019,0,31,147,178
"69288",2020,0,39,99,138
"69289",2015,0,100,115,215
"69289",2016,0,0,53,53
"69289",2017,0,51,168,219
"69289",2018,0,15,14,29
"69289",2019,0,31,147,178
"69289",2020,0,39,99,138
"69290",2015,0,100,20,120
"69290",2016,0,0,53,53
"69290",2017,0,51,168,219
"69290",2018,0,15,14,29
"69290",2019,0,31,147,178
"69290",2020,0,39,99,138
"69291",2015,0,100,115,215
"69291",2016,0,0,53,53
"69291",2017,0,51,168,219
"69291",2018,0,15,14,29
"69291",2019,0,31,147,178
"69291",2020,0,39,99,138
"69292",2016,0,0,53,53
"69292",2017,0,0,168,168
"69292",2018,0,0,14,14
"69292",2019,0,0,147,147
"69292",2020,0,0,99,99
"69293",2016,0,0,53,53
"69293",2017,0,0,168,168
"69293",2018,0,0,14,14
"69293",2019,0,0,147,147
"69293",2020,0,0,99,99
"69294",2015,0,95,0,95
"69294",2016,0,0,53,53
"69294",2017,0,51,168,219
"69294",2018,0,15,14,29
"69294",2019,0,31,147,178
"69294",2020,0,39,99,138
"69295",2015,0,100,115,215
"69295",2016,0,0,53,53
"69295",2017,0,51,168,219
"69295",2018,0,15,14,29
"69295",2019,0,31,147,178
"69295",2020,0,39,99,138
"69296",2015,0,95,20,115
"69296",2016,0,0,53,53
"69296",2017,0,51,168,219
"69296",2018,0,15,14,29
"69296",2019,0,31,147,178
"69296",2020,0,39,99,138
"69297",2015,0,100,0,100
"69297",2016,0,0,53,53
"69297",2017,0,51,168,219
"69297",2018,0,15,14,29
"69297",2019,0,31,147,178
"69297",2020,0,39,99,138
"69298",2015,0,100,20,120
"69298",2016,0,0,53,53
"69298",2017,0,51,168,219
"69298",2018,0,15,14,29
"69298",2019,0,31,147,178
"69298",2020,0,39,99,138
"69299",2015,0,100,0,100
"69299",2017,0,51,168,219
"69299",2018,0,15,14,29
"69299",2019,0,31,147,178
"69299",2020,0,39,99,138
"71001",2014,0,0,22,22
"71001",2019,0,0,34,34
"71001",2020,0,0,55,55
"71002",2014,0,0,22,22
"71002",2019,0,0,34,34
"71002",2020,0,0,55,55
"71003",2014,0,0,22,22
"71003",2015,0,0,10,10
"71003",2017,0,0,32,32
"71003",2018,0,0,15,15
"71003",2019,0,0,24,24
"71003",2020,0,0,86,86
"71004",2014,0,0,22,22
"71004",2019,0,0,34,34
"71004",2020,0,0,55,55
"71005",2014,0,0,22,22
"71005",2015,0,0,10,10
"71005",2017,0,0,32,32
"71005",2018,0,0,15,15
"71005",2019,0,0,24,24
"71005",2020,0,0,86,86
"71006",2015,0,0,10,10
"71006",2017,0,0,32,32
"71006",2019,0,0,21,21
"71007",2019,0,0,21,21
"71008",2015,0,0,10,10
"71008",2017,0,0,32,32
"71008",2019,0,0,21,21
"71009",2017,0,0,32,32
"71009",2019,0,0,13,13
"71009",2020,0,0,35,35
"71010",2017,0,0,32,32
"71010",2019,0,0,13,13
"71010",2020,0,0,35,35
"71011",2015,0,0,10,10
"71011",2017,0,0,32,32
"71011",2019,0,0,21,21
"71012",2017,0,0,54,54
"71012",2018,0,0,85,85
"71012",2019,0,0,24,24
"71012",2020,0,0,35,35
"71013",2014,0,0,22,22
"71013",2019,0,0,34,34
"71013",2020,0,0,55,55
"71014",2017,0,0,32,32
"71014",2019,0,0,13,13
"71014",2020,0,0,35,35
"71015",2017,0,0,32,32
"71015",2019,0,0,13,13
"71015",2020,0,0,35,35
"71016",2019,0,0,21,21
"71017",2015,0,0,10,10
"71017",2017,0,0,32,32
"71017",2019,0,0,21,21
"71018",2014,0,0,22,22
"71018",2019,0,0,34,34
"71018",2020,0,0,55,55
"71019",2014,0,0,22,22
"71019",2015,0,0,10,10
"71019",2017,0,0,32,32
"71019",2018,0,0,15,15
"71019",2019,0,0,24,24
"71019",2020,0,0,86,86
"71020",2017,0,0,32,32
"71020",2019,0,0,13,13
"71020",2020,0,0,35,35
"71021",2015,0,0,10,10
"71021",2017,0,0,32,32
"71022",2015,0,0,10,10
"71022",2017,0,0,32,32
"71022",2019,0,0,21,21
"71023",2014,0,0,22,22
"71023",2019,0,0,34,34
"71023",2020,0,0,55,55
"71024",2015,0,0,10,10
"71024",2017,0,0,32,32
"71024",2019,0,0,21,21
"71025",2015,0,0,10,10
"71025",2017,0,0,32,32
"71025",2019,0,0,21,21
"71026",2019,0,0,21,21
"71027",2014,0,0,22,22
"71027",2019,0,0,34,34
"71027",2020,0,0,55,55
"71028",2014,0,0,22,22
"71028",2019,0,0,34,34
"71028",2020,0,0,55,55
"71029",2014,0,0,22,22
"71029",2019,0,0,34,34
"71029",2020,0,0,55,55
"71030",2019,0,0,21,21
"71031",2019,0,0,21,21
"71032",2014,0,0,22,22
"71032",2015,0,0,10,10
"71032",2017,0,0,32,32
"71032",2018,0,0,15,15
"71032",2019,0,0,24,24
"71032",2020,0,0,86,86
"71033",2014,0,0,22,22
"71033",2019,0,0,34,34
"71033",2020,0,0,55,55
"71034",2014,0,0,22,22
"71034",2015,0,0,10,10
"71034",2017,0,0,32,32
"71034",2018,0,0,15,15
"71034",2019,0,0,24,24
"71034",2020,0,0,86,86
"71035",2014,0,0,22,22
"71035",2015,0,0,10,10
"71035",2017,0,0,32,32
"71035",2018,0,0,15,15
"71035",2019,0,0,24,24
"71035",2020,0,0,86,86
"71036",2019,0,0,21,21
"71037",2019,0,0,21,21
"71038",2015,0,0,10,10
"71038",2017,0,0,22,22
"71038",2020,0,0,35,35
"71039",2019,0,0,21,21
"71040",2015,0,0,10,10
"71040",2017,0,0,22,22
"71040",2020,0,0,35,35
"71041",2015,0,0,10,10
"71041",2017,0,0,32,32
"71041",2019,0,0,21,21
"71042",2019,0,0,21,21
"71043",2014,0,0,22,22
"71043",2015,0,0,10,10
"71043",2017,0,0,32,32
"71043",2018,0,0,15,15
"71043",2019,0,0,24,24
"71043",2020,0,0,86,86
"71044",2014,0,0,22,22
"71044",2019,0,0,34,34
"71044",2020,0,0,55,55
"71045",2014,0,0,22,22
"71045",2019,0,0,34,34
"71045",2020,0,0,55,55
"71046",2017,0,0,32,32
"71046",2019,0,0,13,13
"71046",2020,0,0,35,35
"71047",2017,0,0,32,32
"71047",2019,0,0,13,13
"71047",2020,0,0,35,35
"71048",2017,0,0,54,54
"71048",2018,0,0,85,85
"71048",2019,0,0,24,24
"71048",2020,0,0,35,35
"71050",2019,0,0,21,21
"71051",2014,0,0,22,22
"71051",2018,0,0,15,15
"71051",2019,0,0,24,24
"71051",2020,0,0,86,86
"71052",2019,0,0,21,21
"71054",2014,0,0,22,22
"71054",2015,0,0,10,10
"71054",2017,0,0,32,32
"71054",2018,0,0,15,15
"71054",2019,0,0,24,24
"71054",2020,0,0,86,86
"71056",2014,0,0,22,22
"71056",2019,0,0,34,34
"71056",2020,0,0,55,55
"71057",2019,0,0,21,21
"71058",2019,0,0,21,21
"71059",2015,0,0,10,10
"71059",2017,0,0,32,32
"71059",2020,0,0,35,35
"71060",2015,0,0,10,10
"71060",2017,0,0,32,32
"71060",2019,0,0,21,21
"71061",2014,0,0,22,22
"71061",2019,0,0,34,34
"71061",2020,0,0,55,55
"71062",2017,0,0,32,32
"71062",2019,0,0,13,13
"71062",2020,0,0,35,35
"71063",2017,0,0,32,32
"71063",2019,0,0,13,13
"71063",2020,0,0,35,35
"71064",2014,0,0,22,22
"71064",2019,0,0,34,34
"71064",2020,0,0,55,55
"71065",2019,0,0,21,21
"71066",2014,0,0,22,22
"71066",2015,0,0,10,10
"71066",2017,0,0,32,32
"71066",2018,0,0,15,15
"71066",2019,0,0,24,24
"71066",2020,0,0,86,86
"71067",2019,0,0,21,21
"71068",2019,0,0,21,21
"71069",2014,0,0,22,22
"71069",2015,0,0,10,10
"71069",2017,0,0,32,32
"71069",2018,0,0,15,15
"71069",2019,0,0,24,24
"71069",2020,0,0,86,86
"71070",2014,0,0,22,22
"71070",2015,0,0,10,10
"71070",2017,0,0,32,32
"71070",2018,0,0,15,15
"71070",2019,0,0,24,24
"71070",2020,0,0,86,86
"71071",2017,0,0,54,54
"71071",2018,0,0,85,85
"71071",2019,0,0,24,24
"71071",2020,0,0,35,35
"71072",2019,0,0,21,21
"71073",2014,0,0,22,22
"71073",2015,0,0,10,10
"71073",2017,0,0,32,32
"71073",2018,0,0,15,15
"71073",2019,0,0,24,24
"71073",2020,0,0,86,86
"71074",2014,0,0,22,22
"71074",2015,0,0,10,10
"71074",2017,0,0,32,32
"71074",2018,0,0,15,15
"71074",2019,0,0,24,24
"71074",2020,0,0,86,86
"71075",2017,0,0,32,32
"71075",2019,0,0,13,13
"71075",2020,0,0,35,35
"71076",2014,0,0,22,22
"71076",2015,0,0,10,10
"71076",2017,0,0,32,32
"71076",2018,0,0,15,15
"71076",2019,0,0,24,24
"71076",2020,0,0,86,86
"71077",2017,0,0,54,54
"71077",2018,0,0,85,85
"71077",2019,0,0,24,24
"71077",2020,0,0,35,35
"71078",2014,0,0,22,22
"71078",2018,0,0,15,15
"71078",2019,0,0,24,24
"71078",2020,0,0,86,86
"71079",2014,0,0,22,22
"71079",2019,0,0,34,34
"71079",2020,0,0,55,55
"71080",2019,0,0,21,21
"71081",2014,0,0,22,22
"71081",2015,0,0,10,10
"71081",2017,0,0,32,32
"71081",2018,0,0,15,15
"71081",2019,0,0,24,24
"71081",2020,0,0,86,86
"71082",2015,0,0,10,10
"71082",2017,0,0,32,32
"71084",2014,0,0,22,22
"71084",2015,0,0,10,10
"71084",2017,0,0,32,32
"71084",2018,0,0,15,15
"71084",2019,0,0,24,24
"71084",2020,0,0,86,86
"71085",2017,0,0,32,32
"71085",2019,0,0,13,13
"71085",2020,0,0,35,35
"71086",2015,0,0,10,10
"71086",2017,0,0,32,32
"71087",2019,0,0,21,21
"71088",2017,0,0,32,32
"71088",2019,0,0,13,13
"71088",2020,0,0,35,35
"71089",2019,0,0,21,21
"71090",2014,0,0,22,22
"71090",2015,0,0,10,10
"71090",2017,0,0,32,32
"71090",2018,0,0,15,15
"71090",2019,0,0,24,24
"71090",2020,0,0,86,86
"71091",2019,0,0,21,21
"71092",2014,0,0,22,22
"71092",2019,0,0,34,34
"71092",2020,0,0,55,55
"71093",2014,0,0,22,22
"71093",2019,0,0,34,34
"71093",2020,0,0,55,55
"71094",2019,0,0,21,21
"71095",2015,0,0,10,10
"71095",2017,0,0,32,32
"71095",2019,0,0,21,21
"71096",2017,0,0,32,32
"71096",2019,0,0,13,13
"71096",2020,0,0,35,35
"71097",2014,0,0,22,22
"71097",2019,0,0,34,34
"71097",2020,0,0,55,55
"71098",2017,0,0,32,32
"71098",2019,0,0,13,13
"71098",2020,0,0,35,35
"71099",2014,0,0,22,22
"71099",2015,0,0,10,10
"71099",2017,0,0,32,32
"71099",2018,0,0,15,15
"71099",2019,0,0,24,24
"71099",2020,0,0,86,86
"71100",2014,0,0,22,22
"71100",2015,0,0,10,10
"71100",2017,0,0,32,32
"71100",2018,0,0,15,15
"71100",2019,0,0,24,24
"71100",2020,0,0,86,86
"71101",2014,0,0,22,22
"71101",2019,0,0,34,34
"71101",2020,0,0,55,55
"71102",2019,0,0,21,21
"71103",2015,0,0,10,10
"71103",2017,0,0,32,32
"71103",2020,0,0,35,35
"71104",2014,0,0,22,22
"71104",2015,0,0,10,10
"71104",2017,0,0,32,32
"71104",2018,0,0,15,15
"71104",2019,0,0,24,24
"71104",2020,0,0,86,86
"71105",2014,0,0,22,22
"71105",2015,0,0,10,10
"71105",2017,0,0,32,32
"71105",2018,0,0,15,15
"71105",2019,0,0,24,24
"71105",2020,0,0,86,86
"71106",2015,0,0,10,10
"71106",2017,0,0,32,32
"71107",2014,0,0,22,22
"71107",2015,0,0,10,10
"71107",2017,0,0,32,32
"71107",2018,0,0,15,15
"71107",2019,0,0,24,24
"71107",2020,0,0,86,86
"71108",2014,0,0,22,22
"71108",2015,0,0,10,10
"71108",2017,0,0,32,32
"71108",2018,0,0,15,15
"71108",2019,0,0,24,24
"71108",2020,0,0,86,86
"71109",2014,0,0,22,22
"71109",2018,0,0,15,15
"71109",2019,0,0,24,24
"71109",2020,0,0,86,86
"71110",2015,0,0,10,10
"71110",2017,0,0,32,32
"71110",2019,0,0,21,21
"71111",2015,0,0,10,10
"71111",2017,0,0,32,32
"71111",2020,0,0,35,35
"71112",2019,0,0,21,21
"71113",2015,0,0,10,10
"71113",2017,0,0,32,32
"71113",2019,0,0,21,21
"71115",2014,0,0,22,22
"71115",2015,0,0,10,10
"71115",2017,0,0,32,32
"71115",2018,0,0,15,15
"71115",2019,0,0,24,24
"71115",2020,0,0,86,86
"71116",2015,0,0,10,10
"71116",2017,0,0,32,32
"71116",2019,0,0,21,21
"71117",2014,0,0,22,22
"71117",2015,0,0,10,10
"71117",2017,0,0,32,32
"71117",2018,0,0,15,15
"71117",2019,0,0,24,24
"71117",2020,0,0,86,86
"71118",2014,0,0,22,22
"71118",2015,0,0,10,10
"71118",2017,0,0,32,32
"71118",2018,0,0,15,15
"71118",2019,0,0,24,24
"71118",2020,0,0,86,86
"71119",2014,0,0,22,22
"71119",2018,0,0,15,15
"71119",2019,0,0,24,24
"71119",2020,0,0,86,86
"71120",2015,0,0,10,10
"71120",2017,0,0,32,32
"71120",2019,0,0,21,21
"71121",2014,0,0,22,22
"71121",2019,0,0,34,34
"71121",2020,0,0,55,55
"71122",2014,0,0,22,22
"71122",2018,0,0,15,15
"71122",2019,0,0,24,24
"71122",2020,0,0,86,86
"71123",2017,0,0,54,54
"71123",2018,0,0,85,85
"71123",2019,0,0,24,24
"71123",2020,0,0,35,35
"71124",2019,0,0,21,21
"71125",2019,0,0,21,21
"71126",2014,0,0,22,22
"71126",2015,0,0,10,10
"71126",2017,0,0,32,32
"71126",2018,0,0,15,15
"71126",2019,0,0,24,24
"71126",2020,0,0,86,86
"71127",2019,0,0,21,21
"71128",2019,0,0,21,21
"71129",2017,0,0,32,32
"71129",2019,0,0,13,13
"71129",2020,0,0,35,35
"71130",2019,0,0,21,21
"71131",2014,0,0,22,22
"71131",2019,0,0,34,34
"71131",2020,0,0,55,55
"71132",2015,0,0,10,10
"71132",2017,0,0,32,32
"71133",2015,0,0,10,10
"71133",2017,0,0,32,32
"71133",2019,0,0,21,21
"71134",2019,0,0,21,21
"71135",2014,0,0,22,22
"71135",2015,0,0,10,10
"71135",2017,0,0,32,32
"71135",2018,0,0,15,15
"71135",2019,0,0,24,24
"71135",2020,0,0,86,86
"71136",2015,0,0,10,10
"71136",2017,0,0,32,32
"71136",2020,0,0,35,35
"71137",2019,0,0,21,21
"71140",2017,0,0,32,32
"71140",2019,0,0,13,13
"71140",2020,0,0,35,35
"71141",2015,0,0,10,10
"71141",2017,0,0,32,32
"71141",2019,0,0,21,21
"71142",2017,0,0,32,32
"71142",2019,0,0,13,13
"71142",2020,0,0,35,35
"71143",2014,0,0,22,22
"71143",2019,0,0,34,34
"71143",2020,0,0,55,55
"71144",2017,0,0,32,32
"71144",2019,0,0,13,13
"71144",2020,0,0,35,35
"71145",2019,0,0,21,21
"71146",2019,0,0,21,21
"71147",2019,0,0,21,21
"71148",2015,0,0,10,10
"71148",2017,0,0,32,32
"71148",2019,0,0,21,21
"71149",2017,0,0,32,32
"71149",2019,0,0,13,13
"71149",2020,0,0,35,35
"71150",2014,0,0,22,22
"71150",2015,0,0,10,10
"71150",2017,0,0,32,32
"71150",2018,0,0,15,15
"71150",2019,0,0,24,24
"71150",2020,0,0,86,86
"71151",2017,0,0,32,32
"71151",2019,0,0,13,13
"71151",2020,0,0,35,35
"71152",2017,0,0,32,32
"71152",2019,0,0,13,13
"71152",2020,0,0,35,35
"71153",2015,0,0,10,10
"71153",2017,0,0,32,32
"71153",2020,0,0,35,35
"71154",2014,0,0,22,22
"71154",2015,0,0,10,10
"71154",2017,0,0,32,32
"71154",2018,0,0,15,15
"71154",2019,0,0,24,24
"71154",2020,0,0,86,86
"71155",2017,0,0,32,32
"71155",2019,0,0,13,13
"71155",2020,0,0,35,35
"71156",2014,0,0,22,22
"71156",2015,0,0,10,10
"71156",2017,0,0,32,32
"71156",2018,0,0,15,15
"71156",2019,0,0,24,24
"71156",2020,0,0,86,86
"71157",2014,0,0,22,22
"71157",2019,0,0,34,34
"71157",2020,0,0,55,55
"71158",2014,0,0,22,22
"71158",2019,0,0,34,34
"71158",2020,0,0,55,55
"71159",2019,0,0,21,21
"71160",2015,0,0,10,10
"71160",2017,0,0,32,32
"71160",2019,0,0,21,21
"71161",2017,0,0,32,32
"71161",2019,0,0,13,13
"71161",2020,0,0,35,35
"71162",2017,0,0,32,32
"71162",2019,0,0,13,13
"71162",2020,0,0,35,35
"71163",2019,0,0,21,21
"71164",2019,0,0,21,21
"71165",2017,0,0,32,32
"71165",2019,0,0,13,13
"71165",2020,0,0,35,35
"71166",2017,0,0,32,32
"71166",2019,0,0,13,13
"71166",2020,0,0,35,35
"71167",2014,0,0,22,22
"71167",2019,0,0,34,34
"71167",2020,0,0,55,55
"71168",2014,0,0,22,22
"71168",2019,0,0,34,34
"71168",2020,0,0,55,55
"71169",2014,0,0,22,22
"71169",2015,0,0,10,10
"71169",2017,0,0,32,32
"71169",2018,0,0,15,15
"71169",2019,0,0,24,24
"71169",2020,0,0,86,86
"71170",2014,0,0,22,22
"71170",2015,0,0,10,10
"71170",2017,0,0,32,32
"71170",2018,0,0,15,15
"71170",2019,0,0,24,24
"71170",2020,0,0,86,86
"71171",2014,0,0,22,22
"71171",2018,0,0,15,15
"71171",2019,0,0,24,24
"71171",2020,0,0,86,86
"71172",2017,0,0,32,32
"71172",2019,0,0,13,13
"71172",2020,0,0,35,35
"71173",2014,0,0,22,22
"71173",2019,0,0,34,34
"71173",2020,0,0,55,55
"71174",2014,0,0,22,22
"71174",2018,0,0,15,15
"71174",2019,0,0,24,24
"71174",2020,0,0,86,86
"71175",2014,0,0,22,22
"71175",2019,0,0,34,34
"71175",2020,0,0,55,55
"71176",2015,0,0,10,10
"71176",2017,0,0,32,32
"71176",2020,0,0,35,35
"71177",2014,0,0,22,22
"71177",2019,0,0,34,34
"71177",2020,0,0,55,55
"71178",2019,0,0,21,21
"71179",2015,0,0,10,10
"71179",2017,0,0,32,32
"71179",2020,0,0,35,35
"71181",2019,0,0,21,21
"71182",2014,0,0,22,22
"71182",2015,0,0,10,10
"71182",2017,0,0,32,32
"71182",2018,0,0,15,15
"71182",2019,0,0,24,24
"71182",2020,0,0,86,86
"71183",2017,0,0,32,32
"71183",2019,0,0,13,13
"71183",2020,0,0,35,35
"71184",2017,0,0,32,32
"71184",2019,0,0,13,13
"71184",2020,0,0,35,35
"71185",2015,0,0,10,10
"71185",2017,0,0,32,32
"71185",2019,0,0,21,21
"71186",2014,0,0,22,22
"71186",2015,0,0,10,10
"71186",2017,0,0,32,32
"71186",2018,0,0,15,15
"71186",2019,0,0,24,24
"71186",2020,0,0,86,86
"71187",2015,0,0,10,10
"71187",2017,0,0,32,32
"71187",2020,0,0,35,35
"71188",2017,0,0,32,32
"71188",2019,0,0,13,13
"71188",2020,0,0,35,35
"71189",2014,0,0,22,22
"71189",2015,0,0,10,10
"71189",2017,0,0,32,32
"71189",2018,0,0,15,15
"71189",2019,0,0,24,24
"71189",2020,0,0,86,86
"71190",2017,0,0,32,32
"71190",2019,0,0,13,13
"71190",2020,0,0,35,35
"71191",2014,0,0,22,22
"71191",2018,0,0,15,15
"71191",2019,0,0,24,24
"71191",2020,0,0,86,86
"71192",2017,0,0,32,32
"71192",2019,0,0,13,13
"71192",2020,0,0,35,35
"71193",2019,0,0,21,21
"71194",2014,0,0,22,22
"71194",2015,0,0,10,10
"71194",2017,0,0,32,32
"71194",2018,0,0,15,15
"71194",2019,0,0,24,24
"71194",2020,0,0,86,86
"71195",2014,0,0,22,22
"71195",2015,0,0,10,10
"71195",2017,0,0,32,32
"71195",2018,0,0,15,15
"71195",2019,0,0,24,24
"71195",2020,0,0,86,86
"71196",2014,0,0,22,22
"71196",2019,0,0,34,34
"71196",2020,0,0,55,55
"71198",2014,0,0,22,22
"71198",2019,0,0,34,34
"71198",2020,0,0,55,55
"71199",2019,0,0,21,21
"71200",2015,0,0,10,10
"71200",2017,0,0,32,32
"71200",2019,0,0,21,21
"71201",2019,0,0,21,21
"71202",2014,0,0,22,22
"71202",2015,0,0,10,10
"71202",2017,0,0,32,32
"71202",2018,0,0,15,15
"71202",2019,0,0,24,24
"71202",2020,0,0,86,86
"71203",2015,0,0,10,10
"71203",2017,0,0,32,32
"71203",2019,0,0,21,21
"71204",2014,0,0,22,22
"71204",2015,0,0,10,10
"71204",2017,0,0,32,32
"71204",2018,0,0,15,15
"71204",2019,0,0,24,24
"71204",2020,0,0,86,86
"71205",2014,0,0,22,22
"71205",2019,0,0,34,34
"71205",2020,0,0,55,55
"71206",2014,0,0,22,22
"71206",2019,0,0,34,34
"71206",2020,0,0,55,55
"71207",2014,0,0,22,22
"71207",2019,0,0,34,34
"71207",2020,0,0,55,55
"71208",2014,0,0,22,22
"71208",2019,0,0,34,34
"71208",2020,0,0,55,55
"71209",2014,0,0,22,22
"71209",2019,0,0,34,34
"71209",2020,0,0,55,55
"71210",2014,0,0,22,22
"71210",2015,0,0,10,10
"71210",2017,0,0,32,32
"71210",2018,0,0,15,15
"71210",2019,0,0,24,24
"71210",2020,0,0,86,86
"71212",2015,0,0,10,10
"71212",2017,0,0,22,22
"71212",2020,0,0,35,35
"71213",2014,0,0,22,22
"71213",2019,0,0,34,34
"71213",2020,0,0,55,55
"71214",2019,0,0,21,21
"71215",2014,0,0,22,22
"71215",2015,0,0,10,10
"71215",2017,0,0,32,32
"71215",2018,0,0,15,15
"71215",2019,0,0,24,24
"71215",2020,0,0,86,86
"71216",2019,0,0,21,21
"71217",2019,0,0,21,21
"71218",2019,0,0,21,21
"71219",2019,0,0,21,21
"71220",2017,0,0,32,32
"71220",2019,0,0,13,13
"71220",2020,0,0,35,35
"71221",2014,0,0,22,22
"71221",2015,0,0,10,10
"71221",2017,0,0,32,32
"71221",2018,0,0,15,15
"71221",2019,0,0,24,24
"71221",2020,0,0,86,86
"71223",2017,0,0,32,32
"71223",2019,0,0,13,13
"71223",2020,0,0,35,35
"71224",2015,0,0,10,10
"71224",2017,0,0,32,32
"71225",2014,0,0,22,22
"71225",2015,0,0,10,10
"71225",2017,0,0,32,32
"71225",2018,0,0,15,15
"71225",2019,0,0,24,24
"71225",2020,0,0,86,86
"71226",2014,0,0,22,22
"71226",2015,0,0,10,10
"71226",2017,0,0,32,32
"71226",2018,0,0,15,15
"71226",2019,0,0,24,24
"71226",2020,0,0,86,86
"71227",2017,0,0,32,32
"71227",2019,0,0,13,13
"71227",2020,0,0,35,35
"71228",2014,0,0,22,22
"71228",2019,0,0,34,34
"71228",2020,0,0,55,55
"71229",2017,0,0,32,32
"71229",2019,0,0,13,13
"71229",2020,0,0,35,35
"71230",2017,0,0,32,32
"71230",2019,0,0,13,13
"71230",2020,0,0,35,35
"71231",2019,0,0,21,21
"71232",2015,0,0,10,10
"71232",2017,0,0,32,32
"71233",2015,0,0,10,10
"71233",2017,0,0,32,32
"71233",2019,0,0,21,21
"71234",2014,0,0,22,22
"71234",2019,0,0,34,34
"71234",2020,0,0,55,55
"71235",2014,0,0,22,22
"71235",2015,0,0,10,10
"71235",2017,0,0,32,32
"71235",2018,0,0,15,15
"71235",2019,0,0,24,24
"71235",2020,0,0,86,86
"71236",2019,0,0,21,21
"71237",2017,0,0,32,32
"71237",2019,0,0,13,13
"71237",2020,0,0,35,35
"71238",2015,0,0,10,10
"71238",2017,0,0,32,32
"71238",2019,0,0,21,21
"71239",2017,0,0,32,32
"71239",2019,0,0,13,13
"71239",2020,0,0,35,35
"71240",2019,0,0,21,21
"71241",2014,0,0,22,22
"71241",2015,0,0,10,10
"71241",2017,0,0,32,32
"71241",2018,0,0,15,15
"71241",2019,0,0,24,24
"71241",2020,0,0,86,86
"71242",2019,0,0,21,21
"71243",2014,0,0,22,22
"71243",2019,0,0,34,34
"71243",2020,0,0,55,55
"71244",2014,0,0,22,22
"71244",2019,0,0,34,34
"71244",2020,0,0,55,55
"71245",2019,0,0,21,21
"71246",2014,0,0,22,22
"71246",2019,0,0,34,34
"71246",2020,0,0,55,55
"71247",2019,0,0,21,21
"71248",2014,0,0,22,22
"71248",2015,0,0,10,10
"71248",2017,0,0,32,32
"71248",2018,0,0,15,15
"71248",2019,0,0,24,24
"71248",2020,0,0,86,86
"71249",2019,0,0,21,21
"71250",2014,0,0,22,22
"71250",2015,0,0,10,10
"71250",2017,0,0,32,32
"71250",2018,0,0,15,15
"71250",2019,0,0,24,24
"71250",2020,0,0,86,86
"71251",2017,0,0,32,32
"71251",2019,0,0,13,13
"71251",2020,0,0,35,35
"71252",2019,0,0,21,21
"71253",2014,0,0,22,22
"71253",2019,0,0,34,34
"71253",2020,0,0,55,55
"71254",2014,0,0,22,22
"71254",2015,0,0,10,10
"71254",2017,0,0,32,32
"71254",2018,0,0,15,15
"71254",2019,0,0,24,24
"71254",2020,0,0,86,86
"71255",2017,0,0,54,54
"71255",2018,0,0,85,85
"71255",2019,0,0,24,24
"71255",2020,0,0,35,35
"71256",2014,0,0,22,22
"71256",2019,0,0,34,34
"71256",2020,0,0,55,55
"71257",2014,0,0,22,22
"71257",2015,0,0,10,10
"71257",2017,0,0,32,32
"71257",2018,0,0,15,15
"71257",2019,0,0,24,24
"71257",2020,0,0,86,86
"71258",2014,0,0,22,22
"71258",2015,0,0,10,10
"71258",2017,0,0,32,32
"71258",2018,0,0,15,15
"71258",2019,0,0,24,24
"71258",2020,0,0,86,86
"71259",2015,0,0,10,10
"71259",2017,0,0,32,32
"71259",2019,0,0,21,21
"71261",2014,0,0,22,22
"71261",2019,0,0,34,34
"71261",2020,0,0,55,55
"71262",2014,0,0,22,22
"71262",2015,0,0,10,10
"71262",2017,0,0,32,32
"71262",2018,0,0,15,15
"71262",2019,0,0,24,24
"71262",2020,0,0,86,86
"71263",2014,0,0,22,22
"71263",2019,0,0,34,34
"71263",2020,0,0,55,55
"71264",2019,0,0,21,21
"71266",2017,0,0,32,32
"71266",2019,0,0,13,13
"71266",2020,0,0,35,35
"71267",2014,0,0,22,22
"71267",2015,0,0,10,10
"71267",2017,0,0,32,32
"71267",2018,0,0,15,15
"71267",2019,0,0,24,24
"71267",2020,0,0,86,86
"71268",2015,0,0,10,10
"71268",2017,0,0,32,32
"71269",2014,0,0,22,22
"71269",2015,0,0,10,10
"71269",2017,0,0,32,32
"71269",2018,0,0,15,15
"71269",2019,0,0,24,24
"71269",2020,0,0,86,86
"71270",2014,0,0,22,22
"71270",2015,0,0,10,10
"71270",2017,0,0,32,32
"71270",2018,0,0,15,15
"71270",2019,0,0,24,24
"71270",2020,0,0,86,86
"71271",2015,0,0,10,10
"71271",2017,0,0,32,32
"71271",2019,0,0,21,21
"71272",2019,0,0,21,21
"71273",2017,0,0,32,32
"71273",2019,0,0,13,13
"71273",2020,0,0,35,35
"71274",2019,0,0,21,21
"71275",2015,0,0,10,10
"71275",2017,0,0,32,32
"71275",2019,0,0,21,21
"71276",2015,0,0,10,10
"71276",2017,0,0,32,32
"71276",2019,0,0,21,21
"71277",2019,0,0,21,21
"71280",2017,0,0,32,32
"71280",2019,0,0,13,13
"71280",2020,0,0,35,35
"71281",2015,0,0,10,10
"71281",2017,0,0,32,32
"71281",2020,0,0,35,35
"71282",2015,0,0,10,10
"71282",2017,0,0,32,32
"71282",2020,0,0,35,35
"71283",2014,0,0,22,22
"71283",2015,0,0,10,10
"71283",2017,0,0,32,32
"71283",2018,0,0,15,15
"71283",2019,0,0,24,24
"71283",2020,0,0,86,86
"71284",2019,0,0,21,21
"71285",2015,0,0,10,10
"71285",2017,0,0,32,32
"71287",2019,0,0,21,21
"71289",2019,0,0,21,21
"71290",2019,0,0,21,21
"71291",2017,0,0,54,54
"71291",2018,0,0,85,85
"71291",2019,0,0,24,24
"71291",2020,0,0,35,35
"71292",2014,0,0,22,22
"71292",2015,0,0,10,10
"71292",2017,0,0,32,32
"71292",2018,0,0,15,15
"71292",2019,0,0,24,24
"71292",2020,0,0,86,86
"71293",2014,0,0,22,22
"71293",2019,0,0,34,34
"71293",2020,0,0,55,55
"71294",2014,0,0,22,22
"71294",2015,0,0,10,10
"71294",2017,0,0,32,32
"71294",2018,0,0,15,15
"71294",2019,0,0,24,24
"71294",2020,0,0,86,86
"71295",2014,0,0,22,22
"71295",2019,0,0,34,34
"71295",2020,0,0,55,55
"71296",2019,0,0,21,21
"71297",2017,0,0,32,32
"71297",2019,0,0,13,13
"71297",2020,0,0,35,35
"71299",2014,0,0,22,22
"71299",2015,0,0,10,10
"71299",2017,0,0,32,32
"71299",2018,0,0,15,15
"71299",2019,0,0,24,24
"71299",2020,0,0,86,86
"71300",2014,0,0,22,22
"71300",2019,0,0,34,34
"71300",2020,0,0,55,55
"71301",2017,0,0,32,32
"71301",2019,0,0,13,13
"71301",2020,0,0,35,35
"71302",2014,0,0,22,22
"71302",2015,0,0,10,10
"71302",2017,0,0,32,32
"71302",2018,0,0,15,15
"71302",2019,0,0,24,24
"71302",2020,0,0,86,86
"71303",2014,0,0,22,22
"71303",2019,0,0,34,34
"71303",2020,0,0,55,55
"71305",2014,0,0,22,22
"71305",2015,0,0,10,10
"71305",2017,0,0,32,32
"71305",2018,0,0,15,15
"71305",2019,0,0,24,24
"71305",2020,0,0,86,86
"71306",2015,0,0,10,10
"71306",2017,0,0,22,22
"71306",2020,0,0,35,35
"71307",2015,0,0,10,10
"71307",2017,0,0,32,32
"71307",2019,0,0,21,21
"71308",2019,0,0,21,21
"71309",2015,0,0,10,10
"71309",2017,0,0,32,32
"71309",2020,0,0,35,35
"71310",2015,0,0,10,10
"71310",2020,0,0,35,35
"71311",2014,0,0,22,22
"71311",2019,0,0,34,34
"71311",2020,0,0,55,55
"71312",2014,0,0,22,22
"71312",2019,0,0,34,34
"71312",2020,0,0,55,55
"71313",2017,0,0,32,32
"71313",2019,0,0,13,13
"71313",2020,0,0,35,35
"71314",2014,0,0,22,22
"71314",2019,0,0,34,34
"71314",2020,0,0,55,55
"71315",2014,0,0,22,22
"71315",2015,0,0,10,10
"71315",2017,0,0,32,32
"71315",2018,0,0,15,15
"71315",2019,0,0,24,24
"71315",2020,0,0,86,86
"71316",2019,0,0,21,21
"71317",2017,0,0,32,32
"71317",2019,0,0,13,13
"71317",2020,0,0,35,35
"71318",2014,0,0,22,22
"71318",2019,0,0,34,34
"71318",2020,0,0,55,55
"71319",2014,0,0,22,22
"71319",2019,0,0,34,34
"71319",2020,0,0,55,55
"71321",2014,0,0,22,22
"71321",2018,0,0,15,15
"71321",2019,0,0,24,24
"71321",2020,0,0,86,86
"71322",2017,0,0,32,32
"71322",2019,0,0,13,13
"71322",2020,0,0,35,35
"71323",2015,0,0,10,10
"71323",2017,0,0,32,32
"71323",2019,0,0,21,21
"71324",2014,0,0,22,22
"71324",2015,0,0,10,10
"71324",2017,0,0,32,32
"71324",2018,0,0,15,15
"71324",2019,0,0,24,24
"71324",2020,0,0,86,86
"71325",2017,0,0,32,32
"71325",2019,0,0,13,13
"71325",2020,0,0,35,35
"71326",2014,0,0,22,22
"71326",2019,0,0,34,34
"71326",2020,0,0,55,55
"71327",2015,0,0,10,10
"71327",2017,0,0,32,32
"71327",2019,0,0,21,21
"71328",2019,0,0,21,21
"71329",2014,0,0,22,22
"71329",2015,0,0,10,10
"71329",2017,0,0,32,32
"71329",2018,0,0,15,15
"71329",2019,0,0,24,24
"71329",2020,0,0,86,86
"71330",2017,0,0,32,32
"71330",2019,0,0,13,13
"71330",2020,0,0,35,35
"71331",2015,0,0,10,10
"71331",2017,0,0,32,32
"71332",2014,0,0,22,22
"71332",2019,0,0,34,34
"71332",2020,0,0,55,55
"71333",2014,0,0,22,22
"71333",2019,0,0,34,34
"71333",2020,0,0,55,55
"71334",2015,0,0,10,10
"71334",2017,0,0,32,32
"71334",2020,0,0,35,35
"71335",2015,0,0,10,10
"71335",2017,0,0,32,32
"71335",2019,0,0,21,21
"71336",2014,0,0,22,22
"71336",2019,0,0,34,34
"71336",2020,0,0,55,55
"71337",2015,0,0,10,10
"71337",2017,0,0,32,32
"71337",2019,0,0,21,21
"71338",2014,0,0,22,22
"71338",2015,0,0,10,10
"71338",2017,0,0,32,32
"71338",2018,0,0,15,15
"71338",2019,0,0,24,24
"71338",2020,0,0,86,86
"71339",2015,0,0,10,10
"71339",2017,0,0,32,32
"71339",2019,0,0,21,21
"71340",2015,0,0,10,10
"71340",2017,0,0,22,22
"71340",2020,0,0,35,35
"71341",2014,0,0,22,22
"71341",2015,0,0,10,10
"71341",2017,0,0,32,32
"71341",2018,0,0,15,15
"71341",2019,0,0,24,24
"71341",2020,0,0,86,86
"71342",2015,0,0,10,10
"71342",2017,0,0,32,32
"71343",2014,0,0,22,22
"71343",2018,0,0,15,15
"71343",2019,0,0,24,24
"71343",2020,0,0,86,86
"71344",2019,0,0,21,21
"71345",2014,0,0,22,22
"71345",2015,0,0,10,10
"71345",2017,0,0,32,32
"71345",2018,0,0,15,15
"71345",2019,0,0,24,24
"71345",2020,0,0,86,86
"71346",2015,0,0,10,10
"71346",2017,0,0,32,32
"71346",2020,0,0,35,35
"71347",2014,0,0,22,22
"71347",2018,0,0,15,15
"71347",2019,0,0,24,24
"71347",2020,0,0,86,86
"71348",2017,0,0,32,32
"71348",2019,0,0,13,13
"71348",2020,0,0,35,35
"71349",2017,0,0,32,32
"71349",2019,0,0,13,13
"71349",2020,0,0,35,35
"71350",2019,0,0,21,21
"71351",2014,0,0,22,22
"71351",2019,0,0,34,34
"71351",2020,0,0,55,55
"71352",2014,0,0,22,22
"71352",2019,0,0,34,34
"71352",2020,0,0,55,55
"71353",2014,0,0,22,22
"71353",2015,0,0,10,10
"71353",2017,0,0,32,32
"71353",2018,0,0,15,15
"71353",2019,0,0,24,24
"71353",2020,0,0,86,86
"71354",2015,0,0,10,10
"71354",2017,0,0,32,32
"71355",2014,0,0,22,22
"71355",2019,0,0,34,34
"71355",2020,0,0,55,55
"71356",2015,0,0,10,10
"71356",2017,0,0,32,32
"71357",2014,0,0,22,22
"71357",2015,0,0,10,10
"71357",2017,0,0,32,32
"71357",2018,0,0,15,15
"71357",2019,0,0,24,24
"71357",2020,0,0,86,86
"71358",2019,0,0,21,21
"71359",2014,0,0,22,22
"71359",2019,0,0,34,34
"71359",2020,0,0,55,55
"71360",2014,0,0,22,22
"71360",2015,0,0,10,10
"71360",2017,0,0,32,32
"71360",2018,0,0,15,15
"71360",2019,0,0,24,24
"71360",2020,0,0,86,86
"71361",2015,0,0,10,10
"71361",2017,0,0,32,32
"71361",2019,0,0,21,21
"71362",2014,0,0,22,22
"71362",2015,0,0,10,10
"71362",2017,0,0,32,32
"71362",2018,0,0,15,15
"71362",2019,0,0,24,24
"71362",2020,0,0,86,86
"71363",2019,0,0,21,21
"71364",2014,0,0,22,22
"71364",2019,0,0,34,34
"71364",2020,0,0,55,55
"71365",2014,0,0,22,22
"71365",2019,0,0,34,34
"71365",2020,0,0,55,55
"71366",2014,0,0,22,22
"71366",2019,0,0,34,34
"71366",2020,0,0,55,55
"71367",2014,0,0,22,22
"71367",2019,0,0,34,34
"71367",2020,0,0,55,55
"71368",2017,0,0,32,32
"71368",2019,0,0,13,13
"71368",2020,0,0,35,35
"71369",2014,0,0,22,22
"71369",2018,0,0,15,15
"71369",2019,0,0,24,24
"71369",2020,0,0,86,86
"71370",2015,0,0,10,10
"71370",2017,0,0,32,32
"71370",2020,0,0,35,35
"71371",2014,0,0,22,22
"71371",2015,0,0,10,10
"71371",2017,0,0,32,32
"71371",2018,0,0,15,15
"71371",2019,0,0,24,24
"71371",2020,0,0,86,86
"71372",2014,0,0,22,22
"71372",2015,0,0,10,10
"71372",2017,0,0,32,32
"71372",2018,0,0,15,15
"71372",2019,0,0,24,24
"71372",2020,0,0,86,86
"71373",2014,0,0,22,22
"71373",2019,0,0,34,34
"71373",2020,0,0,55,55
"71374",2014,0,0,22,22
"71374",2015,0,0,10,10
"71374",2017,0,0,32,32
"71374",2018,0,0,15,15
"71374",2019,0,0,24,24
"71374",2020,0,0,86,86
"71376",2017,0,0,32,32
"71376",2019,0,0,13,13
"71376",2020,0,0,35,35
"71377",2014,0,0,22,22
"71377",2015,0,0,10,10
"71377",2017,0,0,32,32
"71377",2018,0,0,15,15
"71377",2019,0,0,24,24
"71377",2020,0,0,86,86
"71378",2014,0,0,22,22
"71378",2015,0,0,10,10
"71378",2017,0,0,32,32
"71378",2018,0,0,15,15
"71378",2019,0,0,24,24
"71378",2020,0,0,86,86
"71379",2014,0,0,22,22
"71379",2019,0,0,34,34
"71379",2020,0,0,55,55
"71380",2014,0,0,22,22
"71380",2019,0,0,34,34
"71380",2020,0,0,55,55
"71381",2019,0,0,21,21
"71382",2017,0,0,32,32
"71382",2019,0,0,13,13
"71382",2020,0,0,35,35
"71383",2014,0,0,22,22
"71383",2015,0,0,10,10
"71383",2017,0,0,32,32
"71383",2018,0,0,15,15
"71383",2019,0,0,24,24
"71383",2020,0,0,86,86
"71384",2019,0,0,21,21
"71385",2014,0,0,22,22
"71385",2015,0,0,10,10
"71385",2017,0,0,32,32
"71385",2018,0,0,15,15
"71385",2019,0,0,24,24
"71385",2020,0,0,86,86
"71386",2014,0,0,22,22
"71386",2019,0,0,34,34
"71386",2020,0,0,55,55
"71387",2019,0,0,21,21
"71388",2015,0,0,10,10
"71388",2017,0,0,32,32
"71389",2017,0,0,54,54
"71389",2018,0,0,85,85
"71389",2019,0,0,24,24
"71389",2020,0,0,35,35
"71390",2015,0,0,10,10
"71390",2017,0,0,32,32
"71390",2020,0,0,35,35
"71391",2014,0,0,22,22
"71391",2015,0,0,10,10
"71391",2017,0,0,32,32
"71391",2018,0,0,15,15
"71391",2019,0,0,24,24
"71391",2020,0,0,86,86
"71392",2019,0,0,21,21
"71393",2015,0,0,10,10
"71393",2017,0,0,32,32
"71393",2019,0,0,21,21
"71394",2019,0,0,21,21
"71395",2015,0,0,10,10
"71395",2017,0,0,32,32
"71396",2014,0,0,22,22
"71396",2019,0,0,34,34
"71396",2020,0,0,55,55
"71397",2019,0,0,21,21
"71398",2014,0,0,22,22
"71398",2019,0,0,34,34
"71398",2020,0,0,55,55
"71399",2015,0,0,10,10
"71399",2017,0,0,32,32
"71399",2019,0,0,21,21
"71400",2019,0,0,21,21
"71401",2014,0,0,22,22
"71401",2019,0,0,34,34
"71401",2020,0,0,55,55
"71402",2019,0,0,21,21
"71403",2014,0,0,22,22
"71403",2015,0,0,10,10
"71403",2017,0,0,32,32
"71403",2018,0,0,15,15
"71403",2019,0,0,24,24
"71403",2020,0,0,86,86
"71404",2014,0,0,22,22
"71404",2015,0,0,10,10
"71404",2017,0,0,32,32
"71404",2018,0,0,15,15
"71404",2019,0,0,24,24
"71404",2020,0,0,86,86
"71405",2014,0,0,22,22
"71405",2019,0,0,34,34
"71405",2020,0,0,55,55
"71406",2015,0,0,10,10
"71406",2017,0,0,32,32
"71406",2019,0,0,21,21
"71407",2017,0,0,32,32
"71407",2019,0,0,13,13
"71407",2020,0,0,35,35
"71408",2015,0,0,10,10
"71408",2017,0,0,32,32
"71408",2019,0,0,21,21
"71409",2017,0,0,32,32
"71409",2019,0,0,13,13
"71409",2020,0,0,35,35
"71410",2014,0,0,22,22
"71410",2019,0,0,34,34
"71410",2020,0,0,55,55
"71411",2015,0,0,10,10
"71411",2017,0,0,32,32
"71411",2020,0,0,35,35
"71413",2017,0,0,32,32
"71413",2019,0,0,13,13
"71413",2020,0,0,35,35
"71414",2017,0,0,32,32
"71414",2019,0,0,13,13
"71414",2020,0,0,35,35
"71415",2015,0,0,10,10
"71415",2017,0,0,32,32
"71415",2019,0,0,21,21
"71416",2014,0,0,22,22
"71416",2015,0,0,10,10
"71416",2017,0,0,32,32
"71416",2018,0,0,15,15
"71416",2019,0,0,24,24
"71416",2020,0,0,86,86
"71417",2019,0,0,21,21
"71419",2014,0,0,22,22
"71419",2019,0,0,34,34
"71419",2020,0,0,55,55
"71420",2014,0,0,22,22
"71420",2019,0,0,34,34
"71420",2020,0,0,55,55
"71421",2015,0,0,10,10
"71421",2017,0,0,32,32
"71421",2019,0,0,21,21
"71422",2019,0,0,21,21
"71423",2014,0,0,22,22
"71423",2015,0,0,10,10
"71423",2017,0,0,32,32
"71423",2018,0,0,15,15
"71423",2019,0,0,24,24
"71423",2020,0,0,86,86
"71424",2017,0,0,32,32
"71424",2019,0,0,13,13
"71424",2020,0,0,35,35
"71425",2014,0,0,22,22
"71425",2018,0,0,15,15
"71425",2019,0,0,24,24
"71425",2020,0,0,86,86
"71426",2014,0,0,22,22
"71426",2015,0,0,10,10
"71426",2017,0,0,32,32
"71426",2018,0,0,15,15
"71426",2019,0,0,24,24
"71426",2020,0,0,86,86
"71427",2019,0,0,21,21
"71428",2015,0,0,10,10
"71428",2017,0,0,32,32
"71428",2019,0,0,21,21
"71430",2014,0,0,22,22
"71430",2015,0,0,10,10
"71430",2017,0,0,32,32
"71430",2018,0,0,15,15
"71430",2019,0,0,24,24
"71430",2020,0,0,86,86
"71431",2014,0,0,22,22
"71431",2018,0,0,15,15
"71431",2019,0,0,24,24
"71431",2020,0,0,86,86
"71433",2015,0,0,10,10
"71433",2017,0,0,32,32
"71433",2019,0,0,21,21
"71434",2015,0,0,10,10
"71434",2017,0,0,32,32
"71434",2019,0,0,21,21
"71435",2014,0,0,22,22
"71435",2018,0,0,15,15
"71435",2019,0,0,24,24
"71435",2020,0,0,86,86
"71437",2015,0,0,10,10
"71437",2017,0,0,32,32
"71437",2019,0,0,21,21
"71438",2017,0,0,32,32
"71438",2019,0,0,13,13
"71438",2020,0,0,35,35
"71439",2015,0,0,10,10
"71439",2017,0,0,54,54
"71439",2020,0,0,35,35
"71440",2017,0,0,32,32
"71440",2019,0,0,13,13
"71440",2020,0,0,35,35
"71441",2019,0,0,21,21
"71442",2014,0,0,22,22
"71442",2015,0,0,10,10
"71442",2017,0,0,32,32
"71442",2018,0,0,15,15
"71442",2019,0,0,24,24
"71442",2020,0,0,86,86
"71443",2014,0,0,22,22
"71443",2015,0,0,10,10
"71443",2017,0,0,32,32
"71443",2018,0,0,15,15
"71443",2019,0,0,24,24
"71443",2020,0,0,86,86
"71444",2014,0,0,22,22
"71444",2015,0,0,10,10
"71444",2017,0,0,32,32
"71444",2018,0,0,15,15
"71444",2019,0,0,24,24
"71444",2020,0,0,86,86
"71445",2014,0,0,22,22
"71445",2015,0,0,10,10
"71445",2017,0,0,32,32
"71445",2018,0,0,15,15
"71445",2019,0,0,24,24
"71445",2020,0,0,86,86
"71446",2019,0,0,21,21
"71447",2014,0,0,22,22
"71447",2015,0,0,10,10
"71447",2017,0,0,32,32
"71447",2018,0,0,15,15
"71447",2019,0,0,24,24
"71447",2020,0,0,86,86
"71448",2014,0,0,22,22
"71448",2015,0,0,10,10
"71448",2017,0,0,32,32
"71448",2018,0,0,15,15
"71448",2019,0,0,24,24
"71448",2020,0,0,86,86
"71449",2019,0,0,21,21
"71450",2017,0,0,32,32
"71450",2019,0,0,13,13
"71450",2020,0,0,35,35
"71451",2015,0,0,10,10
"71451",2017,0,0,32,32
"71451",2019,0,0,21,21
"71452",2019,0,0,21,21
"71453",2015,0,0,10,10
"71453",2017,0,0,32,32
"71453",2019,0,0,21,21
"71454",2014,0,0,22,22
"71454",2019,0,0,34,34
"71454",2020,0,0,55,55
"71455",2019,0,0,21,21
"71456",2014,0,0,22,22
"71456",2019,0,0,34,34
"71456",2020,0,0,55,55
"71457",2014,0,0,22,22
"71457",2015,0,0,10,10
"71457",2017,0,0,32,32
"71457",2018,0,0,15,15
"71457",2019,0,0,24,24
"71457",2020,0,0,86,86
"71458",2019,0,0,21,21
"71459",2014,0,0,22,22
"71459",2015,0,0,10,10
"71459",2017,0,0,32,32
"71459",2018,0,0,15,15
"71459",2019,0,0,24,24
"71459",2020,0,0,86,86
"71460",2014,0,0,22,22
"71460",2015,0,0,10,10
"71460",2017,0,0,32,32
"71460",2018,0,0,15,15
"71460",2019,0,0,24,24
"71460",2020,0,0,86,86
"71461",2019,0,0,21,21
"71462",2014,0,0,22,22
"71462",2019,0,0,34,34
"71462",2020,0,0,55,55
"71463",2015,0,0,10,10
"71463",2017,0,0,32,32
"71463",2019,0,0,21,21
"71464",2014,0,0,22,22
"71464",2018,0,0,15,15
"71464",2019,0,0,24,24
"71464",2020,0,0,86,86
"71466",2017,0,0,32,32
"71466",2019,0,0,13,13
"71466",2020,0,0,35,35
"71468",2017,0,0,32,32
"71468",2019,0,0,13,13
"71468",2020,0,0,35,35
"71469",2019,0,0,21,21
"71470",2019,0,0,21,21
"71471",2019,0,0,21,21
"71472",2017,0,0,32,32
"71472",2019,0,0,13,13
"71472",2020,0,0,35,35
"71473",2015,0,0,10,10
"71473",2017,0,0,32,32
"71473",2019,0,0,21,21
"71474",2017,0,0,32,32
"71474",2019,0,0,13,13
"71474",2020,0,0,35,35
"71475",2014,0,0,22,22
"71475",2015,0,0,10,10
"71475",2017,0,0,32,32
"71475",2018,0,0,15,15
"71475",2019,0,0,24,24
"71475",2020,0,0,86,86
"71478",2015,0,0,10,10
"71478",2017,0,0,32,32
"71478",2020,0,0,35,35
"71479",2017,0,0,32,32
"71479",2019,0,0,13,13
"71479",2020,0,0,35,35
"71480",2017,0,0,32,32
"71480",2019,0,0,13,13
"71480",2020,0,0,35,35
"71481",2014,0,0,22,22
"71481",2015,0,0,10,10
"71481",2017,0,0,32,32
"71481",2018,0,0,15,15
"71481",2019,0,0,24,24
"71481",2020,0,0,86,86
"71482",2015,0,0,10,10
"71482",2017,0,0,32,32
"71482",2020,0,0,35,35
"71483",2015,0,0,10,10
"71483",2017,0,0,32,32
"71483",2019,0,0,21,21
"71484",2014,0,0,22,22
"71484",2019,0,0,34,34
"71484",2020,0,0,55,55
"71485",2019,0,0,21,21
"71486",2015,0,0,10,10
"71486",2017,0,0,22,22
"71486",2020,0,0,35,35
"71487",2014,0,0,22,22
"71487",2015,0,0,10,10
"71487",2017,0,0,32,32
"71487",2018,0,0,15,15
"71487",2019,0,0,24,24
"71487",2020,0,0,86,86
"71488",2019,0,0,21,21
"71489",2014,0,0,22,22
"71489",2019,0,0,34,34
"71489",2020,0,0,55,55
"71490",2015,0,0,10,10
"71490",2017,0,0,32,32
"71490",2020,0,0,35,35
"71491",2015,0,0,10,10
"71491",2017,0,0,32,32
"71493",2017,0,0,32,32
"71493",2019,0,0,13,13
"71493",2020,0,0,35,35
"71494",2014,0,0,22,22
"71494",2015,0,0,10,10
"71494",2017,0,0,32,32
"71494",2018,0,0,15,15
"71494",2019,0,0,24,24
"71494",2020,0,0,86,86
"71495",2019,0,0,21,21
"71496",2014,0,0,22,22
"71496",2018,0,0,15,15
"71496",2019,0,0,24,24
"71496",2020,0,0,86,86
"71497",2014,0,0,22,22
"71497",2015,0,0,10,10
"71497",2017,0,0,32,32
"71497",2018,0,0,15,15
"71497",2019,0,0,24,24
"71497",2020,0,0,86,86
"71498",2019,0,0,21,21
"71499",2015,0,0,10,10
"71499",2017,0,0,32,32
"71499",2020,0,0,35,35
"71500",2015,0,0,10,10
"71500",2017,0,0,32,32
"71500",2019,0,0,21,21
"71501",2014,0,0,22,22
"71501",2015,0,0,10,10
"71501",2017,0,0,32,32
"71501",2018,0,0,15,15
"71501",2019,0,0,24,24
"71501",2020,0,0,86,86
"71502",2014,0,0,22,22
"71502",2015,0,0,10,10
"71502",2017,0,0,32,32
"71502",2018,0,0,15,15
"71502",2019,0,0,24,24
"71502",2020,0,0,86,86
"71503",2019,0,0,21,21
"71504",2014,0,0,22,22
"71504",2015,0,0,10,10
"71504",2017,0,0,32,32
"71504",2018,0,0,15,15
"71504",2019,0,0,24,24
"71504",2020,0,0,86,86
"71505",2019,0,0,21,21
"71506",2014,0,0,22,22
"71506",2019,0,0,34,34
"71506",2020,0,0,55,55
"71507",2019,0,0,21,21
"71508",2014,0,0,22,22
"71508",2019,0,0,34,34
"71508",2020,0,0,55,55
"71509",2017,0,0,32,32
"71509",2019,0,0,13,13
"71509",2020,0,0,35,35
"71510",2015,0,0,10,10
"71510",2017,0,0,32,32
"71510",2019,0,0,21,21
"71512",2019,0,0,21,21
"71513",2014,0,0,22,22
"71513",2015,0,0,10,10
"71513",2017,0,0,32,32
"71513",2018,0,0,15,15
"71513",2019,0,0,24,24
"71513",2020,0,0,86,86
"71514",2014,0,0,22,22
"71514",2019,0,0,34,34
"71514",2020,0,0,55,55
"71515",2019,0,0,21,21
"71516",2014,0,0,22,22
"71516",2019,0,0,34,34
"71516",2020,0,0,55,55
"71517",2014,0,0,22,22
"71517",2019,0,0,34,34
"71517",2020,0,0,55,55
"71518",2019,0,0,21,21
"71519",2014,0,0,22,22
"71519",2019,0,0,34,34
"71519",2020,0,0,55,55
"71520",2014,0,0,22,22
"71520",2015,0,0,10,10
"71520",2017,0,0,32,32
"71520",2018,0,0,15,15
"71520",2019,0,0,24,24
"71520",2020,0,0,86,86
"71521",2019,0,0,21,21
"71522",2014,0,0,22,22
"71522",2019,0,0,34,34
"71522",2020,0,0,55,55
"71523",2014,0,0,22,22
"71523",2019,0,0,34,34
"71523",2020,0,0,55,55
"71524",2019,0,0,21,21
"71525",2019,0,0,21,21
"71526",2014,0,0,22,22
"71526",2015,0,0,10,10
"71526",2017,0,0,32,32
"71526",2018,0,0,15,15
"71526",2019,0,0,24,24
"71526",2020,0,0,86,86
"71527",2017,0,0,32,32
"71527",2019,0,0,13,13
"71527",2020,0,0,35,35
"71528",2014,0,0,22,22
"71528",2019,0,0,34,34
"71528",2020,0,0,55,55
"71529",2019,0,0,21,21
"71530",2017,0,0,32,32
"71530",2019,0,0,13,13
"71530",2020,0,0,35,35
"71531",2015,0,0,10,10
"71531",2017,0,0,32,32
"71531",2020,0,0,35,35
"71532",2019,0,0,21,21
"71533",2015,0,0,10,10
"71533",2017,0,0,32,32
"71533",2019,0,0,21,21
"71534",2014,0,0,22,22
"71534",2019,0,0,34,34
"71534",2020,0,0,55,55
"71535",2017,0,0,32,32
"71535",2019,0,0,13,13
"71535",2020,0,0,35,35
"71537",2017,0,0,32,32
"71537",2019,0,0,13,13
"71537",2020,0,0,35,35
"71538",2014,0,0,22,22
"71538",2019,0,0,34,34
"71538",2020,0,0,55,55
"71539",2017,0,0,32,32
"71539",2019,0,0,13,13
"71539",2020,0,0,35,35
"71540",2015,0,0,10,10
"71540",2017,0,0,32,32
"71540",2020,0,0,35,35
"71541",2014,0,0,22,22
"71541",2019,0,0,34,34
"71541",2020,0,0,55,55
"71542",2015,0,0,10,10
"71542",2017,0,0,32,32
"71542",2020,0,0,35,35
"71543",2014,0,0,22,22
"71543",2015,0,0,10,10
"71543",2017,0,0,32,32
"71543",2018,0,0,15,15
"71543",2019,0,0,24,24
"71543",2020,0,0,86,86
"71544",2014,0,0,22,22
"71544",2019,0,0,34,34
"71544",2020,0,0,55,55
"71545",2019,0,0,21,21
"71546",2019,0,0,21,21
"71547",2019,0,0,21,21
"71548",2014,0,0,22,22
"71548",2019,0,0,34,34
"71548",2020,0,0,55,55
"71549",2014,0,0,22,22
"71549",2019,0,0,34,34
"71549",2020,0,0,55,55
"71550",2014,0,0,22,22
"71550",2015,0,0,10,10
"71550",2017,0,0,32,32
"71550",2018,0,0,15,15
"71550",2019,0,0,24,24
"71550",2020,0,0,86,86
"71551",2015,0,0,10,10
"71551",2017,0,0,32,32
"71551",2020,0,0,35,35
"71552",2017,0,0,32,32
"71552",2019,0,0,13,13
"71552",2020,0,0,35,35
"71553",2015,0,0,10,10
"71553",2017,0,0,32,32
"71553",2019,0,0,21,21
"71554",2015,0,0,10,10
"71554",2017,0,0,32,32
"71554",2019,0,0,21,21
"71555",2019,0,0,21,21
"71556",2014,0,0,22,22
"71556",2015,0,0,10,10
"71556",2017,0,0,32,32
"71556",2018,0,0,15,15
"71556",2019,0,0,24,24
"71556",2020,0,0,86,86
"71557",2015,0,0,10,10
"71557",2017,0,0,54,54
"71557",2020,0,0,35,35
"71558",2014,0,0,22,22
"71558",2019,0,0,34,34
"71558",2020,0,0,55,55
"71559",2015,0,0,10,10
"71559",2017,0,0,32,32
"71559",2019,0,0,21,21
"71561",2015,0,0,10,10
"71561",2017,0,0,32,32
"71561",2019,0,0,21,21
"71562",2015,0,0,10,10
"71562",2017,0,0,32,32
"71562",2019,0,0,21,21
"71563",2019,0,0,21,21
"71564",2015,0,0,10,10
"71564",2017,0,0,32,32
"71564",2019,0,0,21,21
"71565",2017,0,0,32,32
"71565",2019,0,0,13,13
"71565",2020,0,0,35,35
"71566",2014,0,0,22,22
"71566",2015,0,0,10,10
"71566",2017,0,0,32,32
"71566",2018,0,0,15,15
"71566",2019,0,0,24,24
"71566",2020,0,0,86,86
"71567",2014,0,0,22,22
"71567",2015,0,0,10,10
"71567",2017,0,0,32,32
"71567",2018,0,0,15,15
"71567",2019,0,0,24,24
"71567",2020,0,0,86,86
"71568",2014,0,0,22,22
"71568",2019,0,0,34,34
"71568",2020,0,0,55,55
"71570",2014,0,0,22,22
"71570",2015,0,0,10,10
"71570",2017,0,0,32,32
"71570",2018,0,0,15,15
"71570",2019,0,0,24,24
"71570",2020,0,0,86,86
"71571",2019,0,0,21,21
"71572",2019,0,0,21,21
"71573",2015,0,0,10,10
"71573",2017,0,0,32,32
"71573",2019,0,0,21,21
"71574",2019,0,0,21,21
"71576",2014,0,0,22,22
"71576",2015,0,0,10,10
"71576",2017,0,0,32,32
"71576",2018,0,0,15,15
"71576",2019,0,0,24,24
"71576",2020,0,0,86,86
"71577",2014,0,0,22,22
"71577",2019,0,0,34,34
"71577",2020,0,0,55,55
"71578",2014,0,0,22,22
"71578",2015,0,0,10,10
"71578",2017,0,0,32,32
"71578",2018,0,0,15,15
"71578",2019,0,0,24,24
"71578",2020,0,0,86,86
"71579",2014,0,0,22,22
"71579",2015,0,0,10,10
"71579",2017,0,0,32,32
"71579",2018,0,0,15,15
"71579",2019,0,0,24,24
"71579",2020,0,0,86,86
"71580",2014,0,0,22,22
"71580",2019,0,0,34,34
"71580",2020,0,0,55,55
"71581",2015,0,0,10,10
"71581",2017,0,0,32,32
"71581",2019,0,0,21,21
"71582",2019,0,0,21,21
"71583",2014,0,0,22,22
"71583",2015,0,0,10,10
"71583",2017,0,0,32,32
"71583",2018,0,0,15,15
"71583",2019,0,0,24,24
"71583",2020,0,0,86,86
"71584",2014,0,0,22,22
"71584",2015,0,0,10,10
"71584",2017,0,0,32,32
"71584",2018,0,0,15,15
"71584",2019,0,0,24,24
"71584",2020,0,0,86,86
"71585",2014,0,0,22,22
"71585",2015,0,0,10,10
"71585",2017,0,0,32,32
"71585",2018,0,0,15,15
"71585",2019,0,0,24,24
"71585",2020,0,0,86,86
"71586",2015,0,0,10,10
"71586",2017,0,0,32,32
"71586",2019,0,0,21,21
"71588",2015,0,0,10,10
"71588",2017,0,0,54,54
"71588",2020,0,0,35,35
"71589",2017,0,0,32,32
"71589",2019,0,0,13,13
"71589",2020,0,0,35,35
"71590",2015,0,0,10,10
"71590",2017,0,0,22,22
"71590",2020,0,0,35,35
"71591",2014,0,0,22,22
"71591",2015,0,0,10,10
"71591",2017,0,0,32,32
"71591",2018,0,0,15,15
"71591",2019,0,0,24,24
"71591",2020,0,0,86,86
"72001",2017,0,0,90,90
"72001",2018,0,0,122,122
"72001",2020,0,0,8,8
"72002",2018,0,0,122,122
"72002",2020,0,0,8,8
"72003",2015,0,0,76,76
"72003",2017,0,0,90,90
"72003",2018,0,0,13,13
"72003",2019,0,0,44,44
"72004",2015,0,0,76,76
"72004",2018,0,0,59,59
"72004",2019,0,0,23,23
"72004",2020,0,0,70,70
"72005",2017,0,0,90,90
"72005",2018,0,0,122,122
"72005",2020,0,0,8,8
"72006",2017,0,0,90,90
"72006",2018,0,0,122,122
"72006",2020,0,0,8,8
"72007",2015,0,0,76,76
"72007",2017,0,0,8,8
"72007",2018,0,0,14,14
"72007",2019,0,0,12,12
"72007",2020,0,0,14,14
"72008",2015,0,0,76,76
"72008",2017,0,0,90,90
"72008",2018,0,0,13,13
"72008",2019,0,0,44,44
"72009",2015,0,0,76,76
"72009",2017,0,0,98,98
"72009",2018,0,0,13,13
"72009",2019,0,0,56,56
"72010",2015,0,0,76,76
"72010",2018,0,0,45,45
"72010",2019,0,0,23,23
"72010",2020,0,0,70,70
"72011",2017,0,0,90,90
"72011",2018,0,0,122,122
"72011",2020,0,0,8,8
"72012",2017,0,0,90,90
"72012",2018,0,0,122,122
"72012",2020,0,0,8,8
"72013",2015,0,0,76,76
"72013",2017,0,0,8,8
"72013",2018,0,0,13,13
"72013",2019,0,0,63,63
"72013",2020,0,0,70,70
"72015",2017,0,0,90,90
"72015",2018,0,0,122,122
"72015",2020,0,0,8,8
"72016",2015,0,0,76,76
"72016",2018,0,0,45,45
"72016",2019,0,0,23,23
"72016",2020,0,0,13,13
"72017",2015,0,0,76,76
"72017",2018,0,0,129,129
"72017",2019,0,0,93,93
"72017",2020,0,0,63,63
"72018",2018,0,0,88,88
"72018",2019,0,0,7,7
"72018",2020,0,0,7,7
"72019",2015,0,0,76,76
"72019",2018,0,0,45,45
"72019",2019,0,0,23,23
"72019",2020,0,0,13,13
"72020",2017,0,0,8,8
"72020",2019,0,0,26,26
"72020",2020,0,0,14,14
"72021",2015,0,0,76,76
"72021",2018,0,0,45,45
"72021",2019,0,0,23,23
"72021",2020,0,0,70,70
"72022",2015,0,0,76,76
"72022",2017,0,0,98,98
"72022",2018,0,0,13,13
"72022",2019,0,0,56,56
"72023",2018,0,0,88,88
"72023",2019,0,0,7,7
"72024",2017,0,0,90,90
"72024",2018,0,0,122,122
"72024",2020,0,0,8,8
"72025",2015,0,0,76,76
"72025",2017,0,0,8,8
"72025",2018,0,0,13,13
"72025",2019,0,0,63,63
"72025",2020,0,0,14,14
"72027",2015,0,0,76,76
"72027",2017,0,0,8,8
"72027",2018,0,0,13,13
"72027",2019,0,0,63,63
"72027",2020,0,0,70,70
"72028",2015,0,0,76,76
"72028",2017,0,0,98,98
"72028",2018,0,0,20,20
"72028",2019,0,0,48,48
"72028",2020,0,0,7,7
"72029",2017,0,0,90,90
"72029",2018,0,0,122,122
"72029",2020,0,0,8,8
"72031",2017,0,0,8,8
"72031",2019,0,0,26,26
"72031",2020,0,0,14,14
"72032",2015,0,0,76,76
"72032",2017,0,0,90,90
"72032",2018,0,0,87,87
"72032",2019,0,0,7,7
"72032",2020,0,0,35,35
"72034",2017,0,0,90,90
"72034",2018,0,0,122,122
"72034",2020,0,0,8,8
"72035",2018,0,0,59,59
"72035",2019,0,0,7,7
"72036",2017,0,0,90,90
"72036",2018,0,0,122,122
"72036",2020,0,0,8,8
"72037",2017,0,0,90,90
"72037",2018,0,0,122,122
"72037",2020,0,0,8,8
"72038",2017,0,0,8,8
"72038",2019,0,0,26,26
"72038",2020,0,0,14,14
"72039",2018,0,0,88,88
"72039",2019,0,0,7,7
"72040",2017,0,0,8,8
"72040",2019,0,0,26,26
"72040",2020,0,0,14,14
"72041",2015,0,0,76,76
"72041",2017,0,0,8,8
"72041",2018,0,0,14,14
"72041",2019,0,0,12,12
"72041",2020,0,0,14,14
"72042",2018,0,0,14,14
"72042",2019,0,0,7,7
"72043",2017,0,0,90,90
"72043",2018,0,0,122,122
"72043",2020,0,0,8,8
"72044",2015,0,0,76,76
"72044",2017,0,0,98,98
"72044",2018,0,0,13,13
"72044",2019,0,0,56,56
"72045",2015,0,0,76,76
"72045",2018,0,0,129,129
"72045",2019,0,0,86,86
"72045",2020,0,0,63,63
"72046",2015,0,0,76,76
"72046",2017,0,0,8,8
"72046",2018,0,0,14,14
"72046",2019,0,0,12,12
"72046",2020,0,0,14,14
"72047",2015,0,0,76,76
"72047",2017,0,0,90,90
"72047",2018,0,0,14,14
"72047",2019,0,0,12,12
"72048",2018,0,0,88,88
"72048",2019,0,0,7,7
"72049",2015,0,0,76,76
"72049",2017,0,0,8,8
"72049",2018,0,0,13,13
"72049",2019,0,0,63,63
"72049",2020,0,0,70,70
"72050",2015,0,0,76,76
"72050",2018,0,0,45,45
"72050",2019,0,0,23,23
"72050",2020,0,0,13,13
"72051",2015,0,0,76,76
"72051",2017,0,0,90,90
"72051",2018,0,0,13,13
"72051",2019,0,0,44,44
"72052",2018,0,0,14,14
"72052",2019,0,0,15,15
"72053",2018,0,0,14,14
"72053",2019,0,0,7,7
"72054",2017,0,0,8,8
"72054",2019,0,0,26,26
"72054",2020,0,0,14,14
"72056",2017,0,0,90,90
"72056",2018,0,0,122,122
"72056",2020,0,0,8,8
"72057",2015,0,0,76,76
"72057",2017,0,0,90,90
"72057",2018,0,0,87,87
"72057",2019,0,0,7,7
"72057",2020,0,0,35,35
"72058",2017,0,0,90,90
"72058",2018,0,0,13,13
"72058",2019,0,0,42,42
"72059",2015,0,0,76,76
"72059",2018,0,0,45,45
"72059",2019,0,0,23,23
"72059",2020,0,0,70,70
"72060",2015,0,0,76,76
"72060",2017,0,0,8,8
"72060",2018,0,0,13,13
"72060",2019,0,0,63,63
"72060",2020,0,0,70,70
"72061",2015,0,0,76,76
"72061",2017,0,0,98,98
"72061",2018,0,0,13,13
"72061",2019,0,0,56,56
"72061",2020,0,0,7,7
"72062",2018,0,0,88,88
"72062",2019,0,0,7,7
"72062",2020,0,0,14,14
"72064",2018,0,0,59,59
"72064",2019,0,0,7,7
"72064",2020,0,0,35,35
"72065",2017,0,0,90,90
"72065",2018,0,0,122,122
"72065",2020,0,0,8,8
"72066",2017,0,0,90,90
"72066",2018,0,0,122,122
"72066",2020,0,0,8,8
"72067",2017,0,0,8,8
"72067",2019,0,0,26,26
"72067",2020,0,0,14,14
"72068",2015,0,0,76,76
"72068",2017,0,0,8,8
"72068",2018,0,0,13,13
"72068",2019,0,0,63,63
"72068",2020,0,0,70,70
"72070",2015,0,0,76,76
"72070",2018,0,0,59,59
"72070",2019,0,0,23,23
"72070",2020,0,0,70,70
"72071",2015,0,0,76,76
"72071",2017,0,0,8,8
"72071",2018,0,0,13,13
"72071",2019,0,0,63,63
"72071",2020,0,0,70,70
"72072",2015,0,0,76,76
"72072",2017,0,0,90,90
"72072",2018,0,0,20,20
"72072",2019,0,0,57,57
"72073",2017,0,0,90,90
"72073",2018,0,0,122,122
"72074",2015,0,0,76,76
"72074",2018,0,0,45,45
"72074",2019,0,0,23,23
"72074",2020,0,0,70,70
"72075",2015,0,0,76,76
"72075",2018,0,0,129,129
"72075",2019,0,0,86,86
"72075",2020,0,0,63,63
"72076",2017,0,0,90,90
"72076",2018,0,0,122,122
"72076",2020,0,0,8,8
"72077",2015,0,0,76,76
"72077",2017,0,0,8,8
"72077",2018,0,0,13,13
"72077",2019,0,0,63,63
"72077",2020,0,0,70,70
"72078",2017,0,0,90,90
"72078",2018,0,0,122,122
"72078",2020,0,0,8,8
"72079",2017,0,0,90,90
"72079",2018,0,0,122,122
"72079",2020,0,0,8,8
"72080",2017,0,0,8,8
"72080",2019,0,0,26,26
"72080",2020,0,0,14,14
"72083",2015,0,0,76,76
"72083",2018,0,0,45,45
"72083",2019,0,0,23,23
"72083",2020,0,0,70,70
"72084",2015,0,0,76,76
"72084",2017,0,0,98,98
"72084",2018,0,0,13,13
"72084",2019,0,0,56,56
"72085",2018,0,0,59,59
"72086",2018,0,0,88,88
"72086",2019,0,0,7,7
"72086",2020,0,0,7,7
"72087",2015,0,0,76,76
"72087",2017,0,0,90,90
"72087",2018,0,0,87,87
"72087",2019,0,0,12,12
"72087",2020,0,0,14,14
"72088",2018,0,0,88,88
"72088",2019,0,0,7,7
"72088",2020,0,0,7,7
"72089",2018,0,0,52,52
"72089",2020,0,0,28,28
"72090",2015,0,0,76,76
"72090",2017,0,0,8,8
"72090",2018,0,0,14,14
"72090",2019,0,0,12,12
"72090",2020,0,0,14,14
"72091",2018,0,0,122,122
"72091",2020,0,0,8,8
"72093",2017,0,0,8,8
"72093",2019,0,0,26,26
"72093",2020,0,0,14,14
"72094",2018,0,0,59,59
"72094",2019,0,0,7,7
"72095",2017,0,0,90,90
"72095",2018,0,0,122,122
"72095",2020,0,0,8,8
"72096",2018,0,0,129,129
"72098",2015,0,0,76,76
"72098",2017,0,0,98,98
"72098",2018,0,0,20,20
"72098",2019,0,0,48,48
"72098",2020,0,0,7,7
"72099",2017,0,0,90,90
"72099",2018,0,0,122,122
"72100",2017,0,0,90,90
"72100",2019,0,0,37,37
"72101",2018,0,0,88,88
"72101",2019,0,0,7,7
"72102",2018,0,0,88,88
"72102",2019,0,0,7,7
"72102",2020,0,0,7,7
"72103",2018,0,0,14,14
"72104",2018,0,0,122,122
"72104",2020,0,0,8,8
"72105",2015,0,0,76,76
"72105",2017,0,0,90,90
"72105",2018,0,0,87,87
"72105",2019,0,0,7,7
"72105",2020,0,0,35,35
"72106",2017,0,0,90,90
"72106",2019,0,0,37,37
"72106",2020,0,0,28,28
"72107",2015,0,0,76,76
"72107",2018,0,0,129,129
"72107",2019,0,0,86,86
"72107",2020,0,0,63,63
"72109",2018,0,0,52,52
"72110",2015,0,0,76,76
"72110",2017,0,0,8,8
"72110",2018,0,0,13,13
"72110",2019,0,0,63,63
"72110",2020,0,0,14,14
"72111",2018,0,0,59,59
"72111",2020,0,0,28,28
"72112",2018,0,0,88,88
"72112",2019,0,0,7,7
"72112",2020,0,0,7,7
"72113",2017,0,0,90,90
"72113",2018,0,0,122,122
"72114",2017,0,0,8,8
"72114",2019,0,0,26,26
"72114",2020,0,0,14,14
"72115",2015,0,0,76,76
"72115",2017,0,0,8,8
"72115",2018,0,0,13,13
"72115",2019,0,0,63,63
"72115",2020,0,0,70,70
"72118",2015,0,0,76,76
"72118",2017,0,0,8,8
"72118",2018,0,0,14,14
"72118",2019,0,0,12,12
"72118",2020,0,0,14,14
"72119",2018,0,0,52,52
"72119",2020,0,0,28,28
"72120",2017,0,0,90,90
"72120",2018,0,0,122,122
"72120",2020,0,0,8,8
"72121",2017,0,0,90,90
"72121",2018,0,0,122,122
"72122",2015,0,0,76,76
"72122",2017,0,0,8,8
"72122",2018,0,0,14,14
"72122",2019,0,0,12,12
"72122",2020,0,0,14,14
"72123",2017,0,0,90,90
"72123",2019,0,0,37,37
"72123",2020,0,0,28,28
"72124",2015,0,0,76,76
"72124",2017,0,0,90,90
"72124",2018,0,0,20,20
"72124",2019,0,0,57,57
"72125",2018,0,0,59,59
"72125",2019,0,0,7,7
"72126",2015,0,0,76,76
"72126",2018,0,0,59,59
"72126",2019,0,0,23,23
"72126",2020,0,0,70,70
"72127",2015,0,0,76,76
"72127",2017,0,0,90,90
"72127",2018,0,0,13,13
"72127",2019,0,0,44,44
"72128",2018,0,0,14,14
"72129",2017,0,0,8,8
"72129",2019,0,0,26,26
"72130",2017,0,0,90,90
"72130",2018,0,0,122,122
"72131",2015,0,0,76,76
"72131",2018,0,0,129,129
"72131",2019,0,0,86,86
"72131",2020,0,0,63,63
"72132",2017,0,0,8,8
"72132",2019,0,0,26,26
"72132",2020,0,0,14,14
"72133",2015,0,0,76,76
"72133",2017,0,0,90,90
"72133",2018,0,0,13,13
"72133",2019,0,0,44,44
"72134",2015,0,0,76,76
"72134",2017,0,0,8,8
"72134",2018,0,0,13,13
"72134",2019,0,0,63,63
"72134",2020,0,0,70,70
"72135",2015,0,0,76,76
"72135",2017,0,0,98,98
"72135",2018,0,0,20,20
"72135",2019,0,0,48,48
"72136",2015,0,0,76,76
"72136",2018,0,0,45,45
"72136",2019,0,0,23,23
"72136",2020,0,0,70,70
"72137",2017,0,0,90,90
"72137",2018,0,0,122,122
"72137",2020,0,0,8,8
"72138",2017,0,0,90,90
"72138",2018,0,0,122,122
"72138",2020,0,0,8,8
"72139",2017,0,0,90,90
"72139",2018,0,0,122,122
"72139",2020,0,0,8,8
"72141",2017,0,0,90,90
"72141",2018,0,0,122,122
"72141",2020,0,0,8,8
"72142",2017,0,0,98,98
"72142",2019,0,0,37,37
"72142",2020,0,0,14,14
"72143",2018,0,0,14,14
"72143",2019,0,0,7,7
"72144",2015,0,0,76,76
"72144",2017,0,0,90,90
"72144",2018,0,0,87,87
"72144",2019,0,0,7,7
"72144",2020,0,0,35,35
"72145",2015,0,0,76,76
"72145",2018,0,0,45,45
"72145",2019,0,0,23,23
"72146",2015,0,0,76,76
"72146",2017,0,0,90,90
"72146",2018,0,0,13,13
"72146",2019,0,0,44,44
"72147",2018,0,0,122,122
"72147",2020,0,0,8,8
"72148",2018,0,0,88,88
"72148",2019,0,0,7,7
"72148",2020,0,0,7,7
"72149",2015,0,0,76,76
"72149",2018,0,0,45,45
"72149",2019,0,0,23,23
"72149",2020,0,0,13,13
"72150",2018,0,0,122,122
"72151",2015,0,0,76,76
"72151",2018,0,0,45,45
"72151",2019,0,0,23,23
"72151",2020,0,0,13,13
"72152",2017,0,0,90,90
"72152",2018,0,0,122,122
"72152",2020,0,0,8,8
"72153",2018,0,0,14,14
"72153",2019,0,0,15,15
"72154",2015,0,0,76,76
"72154",2017,0,0,8,8
"72154",2018,0,0,13,13
"72154",2019,0,0,63,63
"72154",2020,0,0,70,70
"72155",2015,0,0,76,76
"72155",2017,0,0,90,90
"72155",2018,0,0,13,13
"72155",2019,0,0,42,42
"72156",2015,0,0,76,76
"72156",2017,0,0,90,90
"72156",2018,0,0,87,87
"72156",2019,0,0,7,7
"72156",2020,0,0,35,35
"72157",2017,0,0,90,90
"72157",2018,0,0,122,122
"72157",2020,0,0,8,8
"72158",2015,0,0,76,76
"72158",2017,0,0,90,90
"72158",2018,0,0,87,87
"72158",2019,0,0,12,12
"72158",2020,0,0,14,14
"72160",2015,0,0,76,76
"72160",2017,0,0,8,8
"72160",2018,0,0,13,13
"72160",2019,0,0,63,63
"72160",2020,0,0,7,7
"72161",2018,0,0,14,14
"72161",2019,0,0,15,15
"72163",2015,0,0,76,76
"72163",2017,0,0,98,98
"72163",2018,0,0,13,13
"72163",2019,0,0,56,56
"72164",2017,0,0,98,98
"72164",2019,0,0,37,37
"72164",2020,0,0,14,14
"72165",2017,0,0,8,8
"72165",2019,0,0,26,26
"72166",2015,0,0,76,76
"72166",2018,0,0,59,59
"72166",2019,0,0,23,23
"72166",2020,0,0,70,70
"72167",2017,0,0,90,90
"72167",2019,0,0,37,37
"72168",2015,0,0,76,76
"72168",2018,0,0,59,59
"72168",2019,0,0,23,23
"72168",2020,0,0,70,70
"72169",2015,0,0,76,76
"72169",2017,0,0,90,90
"72169",2018,0,0,13,13
"72169",2019,0,0,44,44
"72170",2017,0,0,98,98
"72170",2019,0,0,37,37
"72170",2020,0,0,14,14
"72171",2017,0,0,90,90
"72171",2018,0,0,122,122
"72171",2020,0,0,8,8
"72172",2015,0,0,76,76
"72172",2017,0,0,8,8
"72172",2018,0,0,14,14
"72172",2019,0,0,12,12
"72172",2020,0,0,14,14
"72173",2015,0,0,76,76
"72173",2017,0,0,8,8
"72173",2018,0,0,13,13
"72173",2019,0,0,63,63
"72173",2020,0,0,70,70
"72174",2018,0,0,88,88
"72174",2019,0,0,7,7
"72174",2020,0,0,7,7
"72175",2015,0,0,76,76
"72175",2017,0,0,98,98
"72175",2018,0,0,20,20
"72175",2019,0,0,48,48
"72175",2020,0,0,7,7
"72176",2015,0,0,76,76
"72176",2017,0,0,8,8
"72176",2018,0,0,13,13
"72176",2019,0,0,63,63
"72176",2020,0,0,70,70
"72177",2015,0,0,76,76
"72177",2018,0,0,129,129
"72177",2019,0,0,86,86
"72177",2020,0,0,63,63
"72178",2018,0,0,14,14
"72178",2019,0,0,7,7
"72179",2017,0,0,90,90
"72179",2019,0,0,37,37
"72180",2018,0,0,88,88
"72180",2019,0,0,7,7
"72180",2020,0,0,7,7
"72181",2017,0,0,90,90
"72181",2018,0,0,122,122
"72182",2015,0,0,76,76
"72182",2017,0,0,98,98
"72182",2018,0,0,20,20
"72182",2019,0,0,48,48
"72182",2020,0,0,7,7
"72183",2018,0,0,14,14
"72183",2019,0,0,15,15
"72184",2015,0,0,76,76
"72184",2018,0,0,45,45
"72184",2019,0,0,23,23
"72184",2020,0,0,70,70
"72185",2015,0,0,76,76
"72185",2017,0,0,8,8
"72185",2018,0,0,13,13
"72185",2019,0,0,63,63
"72185",2020,0,0,70,70
"72186",2018,0,0,122,122
"72186",2020,0,0,8,8
"72187",2018,0,0,14,14
"72187",2019,0,0,7,7
"72188",2018,0,0,88,88
"72188",2019,0,0,7,7
"72188",2020,0,0,7,7
"72189",2018,0,0,88,88
"72189",2019,0,0,7,7
"72189",2020,0,0,7,7
"72190",2015,0,0,76,76
"72190",2017,0,0,90,90
"72190",2018,0,0,87,87
"72190",2019,0,0,7,7
"72190",2020,0,0,35,35
"72191",2015,0,0,76,76
"72191",2017,0,0,98,98
"72191",2018,0,0,20,20
"72191",2019,0,0,48,48
"72191",2020,0,0,7,7
"72192",2017,0,0,90,90
"72192",2018,0,0,122,122
"72192",2020,0,0,8,8
"72193",2015,0,0,76,76
"72193",2017,0,0,90,90
"72193",2018,0,0,87,87
"72193",2019,0,0,7,7
"72193",2020,0,0,35,35
"72194",2018,0,0,122,122
"72194",2020,0,0,8,8
"72195",2017,0,0,90,90
"72195",2019,0,0,37,37
"72196",2018,0,0,88,88
"72196",2019,0,0,7,7
"72197",2017,0,0,90,90
"72197",2018,0,0,122,122
"72197",2020,0,0,8,8
"72198",2017,0,0,90,90
"72198",2018,0,0,122,122
"72198",2020,0,0,8,8
"72199",2017,0,0,90,90
"72199",2018,0,0,122,122
"72199",2020,0,0,8,8
"72200",2015,0,0,76,76
"72200",2017,0,0,90,90
"72200",2018,0,0,13,13
"72200",2019,0,0,44,44
"72201",2018,0,0,88,88
"72201",2019,0,0,7,7
"72201",2020,0,0,7,7
"72202",2018,0,0,88,88
"72202",2019,0,0,7,7
"72202",2020,0,0,7,7
"72204",2018,0,0,59,59
"72204",2019,0,0,7,7
"72205",2018,0,0,122,122
"72205",2020,0,0,8,8
"72208",2015,0,0,76,76
"72208",2017,0,0,90,90
"72208",2018,0,0,87,87
"72208",2019,0,0,7,7
"72208",2020,0,0,35,35
"72209",2017,0,0,90,90
"72209",2018,0,0,122,122
"72210",2018,0,0,14,14
"72211",2017,0,0,90,90
"72211",2018,0,0,122,122
"72212",2017,0,0,90,90
"72212",2018,0,0,122,122
"72212",2020,0,0,8,8
"72213",2015,0,0,76,76
"72213",2017,0,0,90,90
"72213",2018,0,0,13,13
"72213",2019,0,0,42,42
"72214",2018,0,0,88,88
"72214",2019,0,0,7,7
"72214",2020,0,0,7,7
"72215",2017,0,0,90,90
"72215",2018,0,0,122,122
"72215",2020,0,0,8,8
"72216",2017,0,0,90,90
"72216",2018,0,0,122,122
"72216",2020,0,0,8,8
"72217",2017,0,0,90,90
"72217",2018,0,0,122,122
"72218",2015,0,0,76,76
"72218",2018,0,0,45,45
"72218",2019,0,0,23,23
"72218",2020,0,0,70,70
"72219",2015,0,0,76,76
"72219",2018,0,0,59,59
"72219",2019,0,0,23,23
"72219",2020,0,0,70,70
"72220",2018,0,0,88,88
"72220",2019,0,0,7,7
"72220",2020,0,0,14,14
"72221",2015,0,0,76,76
"72221",2017,0,0,8,8
"72221",2018,0,0,13,13
"72221",2019,0,0,63,63
"72221",2020,0,0,70,70
"72222",2018,0,0,122,122
"72222",2020,0,0,8,8
"72223",2015,0,0,76,76
"72223",2018,0,0,129,129
"72223",2019,0,0,86,86
"72224",2015,0,0,76,76
"72224",2017,0,0,8,8
"72224",2018,0,0,14,14
"72224",2019,0,0,12,12
"72224",2020,0,0,14,14
"72225",2017,0,0,90,90
"72225",2018,0,0,122,122
"72225",2020,0,0,8,8
"72226",2015,0,0,76,76
"72226",2017,0,0,98,98
"72226",2018,0,0,20,20
"72226",2019,0,0,48,48
"72227",2017,0,0,98,98
"72227",2019,0,0,37,37
"72227",2020,0,0,14,14
"72228",2017,0,0,90,90
"72228",2019,0,0,37,37
"72229",2015,0,0,76,76
"72229",2018,0,0,45,45
"72229",2019,0,0,23,23
"72229",2020,0,0,70,70
"72230",2015,0,0,76,76
"72230",2017,0,0,90,90
"72230",2018,0,0,13,13
"72230",2019,0,0,44,44
"72231",2018,0,0,14,14
"72231",2019,0,0,7,7
"72232",2017,0,0,90,90
"72232",2019,0,0,37,37
"72232",2020,0,0,28,28
"72233",2018,0,0,88,88
"72233",2019,0,0,7,7
"72233",2020,0,0,7,7
"72234",2017,0,0,90,90
"72234",2018,0,0,122,122
"72235",2017,0,0,90,90
"72235",2018,0,0,122,122
"72235",2020,0,0,8,8
"72236",2017,0,0,90,90
"72236",2019,0,0,37,37
"72236",2020,0,0,28,28
"72237",2015,0,0,76,76
"72237",2018,0,0,129,129
"72237",2019,0,0,86,86
"72237",2020,0,0,63,63
"72238",2018,0,0,88,88
"72238",2019,0,0,7,7
"72238",2020,0,0,14,14
"72239",2015,0,0,76,76
"72239",2018,0,0,45,45
"72239",2019,0,0,23,23
"72239",2020,0,0,13,13
"72241",2017,0,0,8,8
"72241",2019,0,0,26,26
"72243",2015,0,0,76,76
"72243",2017,0,0,98,98
"72243",2018,0,0,20,20
"72243",2019,0,0,48,48
"72243",2020,0,0,7,7
"72244",2017,0,0,90,90
"72244",2019,0,0,37,37
"72244",2020,0,0,28,28
"72245",2017,0,0,8,8
"72245",2019,0,0,26,26
"72245",2020,0,0,14,14
"72246",2017,0,0,8,8
"72246",2019,0,0,26,26
"72247",2017,0,0,90,90
"72247",2018,0,0,122,122
"72248",2018,0,0,14,14
"72248",2019,0,0,7,7
"72249",2018,0,0,129,129
"72250",2015,0,0,76,76
"72250",2017,0,0,90,90
"72250",2018,0,0,87,87
"72250",2019,0,0,7,7
"72250",2020,0,0,35,35
"72251",2018,0,0,122,122
"72251",2020,0,0,8,8
"72252",2017,0,0,98,98
"72252",2018,0,0,13,13
"72252",2019,0,0,57,57
"72252",2020,0,0,7,7
"72253",2015,0,0,76,76
"72253",2017,0,0,90,90
"72253",2018,0,0,13,13
"72253",2019,0,0,44,44
"72254",2017,0,0,90,90
"72254",2018,0,0,122,122
"72254",2020,0,0,8,8
"72255",2015,0,0,76,76
"72255",2018,0,0,45,45
"72255",2019,0,0,23,23
"72256",2018,0,0,52,52
"72256",2020,0,0,28,28
"72257",2017,0,0,90,90
"72257",2018,0,0,122,122
"72259",2018,0,0,88,88
"72259",2019,0,0,7,7
"72259",2020,0,0,7,7
"72260",2017,0,0,90,90
"72260",2018,0,0,13,13
"72260",2019,0,0,42,42
"72261",2015,0,0,76,76
"72261",2018,0,0,45,45
"72261",2019,0,0,23,23
"72261",2020,0,0,70,70
"72262",2018,0,0,14,14
"72262",2019,0,0,15,15
"72264",2017,0,0,90,90
"72264",2019,0,0,37,37
"72264",2020,0,0,13,13
"72265",2018,0,0,88,88
"72265",2019,0,0,7,7
"72265",2020,0,0,7,7
"72266",2017,0,0,90,90
"72266",2018,0,0,122,122
"72267",2017,0,0,8,8
"72267",2019,0,0,26,26
"72267",2020,0,0,14,14
"72268",2015,0,0,76,76
"72268",2017,0,0,90,90
"72268",2018,0,0,20,20
"72268",2019,0,0,57,57
"72269",2015,0,0,76,76
"72269",2017,0,0,90,90
"72269",2018,0,0,87,87
"72269",2019,0,0,7,7
"72269",2020,0,0,35,35
"72270",2018,0,0,88,88
"72270",2019,0,0,7,7
"72270",2020,0,0,14,14
"72271",2017,0,0,8,8
"72271",2019,0,0,26,26
"72272",2018,0,0,59,59
"72273",2017,0,0,90,90
"72273",2018,0,0,122,122
"72273",2020,0,0,8,8
"72274",2015,0,0,76,76
"72274",2018,0,0,45,45
"72274",2019,0,0,23,23
"72274",2020,0,0,70,70
"72276",2018,0,0,88,88
"72276",2019,0,0,7,7
"72276",2020,0,0,14,14
"72277",2017,0,0,8,8
"72277",2019,0,0,26,26
"72277",2020,0,0,14,14
"72278",2015,0,0,76,76
"72278",2018,0,0,45,45
"72278",2019,0,0,23,23
"72278",2020,0,0,13,13
"72279",2018,0,0,14,14
"72280",2015,0,0,76,76
"72280",2017,0,0,90,90
"72280",2018,0,0,13,13
"72280",2019,0,0,44,44
"72281",2018,0,0,88,88
"72281",2019,0,0,7,7
"72281",2020,0,0,14,14
"72282",2017,0,0,90,90
"72282",2018,0,0,122,122
"72283",2015,0,0,76,76
"72283",2017,0,0,8,8
"72283",2018,0,0,13,13
"72283",2019,0,0,63,63
"72283",2020,0,0,70,70
"72286",2015,0,0,76,76
"72286",2017,0,0,90,90
"72286",2018,0,0,87,87
"72286",2020,0,0,35,35
"72287",2015,0,0,76,76
"72287",2017,0,0,90,90
"72287",2018,0,0,13,13
"72287",2019,0,0,42,42
"72289",2017,0,0,90,90
"72289",2018,0,0,122,122
"72289",2020,0,0,8,8
"72290",2017,0,0,90,90
"72290",2018,0,0,122,122
"72290",2020,0,0,8,8
"72291",2015,0,0,76,76
"72291",2017,0,0,98,98
"72291",2018,0,0,20,20
"72291",2019,0,0,48,48
"72292",2015,0,0,76,76
"72292",2017,0,0,90,90
"72292",2018,0,0,87,87
"72292",2019,0,0,7,7
"72292",2020,0,0,35,35
"72293",2017,0,0,90,90
"72293",2019,0,0,37,37
"72294",2017,0,0,90,90
"72294",2018,0,0,122,122
"72295",2018,0,0,88,88
"72295",2019,0,0,7,7
"72295",2020,0,0,14,14
"72296",2015,0,0,76,76
"72296",2017,0,0,90,90
"72296",2018,0,0,87,87
"72296",2019,0,0,7,7
"72296",2020,0,0,35,35
"72297",2017,0,0,90,90
"72297",2018,0,0,122,122
"72297",2020,0,0,8,8
"72298",2018,0,0,14,14
"72298",2019,0,0,7,7
"72299",2018,0,0,14,14
"72299",2019,0,0,7,7
"72300",2015,0,0,76,76
"72300",2017,0,0,8,8
"72300",2018,0,0,14,14
"72300",2019,0,0,12,12
"72302",2017,0,0,8,8
"72302",2019,0,0,26,26
"72302",2020,0,0,14,14
"72303",2015,0,0,76,76
"72303",2017,0,0,8,8
"72303",2018,0,0,14,14
"72303",2019,0,0,12,12
"72303",2020,0,0,14,14
"72305",2017,0,0,90,90
"72305",2018,0,0,122,122
"72305",2020,0,0,8,8
"72306",2015,0,0,76,76
"72306",2017,0,0,90,90
"72306",2018,0,0,13,13
"72306",2019,0,0,42,42
"72307",2015,0,0,76,76
"72307",2018,0,0,45,45
"72307",2019,0,0,23,23
"72307",2020,0,0,70,70
"72308",2017,0,0,90,90
"72308",2018,0,0,122,122
"72308",2020,0,0,8,8
"72309",2017,0,0,90,90
"72309",2018,0,0,122,122
"72310",2017,0,0,90,90
"72310",2018,0,0,122,122
"72310",2020,0,0,8,8
"72311",2015,0,0,76,76
"72311",2017,0,0,8,8
"72311",2018,0,0,13,13
"72311",2019,0,0,63,63
"72311",2020,0,0,70,70
"72312",2018,0,0,14,14
"72312",2019,0,0,41,41
"72313",2018,0,0,88,88
"72313",2019,0,0,7,7
"72313",2020,0,0,7,7
"72314",2018,0,0,14,14
"72314",2019,0,0,15,15
"72315",2018,0,0,52,52
"72316",2018,0,0,88,88
"72316",2019,0,0,7,7
"72316",2020,0,0,7,7
"72317",2017,0,0,98,98
"72317",2019,0,0,37,37
"72317",2020,0,0,14,14
"72319",2017,0,0,90,90
"72319",2018,0,0,122,122
"72319",2020,0,0,8,8
"72320",2017,0,0,90,90
"72320",2018,0,0,122,122
"72320",2020,0,0,8,8
"72321",2015,0,0,76,76
"72321",2018,0,0,45,45
"72321",2019,0,0,23,23
"72321",2020,0,0,70,70
"72322",2015,0,0,76,76
"72322",2017,0,0,90,90
"72322",2018,0,0,87,87
"72322",2019,0,0,7,7
"72322",2020,0,0,35,35
"72323",2017,0,0,90,90
"72323",2018,0,0,122,122
"72323",2020,0,0,8,8
"72324",2018,0,0,88,88
"72324",2019,0,0,7,7
"72324",2020,0,0,7,7
"72325",2018,0,0,14,14
"72325",2019,0,0,15,15
"72326",2018,0,0,88,88
"72326",2019,0,0,7,7
"72326",2020,0,0,14,14
"72327",2015,0,0,76,76
"72327",2017,0,0,98,98
"72327",2018,0,0,20,20
"72327",2019,0,0,48,48
"72327",2020,0,0,7,7
"72328",2017,0,0,90,90
"72328",2018,0,0,122,122
"72329",2017,0,0,90,90
"72329",2018,0,0,122,122
"72330",2015,0,0,76,76
"72330",2017,0,0,8,8
"72330",2018,0,0,13,13
"72330",2019,0,0,63,63
"72330",2020,0,0,70,70
"72331",2015,0,0,76,76
"72331",2017,0,0,8,8
"72331",2018,0,0,14,14
"72331",2019,0,0,12,12
"72331",2020,0,0,14,14
"72332",2017,0,0,90,90
"72332",2018,0,0,122,122
"72332",2020,0,0,8,8
"72333",2015,0,0,76,76
"72333",2017,0,0,90,90
"72333",2018,0,0,87,87
"72333",2019,0,0,12,12
"72333",2020,0,0,14,14
"72334",2018,0,0,52,52
"72336",2017,0,0,90,90
"72336",2019,0,0,37,37
"72336",2020,0,0,28,28
"72337",2017,0,0,90,90
"72337",2018,0,0,122,122
"72338",2017,0,0,90,90
"72338",2018,0,0,122,122
"72338",2020,0,0,8,8
"72339",2015,0,0,76,76
"72339",2017,0,0,90,90
"72339",2018,0,0,13,13
"72339",2019,0,0,44,44
"72340",2018,0,0,122,122
"72341",2015,0,0,76,76
"72341",2017,0,0,8,8
"72341",2018,0,0,14,14
"72341",2019,0,0,12,12
"72341",2020,0,0,14,14
"72342",2017,0,0,8,8
"72342",2019,0,0,26,26
"72342",2020,0,0,14,14
"72343",2017,0,0,90,90
"72343",2019,0,0,37,37
"72343",2020,0,0,13,13
"72344",2015,0,0,76,76
"72344",2017,0,0,90,90
"72344",2018,0,0,13,13
"72344",2019,0,0,44,44
"72345",2015,0,0,76,76
"72345",2017,0,0,8,8
"72345",2018,0,0,14,14
"72345",2019,0,0,12,12
"72345",2020,0,0,14,14
"72346",2017,0,0,90,90
"72346",2019,0,0,37,37
"72347",2018,0,0,14,14
"72347",2019,0,0,43,43
"72347",2020,0,0,28,28
"72348",2015,0,0,76,76
"72348",2018,0,0,59,59
"72348",2019,0,0,23,23
"72348",2020,0,0,70,70
"72349",2018,0,0,122,122
"72349",2020,0,0,8,8
"72350",2015,0,0,76,76
"72350",2017,0,0,90,90
"72350",2018,0,0,13,13
"72350",2019,0,0,42,42
"72351",2018,0,0,52,52
"72351",2020,0,0,28,28
"72352",2018,0,0,88,88
"72352",2019,0,0,7,7
"72352",2020,0,0,7,7
"72353",2015,0,0,76,76
"72353",2017,0,0,90,90
"72353",2018,0,0,87,87
"72353",2019,0,0,7,7
"72353",2020,0,0,35,35
"72354",2018,0,0,122,122
"72354",2020,0,0,8,8
"72355",2017,0,0,90,90
"72355",2018,0,0,122,122
"72355",2020,0,0,8,8
"72356",2018,0,0,14,14
"72356",2019,0,0,15,15
"72357",2015,0,0,76,76
"72357",2017,0,0,8,8
"72357",2018,0,0,13,13
"72357",2019,0,0,63,63
"72357",2020,0,0,70,70
"72358",2015,0,0,76,76
"72358",2017,0,0,8,8
"72358",2018,0,0,14,14
"72358",2019,0,0,12,12
"72358",2020,0,0,14,14
"72360",2017,0,0,90,90
"72360",2018,0,0,122,122
"72361",2018,0,0,14,14
"72361",2019,0,0,7,7
"72362",2017,0,0,90,90
"72362",2018,0,0,122,122
"72362",2020,0,0,8,8
"72363",2017,0,0,8,8
"72363",2019,0,0,26,26
"72363",2020,0,0,14,14
"72364",2015,0,0,76,76
"72364",2017,0,0,8,8
"72364",2018,0,0,13,13
"72364",2019,0,0,63,63
"72364",2020,0,0,70,70
"72366",2015,0,0,76,76
"72366",2017,0,0,90,90
"72366",2018,0,0,87,87
"72366",2019,0,0,7,7
"72366",2020,0,0,35,35
"72367",2015,0,0,76,76
"72367",2018,0,0,59,59
"72367",2019,0,0,23,23
"72367",2020,0,0,70,70
"72368",2018,0,0,59,59
"72369",2015,0,0,76,76
"72369",2017,0,0,98,98
"72369",2018,0,0,20,20
"72369",2019,0,0,48,48
"72369",2020,0,0,7,7
"72370",2017,0,0,90,90
"72370",2018,0,0,122,122
"72370",2020,0,0,8,8
"72372",2018,0,0,88,88
"72372",2019,0,0,7,7
"72372",2020,0,0,14,14
"72373",2015,0,0,76,76
"72373",2017,0,0,90,90
"72373",2018,0,0,87,87
"72373",2019,0,0,12,12
"72373",2020,0,0,14,14
"72374",2018,0,0,122,122
"72374",2020,0,0,8,8
"72375",2017,0,0,8,8
"72375",2019,0,0,26,26
"72375",2020,0,0,14,14
"72376",2018,0,0,14,14
"72376",2019,0,0,7,7
"72377",2015,0,0,76,76
"72377",2017,0,0,98,98
"72377",2018,0,0,13,13
"72377",2019,0,0,56,56
"72378",2017,0,0,90,90
"72378",2019,0,0,37,37
"72379",2017,0,0,90,90
"72379",2019,0,0,37,37
"72379",2020,0,0,13,13
"72380",2018,0,0,122,122
"72380",2020,0,0,8,8
"72381",2015,0,0,76,76
"72381",2017,0,0,90,90
"72381",2018,0,0,13,13
"72381",2019,0,0,44,44
"72382",2015,0,0,76,76
"72382",2017,0,0,8,8
"72382",2018,0,0,14,14
"72382",2019,0,0,12,12
"72382",2020,0,0,14,14
"72383",2015,0,0,76,76
"72383",2017,0,0,8,8
"72383",2018,0,0,14,14
"72383",2019,0,0,12,12
"72383",2020,0,0,14,14
"72385",2015,0,0,76,76
"72385",2017,0,0,90,90
"72385",2018,0,0,20,20
"72385",2019,0,0,57,57
"72386",2017,0,0,90,90
"72386",2018,0,0,122,122
"73001",2015,0,41,36,77
"73001",2017,0,269,176,445
"73001",2018,0,61,12,73
"73001",2019,0,190,74,264
"73001",2020,0,150,64,214
"73003",2015,0,41,0,41
"73003",2016,0,0,22,22
"73003",2017,0,269,176,445
"73003",2018,0,61,145,206
"73003",2019,0,190,190,380
"73003",2020,0,150,150,300
"73004",2015,0,41,36,77
"73004",2017,0,269,176,445
"73004",2018,0,61,0,61
"73004",2019,0,190,105,295
"73004",2020,0,150,50,200
"73005",2015,0,41,36,77
"73005",2017,0,269,176,445
"73005",2018,0,61,8,69
"73005",2019,0,190,105,295
"73005",2020,0,150,50,200
"73006",2015,0,41,36,77
"73006",2016,0,0,22,22
"73006",2017,0,269,176,445
"73006",2018,0,61,145,206
"73006",2019,0,190,190,380
"73006",2020,0,150,150,300
"73007",2015,0,41,36,77
"73007",2016,0,0,22,22
"73007",2017,0,269,176,445
"73007",2018,0,61,0,61
"73007",2019,0,190,163,353
"73007",2020,0,150,150,300
"73008",2015,0,41,36,77
"73008",2017,0,269,176,445
"73008",2018,0,61,12,73
"73008",2019,0,190,163,353
"73008",2020,0,150,64,214
"73010",2015,0,41,36,77
"73010",2017,0,269,176,445
"73010",2018,0,61,12,73
"73010",2019,0,190,163,353
"73010",2020,0,150,64,214
"73011",2015,0,41,36,77
"73011",2016,0,0,22,22
"73011",2017,0,269,176,445
"73011",2018,0,61,0,61
"73011",2019,0,190,163,353
"73011",2020,0,150,150,300
"73012",2015,0,41,0,41
"73012",2016,0,0,22,22
"73012",2017,0,269,176,445
"73012",2018,0,61,145,206
"73012",2019,0,190,190,380
"73012",2020,0,150,150,300
"73013",2015,0,41,0,41
"73013",2016,0,0,22,22
"73013",2017,0,269,176,445
"73013",2018,0,61,145,206
"73013",2019,0,190,190,380
"73013",2020,0,150,150,300
"73014",2015,0,41,36,77
"73014",2016,0,0,22,22
"73014",2017,0,269,176,445
"73014",2018,0,61,0,61
"73014",2019,0,190,163,353
"73014",2020,0,150,150,300
"73015",2015,0,41,0,41
"73015",2016,0,0,22,22
"73015",2017,0,269,176,445
"73015",2018,0,61,145,206
"73015",2019,0,190,190,380
"73015",2020,0,150,150,300
"73017",2015,0,41,36,77
"73017",2017,0,269,176,445
"73017",2018,0,61,0,61
"73017",2019,0,190,74,264
"73017",2020,0,150,64,214
"73018",2015,0,41,36,77
"73018",2016,0,0,22,22
"73018",2017,0,269,176,445
"73018",2018,0,61,0,61
"73018",2019,0,190,163,353
"73018",2020,0,150,150,300
"73019",2015,0,41,0,41
"73019",2016,0,0,22,22
"73019",2017,0,269,176,445
"73019",2018,0,61,145,206
"73019",2019,0,190,190,380
"73019",2020,0,150,150,300
"73020",2015,0,41,36,77
"73020",2017,0,269,176,445
"73020",2018,0,61,8,69
"73020",2019,0,190,105,295
"73020",2020,0,150,50,200
"73021",2015,0,41,36,77
"73021",2016,0,0,22,22
"73021",2017,0,269,176,445
"73021",2018,0,61,0,61
"73021",2019,0,190,163,353
"73021",2020,0,150,150,300
"73022",2015,0,41,36,77
"73022",2017,0,269,176,445
"73022",2018,0,61,12,73
"73022",2019,0,190,74,264
"73022",2020,0,150,64,214
"73023",2015,0,41,0,41
"73023",2016,0,0,22,22
"73023",2017,0,269,176,445
"73023",2018,0,61,145,206
"73023",2019,0,190,190,380
"73023",2020,0,150,150,300
"73024",2015,0,41,0,41
"73024",2016,0,0,22,22
"73024",2017,0,269,176,445
"73024",2018,0,61,145,206
"73024",2019,0,190,190,380
"73024",2020,0,150,150,300
"73025",2015,0,41,36,77
"73025",2017,0,269,176,445
"73025",2018,0,61,12,73
"73025",2019,0,190,74,264
"73025",2020,0,150,64,214
"73026",2015,0,41,0,41
"73026",2016,0,0,22,22
"73026",2017,0,269,176,445
"73026",2018,0,61,145,206
"73026",2019,0,190,190,380
"73026",2020,0,150,150,300
"73027",2015,0,41,36,77
"73027",2017,0,269,176,445
"73027",2018,0,61,12,73
"73027",2019,0,190,74,264
"73027",2020,0,150,64,214
"73028",2015,0,41,36,77
"73028",2017,0,269,176,445
"73028",2018,0,61,12,73
"73028",2019,0,190,74,264
"73028",2020,0,150,64,214
"73029",2015,0,41,36,77
"73029",2017,0,269,176,445
"73029",2018,0,61,12,73
"73029",2019,0,190,163,353
"73029",2020,0,150,64,214
"73030",2015,0,41,36,77
"73030",2017,0,269,176,445
"73030",2018,0,61,12,73
"73030",2019,0,190,163,353
"73030",2020,0,150,64,214
"73031",2015,0,41,36,77
"73031",2017,0,269,176,445
"73031",2018,0,61,12,73
"73031",2019,0,190,163,353
"73031",2020,0,150,64,214
"73032",2015,0,41,36,77
"73032",2016,0,0,22,22
"73032",2017,0,269,176,445
"73032",2018,0,61,145,206
"73032",2019,0,190,190,380
"73032",2020,0,150,150,300
"73033",2015,0,41,36,77
"73033",2017,0,269,176,445
"73033",2018,0,61,12,73
"73033",2019,0,190,74,264
"73033",2020,0,150,64,214
"73034",2015,0,41,36,77
"73034",2016,0,0,22,22
"73034",2017,0,269,176,445
"73034",2018,0,61,145,206
"73034",2019,0,190,190,380
"73034",2020,0,150,150,300
"73036",2015,0,41,36,77
"73036",2017,0,269,176,445
"73036",2018,0,61,8,69
"73036",2019,0,190,105,295
"73036",2020,0,150,50,200
"73039",2015,0,41,36,77
"73039",2017,0,269,176,445
"73039",2018,0,61,12,73
"73039",2019,0,190,74,264
"73039",2020,0,150,64,214
"73040",2015,0,41,0,41
"73040",2016,0,0,22,22
"73040",2017,0,269,176,445
"73040",2018,0,61,145,206
"73040",2019,0,190,190,380
"73040",2020,0,150,150,300
"73041",2015,0,41,36,77
"73041",2016,0,0,22,22
"73041",2017,0,269,176,445
"73041",2018,0,61,0,61
"73041",2019,0,190,163,353
"73041",2020,0,150,150,300
"73042",2015,0,41,36,77
"73042",2017,0,269,176,445
"73042",2018,0,61,12,73
"73042",2019,0,190,74,264
"73042",2020,0,150,64,214
"73043",2015,0,41,36,77
"73043",2017,0,269,176,445
"73043",2018,0,61,12,73
"73043",2019,0,190,163,353
"73043",2020,0,150,64,214
"73047",2015,0,41,0,41
"73047",2016,0,0,22,22
"73047",2017,0,269,176,445
"73047",2018,0,61,145,206
"73047",2019,0,190,190,380
"73047",2020,0,150,150,300
"73048",2015,0,41,36,77
"73048",2016,0,0,22,22
"73048",2017,0,269,176,445
"73048",2018,0,61,0,61
"73048",2019,0,190,163,353
"73048",2020,0,150,150,300
"73049",2015,0,41,36,77
"73049",2016,0,0,22,22
"73049",2017,0,269,176,445
"73049",2018,0,61,0,61
"73049",2019,0,190,163,353
"73049",2020,0,150,150,300
"73050",2015,0,41,36,77
"73050",2017,0,269,176,445
"73050",2018,0,61,12,73
"73050",2019,0,190,74,264
"73050",2020,0,150,64,214
"73051",2015,0,41,36,77
"73051",2017,0,269,176,445
"73051",2018,0,61,12,73
"73051",2019,0,190,74,264
"73051",2020,0,150,64,214
"73052",2015,0,41,36,77
"73052",2016,0,0,22,22
"73052",2017,0,269,176,445
"73052",2018,0,61,0,61
"73052",2019,0,190,163,353
"73052",2020,0,150,150,300
"73053",2015,0,41,36,77
"73053",2016,0,0,22,22
"73053",2017,0,269,176,445
"73053",2018,0,61,0,61
"73053",2019,0,190,163,353
"73053",2020,0,150,150,300
"73054",2015,0,41,36,77
"73054",2016,0,0,22,22
"73054",2017,0,269,176,445
"73054",2018,0,61,145,206
"73054",2019,0,190,190,380
"73054",2020,0,150,150,300
"73055",2015,0,41,0,41
"73055",2016,0,0,22,22
"73055",2017,0,269,176,445
"73055",2018,0,61,145,206
"73055",2019,0,190,190,380
"73055",2020,0,150,150,300
"73057",2015,0,41,0,41
"73057",2016,0,0,22,22
"73057",2017,0,269,176,445
"73057",2018,0,61,145,206
"73057",2019,0,190,190,380
"73057",2020,0,150,150,300
"73058",2015,0,41,36,77
"73058",2017,0,269,176,445
"73058",2018,0,61,12,73
"73058",2019,0,190,74,264
"73058",2020,0,150,64,214
"73059",2015,0,41,36,77
"73059",2017,0,269,176,445
"73059",2018,0,61,12,73
"73059",2019,0,190,163,353
"73059",2020,0,150,64,214
"73061",2015,0,41,36,77
"73061",2016,0,0,22,22
"73061",2017,0,269,176,445
"73061",2018,0,61,0,61
"73061",2019,0,190,163,353
"73061",2020,0,150,150,300
"73063",2015,0,41,36,77
"73063",2016,0,0,22,22
"73063",2017,0,269,176,445
"73063",2018,0,61,145,206
"73063",2019,0,190,190,380
"73063",2020,0,150,150,300
"73064",2015,0,41,36,77
"73064",2017,0,269,176,445
"73064",2018,0,61,0,61
"73064",2019,0,190,163,353
"73064",2020,0,150,64,214
"73065",2015,0,41,36,77
"73065",2017,0,269,176,445
"73065",2018,0,61,12,73
"73065",2019,0,190,163,353
"73065",2020,0,150,64,214
"73067",2015,0,41,0,41
"73067",2016,0,0,22,22
"73067",2017,0,269,176,445
"73067",2018,0,61,145,206
"73067",2019,0,190,190,380
"73067",2020,0,150,150,300
"73068",2015,0,41,36,77
"73068",2016,0,0,22,22
"73068",2017,0,269,176,445
"73068",2018,0,61,0,61
"73068",2019,0,190,163,353
"73068",2020,0,150,150,300
"73069",2015,0,41,36,77
"73069",2016,0,0,22,22
"73069",2017,0,269,176,445
"73069",2018,0,61,0,61
"73069",2019,0,190,163,353
"73069",2020,0,150,150,300
"73070",2015,0,41,36,77
"73070",2017,0,269,176,445
"73070",2018,0,61,12,73
"73070",2019,0,190,74,264
"73070",2020,0,150,64,214
"73071",2015,0,41,0,41
"73071",2016,0,0,22,22
"73071",2017,0,269,176,445
"73071",2018,0,61,145,206
"73071",2019,0,190,190,380
"73071",2020,0,150,150,300
"73072",2015,0,41,36,77
"73072",2016,0,0,22,22
"73072",2017,0,269,176,445
"73072",2018,0,61,0,61
"73072",2019,0,190,163,353
"73072",2020,0,150,150,300
"73073",2015,0,41,36,77
"73073",2017,0,269,176,445
"73073",2018,0,61,12,73
"73073",2019,0,190,74,264
"73073",2020,0,150,64,214
"73074",2015,0,41,0,41
"73074",2016,0,0,22,22
"73074",2017,0,269,176,445
"73074",2018,0,61,145,206
"73074",2019,0,190,190,380
"73074",2020,0,150,150,300
"73075",2015,0,41,36,77
"73075",2016,0,0,22,22
"73075",2017,0,269,176,445
"73075",2018,0,61,0,61
"73075",2019,0,190,163,353
"73075",2020,0,150,150,300
"73076",2015,0,41,36,77
"73076",2017,0,269,176,445
"73076",2018,0,61,12,73
"73076",2019,0,190,74,264
"73076",2020,0,150,64,214
"73077",2015,0,41,36,77
"73077",2016,0,0,22,22
"73077",2017,0,269,176,445
"73077",2018,0,61,145,206
"73077",2019,0,190,190,380
"73077",2020,0,150,150,300
"73078",2015,0,41,36,77
"73078",2017,0,269,176,445
"73078",2018,0,61,12,73
"73078",2019,0,190,74,264
"73078",2020,0,150,64,214
"73079",2015,0,41,36,77
"73079",2016,0,0,22,22
"73079",2017,0,269,176,445
"73079",2018,0,61,0,61
"73079",2019,0,190,163,353
"73079",2020,0,150,150,300
"73081",2015,0,41,36,77
"73081",2017,0,269,176,445
"73081",2018,0,61,8,69
"73081",2019,0,190,105,295
"73081",2020,0,150,50,200
"73082",2015,0,41,36,77
"73082",2016,0,0,22,22
"73082",2017,0,269,176,445
"73082",2018,0,61,0,61
"73082",2019,0,190,163,353
"73082",2020,0,150,150,300
"73083",2015,0,41,0,41
"73083",2016,0,0,22,22
"73083",2017,0,269,176,445
"73083",2018,0,61,145,206
"73083",2019,0,190,190,380
"73083",2020,0,150,150,300
"73084",2015,0,41,36,77
"73084",2017,0,269,176,445
"73084",2018,0,61,0,61
"73084",2019,0,190,163,353
"73084",2020,0,150,64,214
"73085",2015,0,41,36,77
"73085",2017,0,269,176,445
"73085",2018,0,61,12,73
"73085",2019,0,190,163,353
"73085",2020,0,150,64,214
"73086",2015,0,41,36,77
"73086",2017,0,269,176,445
"73086",2018,0,61,0,61
"73086",2019,0,190,105,295
"73086",2020,0,150,50,200
"73087",2015,0,41,36,77
"73087",2017,0,269,176,445
"73087",2018,0,61,12,73
"73087",2019,0,190,163,353
"73087",2020,0,150,64,214
"73088",2015,0,41,36,77
"73088",2016,0,0,22,22
"73088",2017,0,269,176,445
"73088",2018,0,61,145,206
"73088",2019,0,190,190,380
"73088",2020,0,150,150,300
"73089",2015,0,41,36,77
"73089",2016,0,0,22,22
"73089",2017,0,269,176,445
"73089",2018,0,61,0,61
"73089",2019,0,190,163,353
"73089",2020,0,150,150,300
"73090",2015,0,41,36,77
"73090",2017,0,269,176,445
"73090",2018,0,61,8,69
"73090",2019,0,190,105,295
"73090",2020,0,150,50,200
"73091",2015,0,41,36,77
"73091",2017,0,269,176,445
"73091",2018,0,61,12,73
"73091",2019,0,190,74,264
"73091",2020,0,150,64,214
"73092",2015,0,41,36,77
"73092",2017,0,269,176,445
"73092",2018,0,61,12,73
"73092",2019,0,190,74,264
"73092",2020,0,150,64,214
"73094",2015,0,41,36,77
"73094",2016,0,0,22,22
"73094",2017,0,269,176,445
"73094",2018,0,61,145,206
"73094",2019,0,190,190,380
"73094",2020,0,150,150,300
"73095",2015,0,41,36,77
"73095",2016,0,0,22,22
"73095",2017,0,269,176,445
"73095",2018,0,61,0,61
"73095",2019,0,190,163,353
"73095",2020,0,150,150,300
"73096",2015,0,41,36,77
"73096",2017,0,269,176,445
"73096",2018,0,61,0,61
"73096",2019,0,190,163,353
"73096",2020,0,150,64,214
"73097",2015,0,41,36,77
"73097",2017,0,269,176,445
"73097",2018,0,61,0,61
"73097",2019,0,190,163,353
"73097",2020,0,150,64,214
"73098",2015,0,41,36,77
"73098",2017,0,269,176,445
"73098",2018,0,61,8,69
"73098",2019,0,190,105,295
"73098",2020,0,150,50,200
"73099",2015,0,41,36,77
"73099",2016,0,0,22,22
"73099",2017,0,269,176,445
"73099",2018,0,61,0,61
"73099",2019,0,190,163,353
"73099",2020,0,150,150,300
"73100",2015,0,41,36,77
"73100",2017,0,269,176,445
"73100",2018,0,61,12,73
"73100",2019,0,190,74,264
"73100",2020,0,150,64,214
"73101",2015,0,41,36,77
"73101",2017,0,269,176,445
"73101",2018,0,61,8,69
"73101",2019,0,190,105,295
"73101",2020,0,150,50,200
"73103",2015,0,41,36,77
"73103",2017,0,269,176,445
"73103",2018,0,61,12,73
"73103",2019,0,190,163,353
"73103",2020,0,150,64,214
"73104",2015,0,41,36,77
"73104",2017,0,269,176,445
"73104",2018,0,61,12,73
"73104",2019,0,190,74,264
"73104",2020,0,150,64,214
"73105",2015,0,41,36,77
"73105",2017,0,269,176,445
"73105",2018,0,61,12,73
"73105",2019,0,190,74,264
"73105",2020,0,150,64,214
"73106",2015,0,41,36,77
"73106",2017,0,269,176,445
"73106",2018,0,61,0,61
"73106",2019,0,190,105,295
"73106",2020,0,150,50,200
"73107",2015,0,41,36,77
"73107",2017,0,269,176,445
"73107",2018,0,61,0,61
"73107",2019,0,190,74,264
"73107",2020,0,150,64,214
"73109",2015,0,41,0,41
"73109",2016,0,0,22,22
"73109",2017,0,269,176,445
"73109",2018,0,61,145,206
"73109",2019,0,190,190,380
"73109",2020,0,150,150,300
"73110",2015,0,41,36,77
"73110",2016,0,0,22,22
"73110",2017,0,269,176,445
"73110",2018,0,61,0,61
"73110",2019,0,190,163,353
"73110",2020,0,150,150,300
"73113",2015,0,41,0,41
"73113",2016,0,0,22,22
"73113",2017,0,269,176,445
"73113",2018,0,61,145,206
"73113",2019,0,190,190,380
"73113",2020,0,150,150,300
"73114",2015,0,41,36,77
"73114",2016,0,0,22,22
"73114",2017,0,269,176,445
"73114",2018,0,61,145,206
"73114",2019,0,190,190,380
"73114",2020,0,150,150,300
"73116",2015,0,41,0,41
"73116",2016,0,0,22,22
"73116",2017,0,269,176,445
"73116",2018,0,61,145,206
"73116",2019,0,190,190,380
"73116",2020,0,150,150,300
"73117",2015,0,41,0,41
"73117",2016,0,0,22,22
"73117",2017,0,269,176,445
"73117",2018,0,61,145,206
"73117",2019,0,190,190,380
"73117",2020,0,150,150,300
"73119",2015,0,41,0,41
"73119",2016,0,0,22,22
"73119",2017,0,269,176,445
"73119",2018,0,61,145,206
"73119",2019,0,190,190,380
"73119",2020,0,150,150,300
"73120",2015,0,41,36,77
"73120",2017,0,269,176,445
"73120",2018,0,61,0,61
"73120",2019,0,190,105,295
"73120",2020,0,150,50,200
"73121",2015,0,41,36,77
"73121",2016,0,0,22,22
"73121",2017,0,269,176,445
"73121",2018,0,61,0,61
"73121",2019,0,190,163,353
"73121",2020,0,150,150,300
"73122",2015,0,41,36,77
"73122",2017,0,269,176,445
"73122",2018,0,61,12,73
"73122",2019,0,190,74,264
"73122",2020,0,150,64,214
"73123",2015,0,41,36,77
"73123",2016,0,0,22,22
"73123",2017,0,269,176,445
"73123",2018,0,61,145,206
"73123",2019,0,190,190,380
"73123",2020,0,150,150,300
"73124",2015,0,41,36,77
"73124",2016,0,0,22,22
"73124",2017,0,269,176,445
"73124",2018,0,61,0,61
"73124",2019,0,190,163,353
"73124",2020,0,150,150,300
"73128",2015,0,41,36,77
"73128",2017,0,269,176,445
"73128",2018,0,61,12,73
"73128",2019,0,190,163,353
"73128",2020,0,150,64,214
"73129",2015,0,41,36,77
"73129",2017,0,269,176,445
"73129",2018,0,61,0,61
"73129",2019,0,190,105,295
"73129",2020,0,150,50,200
"73130",2015,0,41,36,77
"73130",2016,0,0,22,22
"73130",2017,0,269,176,445
"73130",2018,0,61,0,61
"73130",2019,0,190,163,353
"73130",2020,0,150,150,300
"73131",2015,0,41,0,41
"73131",2016,0,0,22,22
"73131",2017,0,269,176,445
"73131",2018,0,61,145,206
"73131",2019,0,190,190,380
"73131",2020,0,150,150,300
"73132",2015,0,41,36,77
"73132",2016,0,0,22,22
"73132",2017,0,269,176,445
"73132",2018,0,61,145,206
"73132",2019,0,190,190,380
"73132",2020,0,150,150,300
"73133",2015,0,41,36,77
"73133",2016,0,0,22,22
"73133",2017,0,269,176,445
"73133",2018,0,61,0,61
"73133",2019,0,190,163,353
"73133",2020,0,150,150,300
"73135",2015,0,41,0,41
"73135",2016,0,0,22,22
"73135",2017,0,269,176,445
"73135",2018,0,61,145,206
"73135",2019,0,190,190,380
"73135",2020,0,150,150,300
"73137",2015,0,41,36,77
"73137",2017,0,269,176,445
"73137",2018,0,61,12,73
"73137",2019,0,190,163,353
"73137",2020,0,150,64,214
"73138",2015,0,41,0,41
"73138",2016,0,0,22,22
"73138",2017,0,269,176,445
"73138",2018,0,61,145,206
"73138",2019,0,190,190,380
"73138",2020,0,150,150,300
"73139",2015,0,41,36,77
"73139",2017,0,269,176,445
"73139",2018,0,61,0,61
"73139",2019,0,190,105,295
"73139",2020,0,150,50,200
"73140",2015,0,41,36,77
"73140",2017,0,269,176,445
"73140",2018,0,61,12,73
"73140",2019,0,190,74,264
"73140",2020,0,150,64,214
"73141",2015,0,41,36,77
"73141",2016,0,0,22,22
"73141",2017,0,269,176,445
"73141",2018,0,61,0,61
"73141",2019,0,190,163,353
"73141",2020,0,150,150,300
"73142",2015,0,41,0,41
"73142",2016,0,0,22,22
"73142",2017,0,269,176,445
"73142",2018,0,61,145,206
"73142",2019,0,190,190,380
"73142",2020,0,150,150,300
"73145",2015,0,41,36,77
"73145",2017,0,269,176,445
"73145",2018,0,61,12,73
"73145",2019,0,190,74,264
"73145",2020,0,150,64,214
"73146",2015,0,41,36,77
"73146",2017,0,269,176,445
"73146",2018,0,61,8,69
"73146",2019,0,190,105,295
"73146",2020,0,150,50,200
"73147",2015,0,41,36,77
"73147",2017,0,269,176,445
"73147",2018,0,61,12,73
"73147",2019,0,190,74,264
"73147",2020,0,150,64,214
"73149",2015,0,41,36,77
"73149",2017,0,269,176,445
"73149",2018,0,61,12,73
"73149",2019,0,190,74,264
"73149",2020,0,150,64,214
"73150",2015,0,41,36,77
"73150",2016,0,0,22,22
"73150",2017,0,269,176,445
"73150",2018,0,61,145,206
"73150",2019,0,190,190,380
"73150",2020,0,150,150,300
"73151",2015,0,41,36,77
"73151",2017,0,269,176,445
"73151",2018,0,61,0,61
"73151",2019,0,190,163,353
"73151",2020,0,150,150,300
"73152",2015,0,41,36,77
"73152",2017,0,269,176,445
"73152",2018,0,61,12,73
"73152",2019,0,190,74,264
"73152",2020,0,150,64,214
"73153",2015,0,41,36,77
"73153",2016,0,0,22,22
"73153",2017,0,269,176,445
"73153",2018,0,61,0,61
"73153",2019,0,190,163,353
"73153",2020,0,150,150,300
"73154",2015,0,41,36,77
"73154",2016,0,0,22,22
"73154",2017,0,269,176,445
"73154",2018,0,61,0,61
"73154",2019,0,190,163,353
"73154",2020,0,150,150,300
"73155",2015,0,41,36,77
"73155",2017,0,269,176,445
"73155",2018,0,61,12,73
"73155",2019,0,190,163,353
"73155",2020,0,150,64,214
"73156",2015,0,41,36,77
"73156",2017,0,269,176,445
"73156",2018,0,61,12,73
"73156",2019,0,190,74,264
"73156",2020,0,150,64,214
"73157",2015,0,41,0,41
"73157",2016,0,0,22,22
"73157",2017,0,269,176,445
"73157",2018,0,61,145,206
"73157",2019,0,190,190,380
"73157",2020,0,150,150,300
"73159",2015,0,41,36,77
"73159",2016,0,0,22,22
"73159",2017,0,269,176,445
"73159",2018,0,61,0,61
"73159",2019,0,190,163,353
"73159",2020,0,150,150,300
"73160",2015,0,41,36,77
"73160",2017,0,269,176,445
"73160",2018,0,61,8,69
"73160",2019,0,190,163,353
"73160",2020,0,150,64,214
"73161",2015,0,41,0,41
"73161",2016,0,0,22,22
"73161",2017,0,269,176,445
"73161",2018,0,61,145,206
"73161",2019,0,190,190,380
"73161",2020,0,150,150,300
"73162",2015,0,41,36,77
"73162",2017,0,269,176,445
"73162",2018,0,61,0,61
"73162",2019,0,190,105,295
"73162",2020,0,150,50,200
"73164",2015,0,41,36,77
"73164",2017,0,269,176,445
"73164",2018,0,61,12,73
"73164",2019,0,190,163,353
"73164",2020,0,150,64,214
"73166",2015,0,41,36,77
"73166",2016,0,0,22,22
"73166",2017,0,269,176,445
"73166",2018,0,61,0,61
"73166",2019,0,190,163,353
"73166",2020,0,150,150,300
"73168",2015,0,41,36,77
"73168",2016,0,0,22,22
"73168",2017,0,269,176,445
"73168",2018,0,61,0,61
"73168",2019,0,190,163,353
"73168",2020,0,150,150,300
"73170",2015,0,41,36,77
"73170",2016,0,0,22,22
"73170",2017,0,269,176,445
"73170",2018,0,61,0,61
"73170",2019,0,190,163,353
"73170",2020,0,150,150,300
"73171",2015,0,41,36,77
"73171",2017,0,269,176,445
"73171",2018,0,61,0,61
"73171",2019,0,190,163,353
"73171",2020,0,150,64,214
"73173",2015,0,41,0,41
"73173",2016,0,0,22,22
"73173",2017,0,269,176,445
"73173",2018,0,61,145,206
"73173",2019,0,190,190,380
"73173",2020,0,150,150,300
"73175",2015,0,41,36,77
"73175",2016,0,0,22,22
"73175",2017,0,269,176,445
"73175",2018,0,61,0,61
"73175",2019,0,190,163,353
"73175",2020,0,150,150,300
"73176",2015,0,41,0,41
"73176",2016,0,0,22,22
"73176",2017,0,269,176,445
"73176",2018,0,61,145,206
"73176",2019,0,190,190,380
"73176",2020,0,150,150,300
"73177",2015,0,41,0,41
"73177",2016,0,0,22,22
"73177",2017,0,269,176,445
"73177",2018,0,61,145,206
"73177",2019,0,190,190,380
"73177",2020,0,150,150,300
"73178",2015,0,41,36,77
"73178",2017,0,269,176,445
"73178",2018,0,61,8,69
"73178",2019,0,190,105,295
"73178",2020,0,150,50,200
"73179",2015,0,41,36,77
"73179",2017,0,269,176,445
"73179",2018,0,61,12,73
"73179",2019,0,190,74,264
"73179",2020,0,150,64,214
"73180",2015,0,41,36,77
"73180",2017,0,269,176,445
"73180",2018,0,61,12,73
"73180",2019,0,190,163,353
"73180",2020,0,150,64,214
"73181",2015,0,41,0,41
"73181",2016,0,0,22,22
"73181",2017,0,269,176,445
"73181",2018,0,61,145,206
"73181",2019,0,190,190,380
"73181",2020,0,150,150,300
"73182",2015,0,41,36,77
"73182",2017,0,269,176,445
"73182",2018,0,61,12,73
"73182",2019,0,190,163,353
"73182",2020,0,150,64,214
"73183",2015,0,41,36,77
"73183",2017,0,269,176,445
"73183",2018,0,61,0,61
"73183",2019,0,190,163,353
"73183",2020,0,150,64,214
"73184",2015,0,41,36,77
"73184",2017,0,269,176,445
"73184",2018,0,61,12,73
"73184",2019,0,190,74,264
"73184",2020,0,150,64,214
"73186",2015,0,41,36,77
"73186",2016,0,0,22,22
"73186",2017,0,269,176,445
"73186",2018,0,61,145,206
"73186",2019,0,190,190,380
"73186",2020,0,150,150,300
"73187",2015,0,41,36,77
"73187",2016,0,0,22,22
"73187",2017,0,269,176,445
"73187",2018,0,61,145,206
"73187",2019,0,190,190,380
"73187",2020,0,150,150,300
"73188",2015,0,41,36,77
"73188",2016,0,0,22,22
"73188",2017,0,269,176,445
"73188",2018,0,61,0,61
"73188",2019,0,190,163,353
"73188",2020,0,150,150,300
"73189",2015,0,41,0,41
"73189",2016,0,0,22,22
"73189",2017,0,269,176,445
"73189",2018,0,61,145,206
"73189",2019,0,190,190,380
"73189",2020,0,150,150,300
"73190",2015,0,41,0,41
"73190",2016,0,0,22,22
"73190",2017,0,269,176,445
"73190",2018,0,61,145,206
"73190",2019,0,190,190,380
"73190",2020,0,150,150,300
"73191",2015,0,41,36,77
"73191",2017,0,269,176,445
"73191",2018,0,61,12,73
"73191",2019,0,190,74,264
"73191",2020,0,150,64,214
"73192",2015,0,41,36,77
"73192",2017,0,269,176,445
"73192",2018,0,61,8,69
"73192",2019,0,190,105,295
"73192",2020,0,150,50,200
"73193",2015,0,41,36,77
"73193",2017,0,269,176,445
"73193",2018,0,61,12,73
"73193",2019,0,190,74,264
"73193",2020,0,150,64,214
"73194",2015,0,41,0,41
"73194",2016,0,0,22,22
"73194",2017,0,269,176,445
"73194",2018,0,61,145,206
"73194",2019,0,190,190,380
"73194",2020,0,150,150,300
"73196",2015,0,41,36,77
"73196",2016,0,0,22,22
"73196",2017,0,269,176,445
"73196",2018,0,61,0,61
"73196",2019,0,190,163,353
"73196",2020,0,150,150,300
"73197",2015,0,41,0,41
"73197",2016,0,0,22,22
"73197",2017,0,269,176,445
"73197",2018,0,61,145,206
"73197",2019,0,190,190,380
"73197",2020,0,150,150,300
"73200",2015,0,41,36,77
"73200",2016,0,0,22,22
"73200",2017,0,269,176,445
"73200",2018,0,61,0,61
"73200",2019,0,190,163,353
"73200",2020,0,150,150,300
"73201",2015,0,41,0,41
"73201",2016,0,0,22,22
"73201",2017,0,269,176,445
"73201",2018,0,61,145,206
"73201",2019,0,190,190,380
"73201",2020,0,150,150,300
"73202",2015,0,41,36,77
"73202",2017,0,269,176,445
"73202",2018,0,61,0,61
"73202",2019,0,190,105,295
"73202",2020,0,150,50,200
"73204",2015,0,41,36,77
"73204",2017,0,269,176,445
"73204",2018,0,61,12,73
"73204",2019,0,190,74,264
"73204",2020,0,150,64,214
"73205",2015,0,41,36,77
"73205",2016,0,0,22,22
"73205",2017,0,269,176,445
"73205",2018,0,61,0,61
"73205",2019,0,190,163,353
"73205",2020,0,150,150,300
"73206",2015,0,41,0,41
"73206",2016,0,0,22,22
"73206",2017,0,269,176,445
"73206",2018,0,61,145,206
"73206",2019,0,190,190,380
"73206",2020,0,150,150,300
"73207",2015,0,41,36,77
"73207",2016,0,0,22,22
"73207",2017,0,269,176,445
"73207",2018,0,61,0,61
"73207",2019,0,190,163,353
"73207",2020,0,150,150,300
"73208",2015,0,41,36,77
"73208",2017,0,269,176,445
"73208",2018,0,61,12,73
"73208",2019,0,190,163,353
"73208",2020,0,150,64,214
"73210",2015,0,41,36,77
"73210",2017,0,269,176,445
"73210",2018,0,61,12,73
"73210",2019,0,190,163,353
"73210",2020,0,150,64,214
"73211",2015,0,41,36,77
"73211",2016,0,0,22,22
"73211",2017,0,269,176,445
"73211",2018,0,61,0,61
"73211",2019,0,190,163,353
"73211",2020,0,150,150,300
"73212",2015,0,41,36,77
"73212",2016,0,0,22,22
"73212",2017,0,269,176,445
"73212",2018,0,61,0,61
"73212",2019,0,190,163,353
"73212",2020,0,150,150,300
"73213",2015,0,41,36,77
"73213",2017,0,269,176,445
"73213",2018,0,61,0,61
"73213",2019,0,190,163,353
"73213",2020,0,150,64,214
"73214",2015,0,41,36,77
"73214",2017,0,269,176,445
"73214",2018,0,61,12,73
"73214",2019,0,190,74,264
"73214",2020,0,150,64,214
"73215",2015,0,41,36,77
"73215",2016,0,0,22,22
"73215",2017,0,269,176,445
"73215",2018,0,61,0,61
"73215",2019,0,190,163,353
"73215",2020,0,150,150,300
"73216",2015,0,41,0,41
"73216",2016,0,0,22,22
"73216",2017,0,269,176,445
"73216",2018,0,61,145,206
"73216",2019,0,190,190,380
"73216",2020,0,150,150,300
"73217",2015,0,41,36,77
"73217",2016,0,0,22,22
"73217",2017,0,269,176,445
"73217",2018,0,61,0,61
"73217",2019,0,190,163,353
"73217",2020,0,150,150,300
"73218",2015,0,41,36,77
"73218",2017,0,269,176,445
"73218",2018,0,61,12,73
"73218",2019,0,190,163,353
"73218",2020,0,150,64,214
"73219",2015,0,41,36,77
"73219",2017,0,269,176,445
"73219",2018,0,61,12,73
"73219",2019,0,190,74,264
"73219",2020,0,150,64,214
"73220",2015,0,41,36,77
"73220",2016,0,0,22,22
"73220",2017,0,269,176,445
"73220",2018,0,61,0,61
"73220",2019,0,190,163,353
"73220",2020,0,150,150,300
"73221",2015,0,41,0,41
"73221",2016,0,0,22,22
"73221",2017,0,269,176,445
"73221",2018,0,61,145,206
"73221",2019,0,190,190,380
"73221",2020,0,150,150,300
"73222",2015,0,41,36,77
"73222",2017,0,269,176,445
"73222",2018,0,61,12,73
"73222",2019,0,190,163,353
"73222",2020,0,150,64,214
"73223",2015,0,41,0,41
"73223",2016,0,0,22,22
"73223",2017,0,269,176,445
"73223",2018,0,61,145,206
"73223",2019,0,190,190,380
"73223",2020,0,150,150,300
"73224",2015,0,41,0,41
"73224",2016,0,0,22,22
"73224",2017,0,269,176,445
"73224",2018,0,61,145,206
"73224",2019,0,190,190,380
"73224",2020,0,150,150,300
"73225",2015,0,41,36,77
"73225",2017,0,269,176,445
"73225",2018,0,61,0,61
"73225",2019,0,190,163,353
"73225",2020,0,150,64,214
"73226",2015,0,41,36,77
"73226",2017,0,269,176,445
"73226",2018,0,61,12,73
"73226",2019,0,190,74,264
"73226",2020,0,150,64,214
"73227",2015,0,41,0,41
"73227",2016,0,0,22,22
"73227",2017,0,269,176,445
"73227",2018,0,61,145,206
"73227",2019,0,190,190,380
"73227",2020,0,150,150,300
"73228",2015,0,41,36,77
"73228",2017,0,269,176,445
"73228",2018,0,61,8,69
"73228",2019,0,190,74,264
"73228",2020,0,150,64,214
"73229",2015,0,41,36,77
"73229",2017,0,269,176,445
"73229",2018,0,61,12,73
"73229",2019,0,190,74,264
"73229",2020,0,150,64,214
"73230",2015,0,41,0,41
"73230",2016,0,0,22,22
"73230",2017,0,269,176,445
"73230",2018,0,61,145,206
"73230",2019,0,190,190,380
"73230",2020,0,150,150,300
"73231",2015,0,41,0,41
"73231",2016,0,0,22,22
"73231",2017,0,269,176,445
"73231",2018,0,61,0,61
"73231",2019,0,190,163,353
"73231",2020,0,150,150,300
"73232",2015,0,41,0,41
"73232",2016,0,0,22,22
"73232",2017,0,269,176,445
"73232",2018,0,61,145,206
"73232",2019,0,190,190,380
"73232",2020,0,150,150,300
"73233",2015,0,41,36,77
"73233",2017,0,269,176,445
"73233",2018,0,61,12,73
"73233",2019,0,190,74,264
"73233",2020,0,150,64,214
"73234",2015,0,41,36,77
"73234",2017,0,269,176,445
"73234",2018,0,61,8,69
"73234",2019,0,190,105,295
"73234",2020,0,150,50,200
"73235",2015,0,41,0,41
"73235",2016,0,0,22,22
"73235",2017,0,269,176,445
"73235",2018,0,61,145,206
"73235",2019,0,190,190,380
"73235",2020,0,150,150,300
"73236",2015,0,41,36,77
"73236",2017,0,269,176,445
"73236",2018,0,61,12,73
"73236",2019,0,190,74,264
"73236",2020,0,150,64,214
"73237",2015,0,41,36,77
"73237",2016,0,0,22,22
"73237",2017,0,269,176,445
"73237",2018,0,61,0,61
"73237",2019,0,190,163,353
"73237",2020,0,150,150,300
"73240",2015,0,41,36,77
"73240",2016,0,0,22,22
"73240",2017,0,269,176,445
"73240",2018,0,61,0,61
"73240",2019,0,190,163,353
"73240",2020,0,150,150,300
"73241",2015,0,41,36,77
"73241",2016,0,0,22,22
"73241",2017,0,269,176,445
"73241",2018,0,61,0,61
"73241",2019,0,190,163,353
"73241",2020,0,150,150,300
"73242",2015,0,41,0,41
"73242",2016,0,0,22,22
"73242",2017,0,269,176,445
"73242",2018,0,61,145,206
"73242",2019,0,190,190,380
"73242",2020,0,150,150,300
"73243",2015,0,41,36,77
"73243",2017,0,269,176,445
"73243",2018,0,61,12,73
"73243",2019,0,190,163,353
"73243",2020,0,150,64,214
"73245",2015,0,41,36,77
"73245",2017,0,269,176,445
"73245",2018,0,61,12,73
"73245",2019,0,190,74,264
"73245",2020,0,150,64,214
"73246",2015,0,41,36,77
"73246",2017,0,269,176,445
"73246",2018,0,61,12,73
"73246",2019,0,190,74,264
"73246",2020,0,150,64,214
"73247",2015,0,41,36,77
"73247",2017,0,269,176,445
"73247",2018,0,61,0,61
"73247",2019,0,190,105,295
"73247",2020,0,150,50,200
"73248",2015,0,41,0,41
"73248",2016,0,0,22,22
"73248",2017,0,269,176,445
"73248",2018,0,61,145,206
"73248",2019,0,190,190,380
"73248",2020,0,150,150,300
"73249",2015,0,41,36,77
"73249",2017,0,269,176,445
"73249",2018,0,61,0,61
"73249",2019,0,190,163,353
"73249",2020,0,150,64,214
"73250",2015,0,41,0,41
"73250",2016,0,0,22,22
"73250",2017,0,269,176,445
"73250",2018,0,61,145,206
"73250",2019,0,190,190,380
"73250",2020,0,150,150,300
"73252",2015,0,41,0,41
"73252",2016,0,0,22,22
"73252",2017,0,269,176,445
"73252",2018,0,61,145,206
"73252",2019,0,190,190,380
"73252",2020,0,150,150,300
"73253",2015,0,41,0,41
"73253",2016,0,0,22,22
"73253",2017,0,269,176,445
"73253",2018,0,61,145,206
"73253",2019,0,190,190,380
"73253",2020,0,150,150,300
"73254",2015,0,41,36,77
"73254",2017,0,269,176,445
"73254",2018,0,61,12,73
"73254",2019,0,190,74,264
"73254",2020,0,150,64,214
"73255",2015,0,41,0,41
"73255",2016,0,0,22,22
"73255",2017,0,269,176,445
"73255",2018,0,61,145,206
"73255",2019,0,190,190,380
"73255",2020,0,150,150,300
"73256",2015,0,41,0,41
"73256",2016,0,0,22,22
"73256",2017,0,269,176,445
"73256",2018,0,61,145,206
"73256",2019,0,190,190,380
"73256",2020,0,150,150,300
"73257",2015,0,41,0,41
"73257",2016,0,0,22,22
"73257",2017,0,269,176,445
"73257",2018,0,61,145,206
"73257",2019,0,190,190,380
"73257",2020,0,150,150,300
"73258",2015,0,41,0,41
"73258",2016,0,0,22,22
"73258",2017,0,269,176,445
"73258",2018,0,61,145,206
"73258",2019,0,190,190,380
"73258",2020,0,150,150,300
"73259",2015,0,41,0,41
"73259",2016,0,0,22,22
"73259",2017,0,269,176,445
"73259",2018,0,61,145,206
"73259",2019,0,190,190,380
"73259",2020,0,150,150,300
"73261",2015,0,41,0,41
"73261",2016,0,0,22,22
"73261",2017,0,269,176,445
"73261",2018,0,61,145,206
"73261",2019,0,190,190,380
"73261",2020,0,150,150,300
"73262",2015,0,41,36,77
"73262",2016,0,0,22,22
"73262",2017,0,269,176,445
"73262",2018,0,61,145,206
"73262",2019,0,190,190,380
"73262",2020,0,150,150,300
"73263",2015,0,41,36,77
"73263",2017,0,269,176,445
"73263",2018,0,61,8,69
"73263",2019,0,190,105,295
"73263",2020,0,150,50,200
"73265",2015,0,41,36,77
"73265",2017,0,269,176,445
"73265",2018,0,61,12,73
"73265",2019,0,190,163,353
"73265",2020,0,150,64,214
"73267",2015,0,41,0,41
"73267",2016,0,0,22,22
"73267",2017,0,269,176,445
"73267",2018,0,61,145,206
"73267",2019,0,190,190,380
"73267",2020,0,150,150,300
"73268",2015,0,41,36,77
"73268",2016,0,0,22,22
"73268",2017,0,269,176,445
"73268",2018,0,61,0,61
"73268",2019,0,190,163,353
"73268",2020,0,150,150,300
"73269",2015,0,41,36,77
"73269",2017,0,269,176,445
"73269",2018,0,61,12,73
"73269",2019,0,190,74,264
"73269",2020,0,150,64,214
"73270",2015,0,41,36,77
"73270",2017,0,269,176,445
"73270",2018,0,61,0,61
"73270",2019,0,190,105,295
"73270",2020,0,150,50,200
"73271",2015,0,41,36,77
"73271",2017,0,269,176,445
"73271",2018,0,61,12,73
"73271",2019,0,190,74,264
"73271",2020,0,150,64,214
"73272",2015,0,41,36,77
"73272",2016,0,0,22,22
"73272",2017,0,269,176,445
"73272",2018,0,61,0,61
"73272",2019,0,190,163,353
"73272",2020,0,150,150,300
"73273",2015,0,41,36,77
"73273",2017,0,269,176,445
"73273",2018,0,61,12,73
"73273",2019,0,190,74,264
"73273",2020,0,150,64,214
"73274",2015,0,41,36,77
"73274",2017,0,269,176,445
"73274",2018,0,61,12,73
"73274",2019,0,190,74,264
"73274",2020,0,150,64,214
"73275",2015,0,41,36,77
"73275",2017,0,269,176,445
"73275",2018,0,61,12,73
"73275",2019,0,190,74,264
"73275",2020,0,150,64,214
"73276",2015,0,41,36,77
"73276",2016,0,0,22,22
"73276",2017,0,269,176,445
"73276",2018,0,61,0,61
"73276",2019,0,190,163,353
"73276",2020,0,150,150,300
"73277",2015,0,41,36,77
"73277",2017,0,269,176,445
"73277",2018,0,61,0,61
"73277",2019,0,190,105,295
"73277",2020,0,150,50,200
"73278",2015,0,41,36,77
"73278",2016,0,0,22,22
"73278",2017,0,269,176,445
"73278",2018,0,61,0,61
"73278",2019,0,190,163,353
"73278",2020,0,150,150,300
"73280",2015,0,41,0,41
"73280",2016,0,0,22,22
"73280",2017,0,269,176,445
"73280",2018,0,61,145,206
"73280",2019,0,190,190,380
"73280",2020,0,150,150,300
"73281",2015,0,41,36,77
"73281",2017,0,269,176,445
"73281",2018,0,61,12,73
"73281",2019,0,190,74,264
"73281",2020,0,150,64,214
"73282",2015,0,41,36,77
"73282",2017,0,269,176,445
"73282",2018,0,61,12,73
"73282",2019,0,190,74,264
"73282",2020,0,150,64,214
"73283",2015,0,41,36,77
"73283",2016,0,0,22,22
"73283",2017,0,269,176,445
"73283",2018,0,61,0,61
"73283",2019,0,190,163,353
"73283",2020,0,150,150,300
"73284",2015,0,41,0,41
"73284",2016,0,0,22,22
"73284",2017,0,269,176,445
"73284",2018,0,61,145,206
"73284",2019,0,190,190,380
"73284",2020,0,150,150,300
"73285",2015,0,41,0,41
"73285",2016,0,0,22,22
"73285",2017,0,269,176,445
"73285",2018,0,61,145,206
"73285",2019,0,190,190,380
"73285",2020,0,150,150,300
"73286",2015,0,41,36,77
"73286",2017,0,269,176,445
"73286",2018,0,61,12,73
"73286",2019,0,190,163,353
"73286",2020,0,150,64,214
"73288",2015,0,41,36,77
"73288",2017,0,269,176,445
"73288",2018,0,61,12,73
"73288",2019,0,190,163,353
"73288",2020,0,150,64,214
"73289",2015,0,41,36,77
"73289",2016,0,0,22,22
"73289",2017,0,269,176,445
"73289",2018,0,61,0,61
"73289",2019,0,190,163,353
"73289",2020,0,150,150,300
"73290",2015,0,41,0,41
"73290",2016,0,0,22,22
"73290",2017,0,269,176,445
"73290",2018,0,61,145,206
"73290",2019,0,190,190,380
"73290",2020,0,150,150,300
"73292",2015,0,41,36,77
"73292",2016,0,0,22,22
"73292",2017,0,269,176,445
"73292",2018,0,61,0,61
"73292",2019,0,190,163,353
"73292",2020,0,150,150,300
"73293",2015,0,41,36,77
"73293",2017,0,269,176,445
"73293",2018,0,61,8,69
"73293",2019,0,190,105,295
"73293",2020,0,150,50,200
"73294",2015,0,41,36,77
"73294",2017,0,269,176,445
"73294",2018,0,61,0,61
"73294",2019,0,190,105,295
"73294",2020,0,150,50,200
"73296",2015,0,41,0,41
"73296",2016,0,0,22,22
"73296",2017,0,269,176,445
"73296",2018,0,61,145,206
"73296",2019,0,190,190,380
"73296",2020,0,150,150,300
"73297",2015,0,41,36,77
"73297",2016,0,0,22,22
"73297",2017,0,269,176,445
"73297",2018,0,61,0,61
"73297",2019,0,190,163,353
"73297",2020,0,150,150,300
"73298",2015,0,41,36,77
"73298",2016,0,0,22,22
"73298",2017,0,269,176,445
"73298",2018,0,61,8,69
"73298",2019,0,190,163,353
"73298",2020,0,150,150,300
"73299",2015,0,41,36,77
"73299",2017,0,269,176,445
"73299",2018,0,61,12,73
"73299",2019,0,190,74,264
"73299",2020,0,150,64,214
"73300",2015,0,41,36,77
"73300",2017,0,269,176,445
"73300",2018,0,61,12,73
"73300",2019,0,190,163,353
"73300",2020,0,150,64,214
"73301",2015,0,41,36,77
"73301",2017,0,269,176,445
"73301",2018,0,61,12,73
"73301",2019,0,190,163,353
"73301",2020,0,150,64,214
"73302",2015,0,41,36,77
"73302",2016,0,0,22,22
"73302",2017,0,269,176,445
"73302",2018,0,61,0,61
"73302",2019,0,190,163,353
"73302",2020,0,150,150,300
"73303",2015,0,41,36,77
"73303",2016,0,0,22,22
"73303",2017,0,269,176,445
"73303",2018,0,61,0,61
"73303",2019,0,190,163,353
"73303",2020,0,150,150,300
"73304",2015,0,41,0,41
"73304",2016,0,0,22,22
"73304",2017,0,269,176,445
"73304",2018,0,61,145,206
"73304",2019,0,190,190,380
"73304",2020,0,150,150,300
"73306",2015,0,41,0,41
"73306",2016,0,0,22,22
"73306",2017,0,269,176,445
"73306",2018,0,61,145,206
"73306",2019,0,190,190,380
"73306",2020,0,150,150,300
"73307",2015,0,41,0,41
"73307",2016,0,0,22,22
"73307",2017,0,269,176,445
"73307",2018,0,61,145,206
"73307",2019,0,190,190,380
"73307",2020,0,150,150,300
"73308",2015,0,41,36,77
"73308",2016,0,0,22,22
"73308",2017,0,269,176,445
"73308",2018,0,61,8,69
"73308",2019,0,190,163,353
"73308",2020,0,150,150,300
"73309",2015,0,41,36,77
"73309",2017,0,269,176,445
"73309",2018,0,61,12,73
"73309",2019,0,190,74,264
"73309",2020,0,150,64,214
"73310",2015,0,41,36,77
"73310",2017,0,269,176,445
"73310",2018,0,61,12,73
"73310",2019,0,190,163,353
"73310",2020,0,150,64,214
"73311",2015,0,41,36,77
"73311",2016,0,0,22,22
"73311",2017,0,269,176,445
"73311",2018,0,61,0,61
"73311",2019,0,190,163,353
"73311",2020,0,150,150,300
"73312",2015,0,41,36,77
"73312",2017,0,269,176,445
"73312",2018,0,61,0,61
"73312",2019,0,190,105,295
"73312",2020,0,150,50,200
"73313",2015,0,41,36,77
"73313",2017,0,269,176,445
"73313",2018,0,61,12,73
"73313",2019,0,190,74,264
"73313",2020,0,150,64,214
"73314",2015,0,41,36,77
"73314",2016,0,0,22,22
"73314",2017,0,269,176,445
"73314",2018,0,61,0,61
"73314",2019,0,190,163,353
"73314",2020,0,150,150,300
"73315",2015,0,41,36,77
"73315",2016,0,0,22,22
"73315",2017,0,269,176,445
"73315",2018,0,61,0,61
"73315",2019,0,190,163,353
"73315",2020,0,150,150,300
"73316",2015,0,41,36,77
"73316",2016,0,0,22,22
"73316",2017,0,269,176,445
"73316",2018,0,61,0,61
"73316",2019,0,190,163,353
"73316",2020,0,150,150,300
"73317",2015,0,41,36,77
"73317",2016,0,0,22,22
"73317",2017,0,269,176,445
"73317",2018,0,61,145,206
"73317",2019,0,190,190,380
"73317",2020,0,150,150,300
"73318",2015,0,41,0,41
"73318",2016,0,0,22,22
"73318",2017,0,269,176,445
"73318",2018,0,61,145,206
"73318",2019,0,190,190,380
"73318",2020,0,150,150,300
"73320",2015,0,41,0,41
"73320",2016,0,0,22,22
"73320",2017,0,269,176,445
"73320",2018,0,61,145,206
"73320",2019,0,190,190,380
"73320",2020,0,150,150,300
"73322",2015,0,41,0,41
"73322",2016,0,0,22,22
"73322",2017,0,269,176,445
"73322",2018,0,61,145,206
"73322",2019,0,190,190,380
"73322",2020,0,150,150,300
"73323",2015,0,41,0,41
"73323",2016,0,0,22,22
"73323",2017,0,269,176,445
"73323",2018,0,61,145,206
"73323",2019,0,190,190,380
"73323",2020,0,150,150,300
"73324",2015,0,41,36,77
"73324",2016,0,0,22,22
"73324",2017,0,269,176,445
"73324",2018,0,61,0,61
"73324",2019,0,190,163,353
"73324",2020,0,150,150,300
"73326",2015,0,41,36,77
"73326",2017,0,269,176,445
"73326",2018,0,61,12,73
"73326",2019,0,190,74,264
"73326",2020,0,150,64,214
"73327",2015,0,41,36,77
"73327",2017,0,269,176,445
"73327",2018,0,61,12,73
"73327",2019,0,190,163,353
"73327",2020,0,150,64,214
"73328",2015,0,41,36,77
"73328",2017,0,269,176,445
"73328",2018,0,61,12,73
"73328",2019,0,190,163,353
"73328",2020,0,150,64,214
"73329",2015,0,41,36,77
"73329",2017,0,269,176,445
"73329",2018,0,61,12,73
"73329",2019,0,190,163,353
"73329",2020,0,150,64,214
"73330",2015,0,41,36,77
"73330",2017,0,269,176,445
"73330",2018,0,61,12,73
"73330",2019,0,190,74,264
"73330",2020,0,150,64,214
"74001",2017,0,115,115,230
"74001",2018,0,0,16,16
"74001",2019,0,0,92,92
"74002",2017,0,115,115,230
"74003",2017,0,115,115,230
"74003",2019,0,0,92,92
"74004",2017,0,115,115,230
"74005",2015,0,0,28,28
"74005",2017,0,115,115,230
"74005",2018,0,0,68,68
"74005",2019,0,0,92,92
"74005",2020,0,0,131,131
"74006",2017,0,115,115,230
"74007",2015,0,0,28,28
"74007",2017,0,115,115,230
"74007",2018,0,0,16,16
"74007",2019,0,0,92,92
"74008",2015,0,0,28,28
"74008",2017,0,115,115,230
"74008",2018,0,0,9,9
"74008",2019,0,0,92,92
"74009",2017,0,115,115,230
"74009",2018,0,0,16,16
"74010",2017,0,115,115,230
"74012",2015,0,0,28,28
"74012",2017,0,115,115,230
"74012",2018,0,0,9,9
"74012",2019,0,0,92,92
"74013",2015,0,0,28,28
"74013",2017,0,115,115,230
"74013",2018,0,0,68,68
"74013",2019,0,0,92,92
"74013",2020,0,0,131,131
"74014",2017,0,115,115,230
"74014",2018,0,0,16,16
"74014",2019,0,0,92,92
"74015",2017,0,115,115,230
"74016",2017,0,115,115,230
"74016",2018,0,0,16,16
"74018",2015,0,0,28,28
"74018",2017,0,115,115,230
"74018",2018,0,0,16,16
"74018",2019,0,0,92,92
"74019",2017,0,115,115,230
"74019",2019,0,0,92,92
"74020",2017,0,115,115,230
"74020",2018,0,0,41,41
"74020",2019,0,0,92,92
"74020",2020,0,0,82,82
"74021",2015,0,0,28,28
"74021",2017,0,115,115,230
"74021",2018,0,0,8,8
"74021",2019,0,0,92,92
"74024",2015,0,0,28,28
"74024",2017,0,115,115,230
"74024",2018,0,0,15,15
"74024",2019,0,0,92,92
"74025",2015,0,0,28,28
"74025",2017,0,115,115,230
"74025",2018,0,0,68,68
"74025",2019,0,0,92,92
"74025",2020,0,0,131,131
"74026",2017,0,115,115,230
"74027",2017,0,115,115,230
"74027",2019,0,0,92,92
"74029",2017,0,115,115,230
"74029",2018,0,0,16,16
"74030",2017,0,115,115,230
"74030",2018,0,0,16,16
"74030",2019,0,0,92,92
"74031",2017,0,115,115,230
"74031",2018,0,0,16,16
"74032",2017,0,115,115,230
"74032",2018,0,0,15,15
"74032",2019,0,0,92,92
"74032",2020,0,0,82,82
"74033",2017,0,115,115,230
"74033",2018,0,0,16,16
"74033",2019,0,0,92,92
"74034",2017,0,115,115,230
"74034",2018,0,0,16,16
"74034",2019,0,0,92,92
"74035",2017,0,115,115,230
"74036",2017,0,115,115,230
"74036",2019,0,0,92,92
"74037",2015,0,0,28,28
"74037",2017,0,115,115,230
"74037",2018,0,0,15,15
"74037",2019,0,0,92,92
"74037",2020,0,0,82,82
"74038",2015,0,0,28,28
"74038",2017,0,115,115,230
"74038",2018,0,0,15,15
"74038",2019,0,0,92,92
"74040",2015,0,0,28,28
"74040",2017,0,115,115,230
"74040",2018,0,0,8,8
"74040",2019,0,0,92,92
"74041",2017,0,115,115,230
"74041",2018,0,0,16,16
"74041",2019,0,0,92,92
"74042",2015,0,0,28,28
"74042",2017,0,115,115,230
"74042",2018,0,0,15,15
"74042",2019,0,0,92,92
"74043",2015,0,0,28,28
"74043",2017,0,115,115,230
"74043",2018,0,0,15,15
"74043",2019,0,0,92,92
"74043",2020,0,0,82,82
"74044",2015,0,0,28,28
"74044",2017,0,115,115,230
"74044",2018,0,0,9,9
"74044",2019,0,0,92,92
"74045",2017,0,115,115,230
"74045",2019,0,0,92,92
"74046",2017,0,115,115,230
"74048",2015,0,0,28,28
"74048",2017,0,115,115,230
"74048",2018,0,0,15,15
"74048",2019,0,0,92,92
"74048",2020,0,0,82,82
"74049",2017,0,115,115,230
"74049",2018,0,0,16,16
"74049",2019,0,0,92,92
"74050",2015,0,0,28,28
"74050",2017,0,115,115,230
"74050",2018,0,0,15,15
"74050",2019,0,0,92,92
"74050",2020,0,0,82,82
"74051",2017,0,115,115,230
"74051",2018,0,0,16,16
"74052",2017,0,115,115,230
"74052",2018,0,0,16,16
"74053",2015,0,0,28,28
"74053",2017,0,115,115,230
"74053",2018,0,0,15,15
"74053",2019,0,0,92,92
"74053",2020,0,0,82,82
"74054",2017,0,115,115,230
"74055",2017,0,115,115,230
"74055",2018,0,0,16,16
"74056",2017,0,115,115,230
"74056",2018,0,0,16,16
"74056",2019,0,0,92,92
"74057",2017,0,115,115,230
"74057",2018,0,0,16,16
"74057",2019,0,0,92,92
"74058",2017,0,115,115,230
"74058",2018,0,0,16,16
"74058",2019,0,0,92,92
"74059",2015,0,0,28,28
"74059",2017,0,115,115,230
"74059",2019,0,0,92,92
"74060",2017,0,115,115,230
"74060",2019,0,0,7,7
"74061",2017,0,115,115,230
"74061",2019,0,0,7,7
"74062",2017,0,115,115,230
"74063",2017,0,115,115,230
"74063",2018,0,0,16,16
"74063",2019,0,0,92,92
"74064",2017,0,115,115,230
"74064",2018,0,0,16,16
"74064",2019,0,0,92,92
"74065",2017,0,115,115,230
"74065",2018,0,0,16,16
"74066",2017,0,115,115,230
"74066",2018,0,0,16,16
"74067",2017,0,115,115,230
"74067",2019,0,0,7,7
"74068",2017,0,115,115,230
"74068",2018,0,0,16,16
"74069",2017,0,115,115,230
"74069",2018,0,0,16,16
"74070",2015,0,0,28,28
"74070",2017,0,115,115,230
"74070",2018,0,0,68,68
"74070",2019,0,0,92,92
"74070",2020,0,0,131,131
"74071",2017,0,115,115,230
"74071",2018,0,0,16,16
"74072",2017,0,115,115,230
"74072",2019,0,0,92,92
"74073",2017,0,115,115,230
"74073",2018,0,0,16,16
"74073",2019,0,0,92,92
"74074",2017,0,115,115,230
"74074",2018,0,0,16,16
"74075",2017,0,115,115,230
"74076",2017,0,115,115,230
"74077",2017,0,115,115,230
"74077",2018,0,0,16,16
"74078",2017,0,115,115,230
"74079",2017,0,115,115,230
"74079",2019,0,0,92,92
"74080",2017,0,115,115,230
"74080",2019,0,0,92,92
"74081",2017,0,115,115,230
"74081",2018,0,0,16,16
"74081",2019,0,0,92,92
"74082",2015,0,0,28,28
"74082",2017,0,115,115,230
"74082",2018,0,0,9,9
"74082",2019,0,0,92,92
"74083",2017,0,115,115,230
"74083",2018,0,0,16,16
"74083",2019,0,0,92,92
"74085",2017,0,115,115,230
"74085",2018,0,0,16,16
"74085",2019,0,0,92,92
"74086",2017,0,115,115,230
"74086",2018,0,0,16,16
"74087",2015,0,0,28,28
"74087",2017,0,115,115,230
"74087",2018,0,0,15,15
"74087",2019,0,0,92,92
"74088",2017,0,115,115,230
"74088",2018,0,0,16,16
"74089",2017,0,115,115,230
"74089",2019,0,0,92,92
"74090",2015,0,0,28,28
"74090",2017,0,115,115,230
"74090",2018,0,0,9,9
"74090",2019,0,0,92,92
"74091",2017,0,115,115,230
"74091",2018,0,0,16,16
"74091",2019,0,0,92,92
"74094",2015,0,0,28,28
"74094",2017,0,115,115,230
"74094",2018,0,0,8,8
"74094",2019,0,0,92,92
"74095",2017,0,115,115,230
"74096",2017,0,115,115,230
"74097",2017,0,115,115,230
"74098",2017,0,115,115,230
"74099",2017,0,115,115,230
"74099",2018,0,0,16,16
"74099",2019,0,0,92,92
"74100",2017,0,115,115,230
"74101",2017,0,115,115,230
"74101",2018,0,0,16,16
"74102",2017,0,115,115,230
"74102",2019,0,0,92,92
"74103",2017,0,115,115,230
"74103",2018,0,0,16,16
"74103",2019,0,0,92,92
"74104",2017,0,115,115,230
"74104",2019,0,0,92,92
"74105",2015,0,0,28,28
"74105",2017,0,115,115,230
"74105",2018,0,0,68,68
"74105",2019,0,0,92,92
"74105",2020,0,0,131,131
"74106",2015,0,0,28,28
"74106",2017,0,115,115,230
"74106",2018,0,0,15,15
"74106",2019,0,0,92,92
"74106",2020,0,0,82,82
"74107",2017,0,115,115,230
"74108",2017,0,115,115,230
"74108",2019,0,0,92,92
"74109",2017,0,115,115,230
"74109",2018,0,0,16,16
"74111",2017,0,115,115,230
"74111",2019,0,0,92,92
"74112",2017,0,115,115,230
"74114",2017,0,115,115,230
"74114",2018,0,0,16,16
"74114",2019,0,0,92,92
"74116",2015,0,0,28,28
"74116",2017,0,115,115,230
"74116",2019,0,0,92,92
"74117",2017,0,115,115,230
"74117",2019,0,0,7,7
"74118",2015,0,0,28,28
"74118",2017,0,115,115,230
"74118",2018,0,0,9,9
"74118",2019,0,0,92,92
"74119",2017,0,115,115,230
"74119",2018,0,0,16,16
"74119",2019,0,0,92,92
"74121",2015,0,0,28,28
"74121",2017,0,115,115,230
"74121",2018,0,0,68,68
"74121",2019,0,0,92,92
"74121",2020,0,0,131,131
"74122",2015,0,0,28,28
"74122",2017,0,115,115,230
"74122",2018,0,0,15,15
"74122",2019,0,0,92,92
"74123",2017,0,115,115,230
"74123",2019,0,0,92,92
"74124",2015,0,0,28,28
"74124",2017,0,115,115,230
"74124",2018,0,0,9,9
"74124",2019,0,0,92,92
"74126",2015,0,0,28,28
"74126",2017,0,115,115,230
"74126",2018,0,0,15,15
"74126",2019,0,0,92,92
"74126",2020,0,0,82,82
"74127",2017,0,115,115,230
"74127",2018,0,0,41,41
"74127",2019,0,0,92,92
"74127",2020,0,0,82,82
"74128",2015,0,0,28,28
"74128",2017,0,115,115,230
"74128",2018,0,0,8,8
"74128",2019,0,0,92,92
"74129",2017,0,115,115,230
"74129",2018,0,0,16,16
"74129",2019,0,0,92,92
"74130",2017,0,115,115,230
"74130",2018,0,0,16,16
"74131",2017,0,115,115,230
"74131",2018,0,0,16,16
"74133",2015,0,0,28,28
"74133",2017,0,115,115,230
"74133",2018,0,0,9,9
"74133",2019,0,0,92,92
"74134",2017,0,115,115,230
"74134",2018,0,0,16,16
"74134",2019,0,0,92,92
"74135",2017,0,115,115,230
"74135",2019,0,0,92,92
"74136",2017,0,115,115,230
"74136",2019,0,0,92,92
"74137",2017,0,115,115,230
"74138",2017,0,115,115,230
"74139",2017,0,115,115,230
"74139",2018,0,0,15,15
"74139",2019,0,0,92,92
"74139",2020,0,0,82,82
"74140",2017,0,115,115,230
"74140",2018,0,0,15,15
"74140",2019,0,0,92,92
"74140",2020,0,0,82,82
"74141",2017,0,115,115,230
"74141",2019,0,0,7,7
"74142",2017,0,115,115,230
"74143",2017,0,115,115,230
"74143",2018,0,0,16,16
"74143",2019,0,0,92,92
"74144",2017,0,115,115,230
"74144",2018,0,0,16,16
"74145",2015,0,0,28,28
"74145",2017,0,115,115,230
"74145",2018,0,0,9,9
"74145",2019,0,0,92,92
"74146",2017,0,115,115,230
"74146",2018,0,0,16,16
"74146",2019,0,0,92,92
"74147",2017,0,115,115,230
"74147",2019,0,0,92,92
"74148",2017,0,115,115,230
"74148",2019,0,0,7,7
"74150",2015,0,0,28,28
"74150",2017,0,115,115,230
"74150",2018,0,0,68,68
"74150",2019,0,0,92,92
"74150",2020,0,0,82,82
"74151",2017,0,115,115,230
"74151",2019,0,0,92,92
"74152",2017,0,115,115,230
"74152",2019,0,0,92,92
"74153",2015,0,0,28,28
"74153",2017,0,115,115,230
"74153",2018,0,0,8,8
"74153",2019,0,0,92,92
"74154",2017,0,115,115,230
"74154",2018,0,0,16,16
"74154",2019,0,0,92,92
"74155",2017,0,115,115,230
"74155",2018,0,0,15,15
"74155",2019,0,0,92,92
"74155",2020,0,0,82,82
"74156",2015,0,0,28,28
"74156",2017,0,115,115,230
"74156",2018,0,0,68,68
"74156",2019,0,0,92,92
"74156",2020,0,0,131,131
"74157",2017,0,115,115,230
"74157",2018,0,0,41,41
"74157",2019,0,0,92,92
"74157",2020,0,0,82,82
"74158",2015,0,0,28,28
"74158",2017,0,115,115,230
"74158",2018,0,0,68,68
"74158",2019,0,0,92,92
"74158",2020,0,0,82,82
"74159",2017,0,115,115,230
"74159",2018,0,0,16,16
"74159",2019,0,0,92,92
"74160",2017,0,115,115,230
"74160",2019,0,0,92,92
"74161",2017,0,115,115,230
"74161",2019,0,0,7,7
"74162",2015,0,0,28,28
"74162",2017,0,115,115,230
"74162",2018,0,0,8,8
"74162",2019,0,0,92,92
"74163",2015,0,0,28,28
"74163",2017,0,115,115,230
"74163",2018,0,0,68,68
"74163",2019,0,0,92,92
"74163",2020,0,0,131,131
"74164",2017,0,115,115,230
"74164",2018,0,0,16,16
"74164",2019,0,0,92,92
"74165",2017,0,115,115,230
"74166",2017,0,115,115,230
"74166",2018,0,0,41,41
"74166",2019,0,0,92,92
"74166",2020,0,0,82,82
"74167",2017,0,115,115,230
"74167",2019,0,0,92,92
"74168",2017,0,115,115,230
"74168",2018,0,0,16,16
"74169",2017,0,115,115,230
"74169",2018,0,0,16,16
"74169",2019,0,0,92,92
"74170",2017,0,115,115,230
"74170",2019,0,0,7,7
"74171",2015,0,0,28,28
"74171",2017,0,115,115,230
"74171",2018,0,0,68,68
"74171",2019,0,0,92,92
"74171",2020,0,0,131,131
"74172",2017,0,115,115,230
"74172",2018,0,0,16,16
"74172",2019,0,0,92,92
"74173",2017,0,115,115,230
"74173",2018,0,0,16,16
"74173",2019,0,0,92,92
"74174",2017,0,115,115,230
"74174",2018,0,0,15,15
"74174",2019,0,0,92,92
"74175",2017,0,115,115,230
"74175",2018,0,0,16,16
"74175",2019,0,0,92,92
"74176",2017,0,115,115,230
"74176",2019,0,0,92,92
"74177",2017,0,115,115,230
"74178",2017,0,115,115,230
"74179",2017,0,115,115,230
"74179",2018,0,0,16,16
"74180",2015,0,0,28,28
"74180",2017,0,115,115,230
"74180",2018,0,0,68,68
"74180",2019,0,0,92,92
"74180",2020,0,0,131,131
"74183",2017,0,115,115,230
"74183",2018,0,0,16,16
"74183",2019,0,0,92,92
"74184",2017,0,115,115,230
"74184",2018,0,0,16,16
"74185",2015,0,0,28,28
"74185",2017,0,115,115,230
"74185",2018,0,0,9,9
"74185",2019,0,0,92,92
"74186",2017,0,115,115,230
"74186",2019,0,0,7,7
"74188",2017,0,115,115,230
"74188",2018,0,0,16,16
"74188",2019,0,0,92,92
"74189",2017,0,115,115,230
"74189",2018,0,0,16,16
"74189",2019,0,0,92,92
"74190",2017,0,115,115,230
"74190",2018,0,0,16,16
"74190",2019,0,0,92,92
"74191",2017,0,115,115,230
"74191",2018,0,0,16,16
"74191",2019,0,0,92,92
"74192",2017,0,115,115,230
"74192",2019,0,0,7,7
"74193",2017,0,115,115,230
"74193",2018,0,0,16,16
"74194",2017,0,115,115,230
"74195",2017,0,115,115,230
"74195",2018,0,0,16,16
"74196",2017,0,115,115,230
"74196",2018,0,0,16,16
"74196",2019,0,0,92,92
"74197",2015,0,0,28,28
"74197",2017,0,115,115,230
"74197",2018,0,0,8,8
"74197",2019,0,0,92,92
"74198",2017,0,115,115,230
"74198",2019,0,0,92,92
"74199",2015,0,0,28,28
"74199",2017,0,115,115,230
"74199",2018,0,0,68,68
"74199",2019,0,0,92,92
"74199",2020,0,0,131,131
"74200",2017,0,115,115,230
"74200",2018,0,0,16,16
"74200",2019,0,0,92,92
"74201",2015,0,0,28,28
"74201",2017,0,115,115,230
"74201",2018,0,0,9,9
"74201",2019,0,0,92,92
"74202",2017,0,115,115,230
"74203",2017,0,115,115,230
"74203",2018,0,0,16,16
"74203",2019,0,0,92,92
"74205",2015,0,0,28,28
"74205",2017,0,115,115,230
"74205",2018,0,0,15,15
"74205",2019,0,0,92,92
"74206",2017,0,115,115,230
"74206",2018,0,0,41,41
"74206",2019,0,0,92,92
"74206",2020,0,0,82,82
"74208",2017,0,115,115,230
"74208",2018,0,0,16,16
"74208",2019,0,0,92,92
"74209",2015,0,0,28,28
"74209",2017,0,115,115,230
"74209",2018,0,0,8,8
"74209",2019,0,0,92,92
"74210",2015,0,0,28,28
"74210",2017,0,115,115,230
"74210",2018,0,0,68,68
"74210",2019,0,0,92,92
"74210",2020,0,0,131,131
"74211",2015,0,0,28,28
"74211",2017,0,115,115,230
"74211",2018,0,0,9,9
"74211",2019,0,0,92,92
"74212",2015,0,0,28,28
"74212",2017,0,115,115,230
"74212",2019,0,0,92,92
"74213",2017,0,115,115,230
"74215",2017,0,115,115,230
"74215",2018,0,0,16,16
"74215",2019,0,0,92,92
"74216",2017,0,115,115,230
"74216",2018,0,0,16,16
"74218",2017,0,115,115,230
"74218",2018,0,0,41,41
"74218",2019,0,0,92,92
"74218",2020,0,0,82,82
"74219",2017,0,115,115,230
"74219",2019,0,0,7,7
"74220",2015,0,0,28,28
"74220",2017,0,115,115,230
"74220",2018,0,0,9,9
"74220",2019,0,0,92,92
"74221",2017,0,115,115,230
"74221",2018,0,0,16,16
"74221",2019,0,0,92,92
"74222",2017,0,115,115,230
"74222",2018,0,0,41,41
"74222",2019,0,0,92,92
"74222",2020,0,0,82,82
"74223",2017,0,115,115,230
"74223",2018,0,0,16,16
"74223",2019,0,0,92,92
"74224",2015,0,0,28,28
"74224",2017,0,115,115,230
"74224",2019,0,0,92,92
"74225",2017,0,115,115,230
"74225",2019,0,0,7,7
"74226",2015,0,0,28,28
"74226",2017,0,115,115,230
"74226",2018,0,0,8,8
"74226",2019,0,0,92,92
"74228",2017,0,115,115,230
"74228",2018,0,0,16,16
"74229",2015,0,0,28,28
"74229",2017,0,115,115,230
"74229",2018,0,0,15,15
"74229",2019,0,0,92,92
"74229",2020,0,0,82,82
"74231",2017,0,115,115,230
"74231",2019,0,0,92,92
"74232",2017,0,115,115,230
"74232",2019,0,0,7,7
"74233",2017,0,115,115,230
"74234",2017,0,115,115,230
"74234",2019,0,0,92,92
"74235",2017,0,115,115,230
"74235",2018,0,0,16,16
"74236",2017,0,115,115,230
"74236",2018,0,0,16,16
"74236",2019,0,0,92,92
"74237",2017,0,115,115,230
"74237",2018,0,0,16,16
"74237",2019,0,0,92,92
"74238",2017,0,115,115,230
"74238",2018,0,0,16,16
"74238",2019,0,0,92,92
"74239",2017,0,115,115,230
"74239",2019,0,0,92,92
"74240",2015,0,0,28,28
"74240",2017,0,115,115,230
"74240",2018,0,0,15,15
"74240",2019,0,0,92,92
"74241",2015,0,0,28,28
"74241",2017,0,115,115,230
"74241",2018,0,0,15,15
"74241",2019,0,0,92,92
"74242",2017,0,115,115,230
"74242",2019,0,0,7,7
"74243",2015,0,0,28,28
"74243",2017,0,115,115,230
"74243",2018,0,0,9,9
"74243",2019,0,0,92,92
"74244",2015,0,0,28,28
"74244",2017,0,115,115,230
"74244",2018,0,0,16,16
"74244",2019,0,0,92,92
"74249",2017,0,115,115,230
"74249",2018,0,0,16,16
"74249",2019,0,0,92,92
"74250",2015,0,0,28,28
"74250",2017,0,115,115,230
"74250",2018,0,0,16,16
"74250",2019,0,0,92,92
"74252",2017,0,115,115,230
"74252",2018,0,0,16,16
"74252",2019,0,0,92,92
"74253",2015,0,0,28,28
"74253",2017,0,115,115,230
"74253",2018,0,0,16,16
"74253",2019,0,0,92,92
"74254",2017,0,115,115,230
"74255",2017,0,115,115,230
"74255",2019,0,0,7,7
"74256",2017,0,115,115,230
"74256",2019,0,0,92,92
"74257",2017,0,115,115,230
"74257",2018,0,0,16,16
"74258",2017,0,115,115,230
"74258",2018,0,0,16,16
"74258",2019,0,0,92,92
"74259",2017,0,115,115,230
"74259",2018,0,0,16,16
"74260",2017,0,115,115,230
"74260",2018,0,0,16,16
"74261",2015,0,0,28,28
"74261",2017,0,115,115,230
"74261",2018,0,0,15,15
"74261",2019,0,0,92,92
"74261",2020,0,0,82,82
"74262",2015,0,0,28,28
"74262",2017,0,115,115,230
"74262",2018,0,0,9,9
"74262",2019,0,0,92,92
"74263",2015,0,0,28,28
"74263",2017,0,115,115,230
"74263",2018,0,0,68,68
"74263",2019,0,0,92,92
"74263",2020,0,0,131,131
"74264",2017,0,115,115,230
"74264",2018,0,0,16,16
"74264",2019,0,0,92,92
"74265",2017,0,115,115,230
"74265",2019,0,0,92,92
"74266",2017,0,115,115,230
"74266",2018,0,0,16,16
"74266",2019,0,0,92,92
"74267",2017,0,115,115,230
"74267",2019,0,0,7,7
"74269",2017,0,115,115,230
"74271",2017,0,115,115,230
"74271",2018,0,0,16,16
"74271",2019,0,0,92,92
"74272",2017,0,115,115,230
"74273",2017,0,115,115,230
"74273",2018,0,0,16,16
"74273",2019,0,0,92,92
"74275",2017,0,115,115,230
"74275",2019,0,0,92,92
"74276",2017,0,115,115,230
"74276",2018,0,0,16,16
"74276",2019,0,0,92,92
"74278",2017,0,115,115,230
"74278",2018,0,0,16,16
"74278",2019,0,0,92,92
"74279",2017,0,115,115,230
"74279",2018,0,0,16,16
"74279",2019,0,0,92,92
"74280",2017,0,115,115,230
"74280",2019,0,0,92,92
"74281",2017,0,115,115,230
"74281",2018,0,0,41,41
"74281",2019,0,0,92,92
"74281",2020,0,0,82,82
"74282",2017,0,115,115,230
"74283",2017,0,115,115,230
"74284",2015,0,0,28,28
"74284",2017,0,115,115,230
"74284",2018,0,0,15,15
"74284",2019,0,0,92,92
"74285",2017,0,115,115,230
"74285",2018,0,0,16,16
"74286",2017,0,115,115,230
"74286",2018,0,0,16,16
"74286",2019,0,0,92,92
"74287",2017,0,115,115,230
"74287",2018,0,0,41,41
"74287",2019,0,0,92,92
"74287",2020,0,0,82,82
"74288",2015,0,0,28,28
"74288",2017,0,115,115,230
"74288",2018,0,0,9,9
"74288",2019,0,0,92,92
"74289",2017,0,115,115,230
"74290",2017,0,115,115,230
"74290",2018,0,0,16,16
"74290",2019,0,0,92,92
"74291",2017,0,115,115,230
"74291",2018,0,0,16,16
"74292",2017,0,115,115,230
"74293",2015,0,0,28,28
"74293",2017,0,115,115,230
"74293",2018,0,0,68,68
"74293",2019,0,0,92,92
"74293",2020,0,0,82,82
"74294",2017,0,115,115,230
"74294",2018,0,0,16,16
"74294",2019,0,0,92,92
"74295",2017,0,115,115,230
"74295",2018,0,0,16,16
"74295",2019,0,0,92,92
"74296",2017,0,115,115,230
"74296",2018,0,0,16,16
"74297",2017,0,115,115,230
"74297",2019,0,0,92,92
"74298",2015,0,0,28,28
"74298",2017,0,115,115,230
"74298",2018,0,0,9,9
"74298",2019,0,0,92,92
"74299",2017,0,115,115,230
"74299",2019,0,0,92,92
"74301",2015,0,0,28,28
"74301",2017,0,115,115,230
"74301",2018,0,0,15,15
"74301",2019,0,0,92,92
"74302",2017,0,115,115,230
"74302",2019,0,0,92,92
"74303",2017,0,115,115,230
"74303",2019,0,0,92,92
"74304",2015,0,0,28,28
"74304",2017,0,115,115,230
"74304",2018,0,0,8,8
"74304",2019,0,0,92,92
"74305",2015,0,0,28,28
"74305",2017,0,115,115,230
"74305",2018,0,0,9,9
"74305",2019,0,0,92,92
"74306",2017,0,115,115,230
"74307",2017,0,115,115,230
"74308",2017,0,115,115,230
"74308",2018,0,0,16,16
"74308",2019,0,0,92,92
"74309",2015,0,0,28,28
"74309",2017,0,115,115,230
"74309",2018,0,0,9,9
"74309",2019,0,0,92,92
"74310",2017,0,115,115,230
"74310",2019,0,0,7,7
"74311",2015,0,0,28,28
"74311",2017,0,115,115,230
"74311",2018,0,0,15,15
"74311",2019,0,0,92,92
"74312",2017,0,115,115,230
"74312",2018,0,0,16,16
"74312",2019,0,0,92,92
"74313",2017,0,115,115,230
"74313",2018,0,0,16,16
"74314",2017,0,115,115,230
"74314",2018,0,0,16,16
"74315",2015,0,0,28,28
"74315",2017,0,115,115,230
"74315",2018,0,0,68,68
"74315",2019,0,0,92,92
"74315",2020,0,0,131,131
"75056",2017,0,0,91,91
"75056",2019,0,0,67,67
"75056",2020,0,0,86,86
"76001",2016,0,13,122,135
"76001",2017,0,15,15,30
"76001",2019,0,28,28,56
"76002",2016,0,13,0,13
"76002",2017,0,77,0,77
"76002",2019,0,142,114,256
"76004",2016,0,13,13,26
"76004",2017,0,77,15,92
"76004",2019,0,142,83,225
"76005",2016,0,13,0,13
"76005",2017,0,74,15,89
"76005",2019,0,142,114,256
"76006",2016,0,13,0,13
"76006",2017,0,77,0,77
"76006",2019,0,142,114,256
"76007",2016,0,13,122,135
"76007",2017,0,15,63,78
"76007",2019,0,28,28,56
"76008",2016,0,13,13,26
"76008",2017,0,21,15,36
"76008",2019,0,66,39,105
"76009",2016,0,13,0,13
"76009",2017,0,77,0,77
"76009",2019,0,142,114,256
"76010",2016,0,13,122,135
"76010",2017,0,15,37,52
"76010",2019,0,28,28,56
"76011",2016,0,13,0,13
"76011",2017,0,77,0,77
"76011",2019,0,142,114,256
"76012",2016,0,13,118,131
"76012",2017,0,92,0,92
"76012",2019,0,142,114,256
"76013",2016,0,13,0,13
"76013",2017,0,77,0,77
"76013",2019,0,142,114,256
"76014",2016,0,13,118,131
"76014",2017,0,161,0,161
"76014",2019,0,28,0,28
"76015",2016,0,13,0,13
"76015",2017,0,77,0,77
"76015",2019,0,142,114,256
"76016",2016,0,13,0,13
"76016",2017,0,77,0,77
"76016",2019,0,142,114,256
"76017",2016,0,13,118,131
"76017",2017,0,161,0,161
"76017",2019,0,28,0,28
"76018",2016,0,13,13,26
"76018",2017,0,215,15,230
"76018",2019,0,133,28,161
"76019",2016,0,13,13,26
"76019",2017,0,215,15,230
"76019",2019,0,133,28,161
"76020",2016,0,13,122,135
"76020",2017,0,15,63,78
"76020",2019,0,28,28,56
"76021",2016,0,13,118,131
"76021",2017,0,92,0,92
"76021",2019,0,142,114,256
"76022",2016,0,13,118,131
"76022",2017,0,30,15,45
"76022",2019,0,28,28,56
"76023",2016,0,13,0,13
"76023",2017,0,77,0,77
"76023",2019,0,142,114,256
"76024",2016,0,13,13,26
"76024",2017,0,215,15,230
"76024",2019,0,133,28,161
"76025",2016,0,13,0,13
"76025",2017,0,246,0,246
"76025",2019,0,0,133,133
"76026",2016,0,13,13,26
"76026",2017,0,21,15,36
"76026",2019,0,66,39,105
"76028",2016,0,13,0,13
"76028",2017,0,15,0,15
"76028",2019,0,67,28,95
"76029",2016,0,13,0,13
"76029",2017,0,15,0,15
"76029",2019,0,0,70,70
"76030",2016,0,13,13,26
"76030",2017,0,215,15,230
"76030",2019,0,133,28,161
"76032",2016,0,13,0,13
"76032",2017,0,77,0,77
"76032",2019,0,142,114,256
"76033",2016,0,13,118,131
"76033",2017,0,92,0,92
"76033",2019,0,142,114,256
"76034",2016,0,13,13,26
"76034",2017,0,215,15,230
"76034",2019,0,133,28,161
"76035",2016,0,13,0,13
"76035",2017,0,15,0,15
"76035",2019,0,67,28,95
"76036",2016,0,13,13,26
"76036",2017,0,215,15,230
"76036",2019,0,133,28,161
"76038",2016,0,13,13,26
"76038",2017,0,215,15,230
"76038",2019,0,142,83,225
"76039",2016,0,13,0,13
"76039",2017,0,74,15,89
"76039",2019,0,142,114,256
"76040",2016,0,13,0,13
"76040",2017,0,77,0,77
"76040",2019,0,142,114,256
"76041",2016,0,13,0,13
"76041",2017,0,77,0,77
"76041",2019,0,142,114,256
"76042",2016,0,13,0,13
"76042",2017,0,15,0,15
"76042",2019,0,0,70,70
"76043",2016,0,13,122,135
"76043",2017,0,15,15,30
"76043",2019,0,28,28,56
"76045",2016,0,13,122,135
"76045",2017,0,15,63,78
"76045",2019,0,28,28,56
"76046",2016,0,13,0,13
"76046",2017,0,246,15,261
"76046",2019,0,142,142,284
"76047",2016,0,13,13,26
"76047",2017,0,215,15,230
"76047",2019,0,133,28,161
"76048",2016,0,13,0,13
"76048",2017,0,246,0,246
"76048",2019,0,0,133,133
"76049",2016,0,13,0,13
"76049",2017,0,15,0,15
"76049",2019,0,0,70,70
"76050",2016,0,13,13,26
"76050",2017,0,77,15,92
"76050",2019,0,142,83,225
"76051",2016,0,13,13,26
"76051",2017,0,215,15,230
"76051",2019,0,133,28,161
"76052",2016,0,13,0,13
"76052",2017,0,15,0,15
"76052",2019,0,0,70,70
"76053",2016,0,13,0,13
"76053",2017,0,15,0,15
"76053",2019,0,0,70,70
"76054",2016,0,13,0,13
"76054",2017,0,15,0,15
"76054",2019,0,0,70,70
"76055",2016,0,13,122,135
"76055",2017,0,15,15,30
"76055",2019,0,28,28,56
"76056",2016,0,13,122,135
"76056",2017,0,15,63,78
"76056",2019,0,28,28,56
"76057",2016,0,13,122,135
"76057",2017,0,15,63,78
"76057",2019,0,28,28,56
"76058",2016,0,13,0,13
"76058",2017,0,15,0,15
"76058",2019,0,0,59,59
"76059",2016,0,13,0,13
"76059",2017,0,15,0,15
"76059",2019,0,67,28,95
"76060",2016,0,13,0,13
"76060",2017,0,52,0,52
"76060",2019,0,0,133,133
"76062",2016,0,13,13,26
"76062",2017,0,215,15,230
"76062",2019,0,133,28,161
"76063",2016,0,13,13,26
"76063",2017,0,215,15,230
"76063",2019,0,133,28,161
"76064",2016,0,13,118,131
"76064",2017,0,161,0,161
"76064",2019,0,28,0,28
"76065",2016,0,13,0,13
"76065",2017,0,15,0,15
"76065",2019,0,0,59,59
"76066",2016,0,13,13,26
"76066",2017,0,215,15,230
"76066",2019,0,142,83,225
"76067",2016,0,13,0,13
"76067",2017,0,246,0,246
"76067",2019,0,0,133,133
"76068",2016,0,13,0,13
"76068",2017,0,77,0,77
"76068",2019,0,142,114,256
"76069",2016,0,13,0,13
"76069",2017,0,74,15,89
"76069",2019,0,142,114,256
"76070",2016,0,13,13,26
"76070",2017,0,215,15,230
"76070",2019,0,133,28,161
"76071",2016,0,13,0,13
"76071",2017,0,15,0,15
"76071",2019,0,0,70,70
"76072",2016,0,13,13,26
"76072",2017,0,215,15,230
"76072",2019,0,133,28,161
"76074",2016,0,13,0,13
"76074",2017,0,246,0,246
"76075",2016,0,13,13,26
"76075",2017,0,215,15,230
"76075",2019,0,133,28,161
"76076",2016,0,13,0,13
"76076",2017,0,77,0,77
"76076",2019,0,142,114,256
"76077",2016,0,13,0,13
"76077",2017,0,77,0,77
"76077",2019,0,142,114,256
"76079",2016,0,13,118,131
"76079",2017,0,161,0,161
"76079",2019,0,28,0,28
"76082",2016,0,13,118,131
"76082",2017,0,92,0,92
"76082",2019,0,142,114,256
"76083",2016,0,13,0,13
"76083",2017,0,77,0,77
"76083",2019,0,142,114,256
"76084",2016,0,13,0,13
"76084",2017,0,77,0,77
"76084",2019,0,142,114,256
"76085",2016,0,13,13,26
"76085",2017,0,215,15,230
"76085",2019,0,133,28,161
"76086",2016,0,13,13,26
"76086",2017,0,215,15,230
"76086",2019,0,133,28,161
"76087",2016,0,13,13,26
"76087",2017,0,77,15,92
"76087",2019,0,142,83,225
"76088",2016,0,13,122,135
"76088",2017,0,15,63,78
"76088",2019,0,28,28,56
"76090",2016,0,13,118,131
"76090",2017,0,161,0,161
"76090",2019,0,28,0,28
"76091",2016,0,13,0,13
"76091",2017,0,77,0,77
"76091",2019,0,142,114,256
"76092",2016,0,13,118,131
"76092",2017,0,92,0,92
"76092",2019,0,142,114,256
"76093",2016,0,13,0,13
"76093",2017,0,246,0,246
"76093",2019,0,0,133,133
"76094",2016,0,13,0,13
"76094",2017,0,246,0,246
"76094",2019,0,0,133,133
"76095",2016,0,13,0,13
"76095",2017,0,74,15,89
"76095",2019,0,142,114,256
"76096",2016,0,13,13,26
"76096",2017,0,215,15,230
"76096",2019,0,133,28,161
"76097",2016,0,13,13,26
"76097",2017,0,215,15,230
"76097",2019,0,133,28,161
"76099",2016,0,13,122,135
"76099",2017,0,15,63,78
"76099",2019,0,28,28,56
"76100",2016,0,13,0,13
"76100",2017,0,246,15,261
"76100",2019,0,142,142,284
"76101",2016,0,13,0,13
"76101",2017,0,15,0,15
"76101",2019,0,67,28,95
"76103",2016,0,13,0,13
"76103",2017,0,74,15,89
"76103",2019,0,142,114,256
"76104",2016,0,13,0,13
"76104",2017,0,77,0,77
"76104",2019,0,142,114,256
"76105",2016,0,13,122,135
"76105",2017,0,15,37,52
"76105",2019,0,28,28,56
"76106",2016,0,13,0,13
"76106",2017,0,246,15,261
"76106",2019,0,142,142,284
"76107",2016,0,13,0,13
"76107",2017,0,246,0,246
"76107",2019,0,0,133,133
"76108",2016,0,13,0,13
"76108",2017,0,74,15,89
"76108",2019,0,142,114,256
"76109",2016,0,13,13,26
"76109",2017,0,246,15,261
"76109",2019,0,133,74,207
"76110",2016,0,13,122,135
"76110",2017,0,15,15,30
"76110",2019,0,28,28,56
"76111",2016,0,13,0,13
"76111",2017,0,246,15,261
"76111",2019,0,142,142,284
"76112",2016,0,13,13,26
"76112",2017,0,215,15,230
"76112",2019,0,133,28,161
"76113",2016,0,13,0,13
"76113",2017,0,246,0,246
"76113",2019,0,0,133,133
"76114",2016,0,13,118,131
"76114",2017,0,92,0,92
"76114",2019,0,142,114,256
"76115",2016,0,13,118,131
"76115",2017,0,92,0,92
"76115",2019,0,142,114,256
"76116",2016,0,13,0,13
"76116",2017,0,74,15,89
"76116",2019,0,142,114,256
"76117",2016,0,13,118,131
"76117",2017,0,161,0,161
"76117",2019,0,28,0,28
"76118",2016,0,13,118,131
"76118",2017,0,161,0,161
"76118",2019,0,28,0,28
"76119",2016,0,13,13,26
"76119",2017,0,215,15,230
"76119",2019,0,133,28,161
"76120",2016,0,13,13,26
"76120",2017,0,52,15,67
"76120",2019,0,66,74,140
"76121",2016,0,13,0,13
"76121",2017,0,246,0,246
"76121",2019,0,0,133,133
"76122",2016,0,13,0,13
"76122",2017,0,15,0,15
"76122",2019,0,0,70,70
"76123",2016,0,13,0,13
"76123",2017,0,74,15,89
"76123",2019,0,142,114,256
"76124",2016,0,13,0,13
"76124",2017,0,246,0,246
"76124",2019,0,0,133,133
"76125",2016,0,13,13,26
"76125",2017,0,215,15,230
"76125",2019,0,142,83,225
"76126",2016,0,13,13,26
"76126",2017,0,21,15,36
"76126",2019,0,66,39,105
"76128",2016,0,13,0,13
"76128",2017,0,77,0,77
"76128",2019,0,142,114,256
"76129",2016,0,13,13,26
"76129",2017,0,77,15,92
"76129",2019,0,142,83,225
"76130",2016,0,13,0,13
"76130",2017,0,15,0,15
"76130",2019,0,0,70,70
"76131",2016,0,13,0,13
"76131",2017,0,74,15,89
"76131",2019,0,142,114,256
"76132",2016,0,13,13,26
"76132",2017,0,77,15,92
"76132",2019,0,142,83,225
"76133",2016,0,13,13,26
"76133",2017,0,77,15,92
"76133",2019,0,142,83,225
"76134",2016,0,13,0,13
"76134",2017,0,77,0,77
"76134",2019,0,142,114,256
"76135",2016,0,13,122,135
"76135",2017,0,15,63,78
"76135",2019,0,28,28,56
"76136",2016,0,13,13,26
"76136",2017,0,77,15,92
"76136",2019,0,142,83,225
"76138",2016,0,13,13,26
"76138",2017,0,215,15,230
"76138",2019,0,133,28,161
"76139",2016,0,13,13,26
"76139",2017,0,21,15,36
"76139",2019,0,66,39,105
"76140",2016,0,13,13,26
"76140",2017,0,77,15,92
"76140",2019,0,142,83,225
"76141",2016,0,13,118,131
"76141",2017,0,161,0,161
"76141",2019,0,28,0,28
"76142",2016,0,13,0,13
"76142",2017,0,246,0,246
"76142",2019,0,0,133,133
"76143",2016,0,13,118,131
"76143",2017,0,92,0,92
"76143",2019,0,142,114,256
"76144",2016,0,13,13,26
"76144",2017,0,77,15,92
"76144",2019,0,142,83,225
"76146",2016,0,13,13,26
"76146",2017,0,246,15,261
"76146",2019,0,142,83,225
"76147",2016,0,13,13,26
"76147",2017,0,21,15,36
"76147",2019,0,66,39,105
"76148",2016,0,13,13,26
"76148",2017,0,21,15,36
"76148",2019,0,66,39,105
"76149",2016,0,13,122,135
"76149",2017,0,15,37,52
"76149",2019,0,28,28,56
"76151",2016,0,13,0,13
"76151",2017,0,77,0,77
"76151",2019,0,142,114,256
"76152",2016,0,13,13,26
"76152",2017,0,215,15,230
"76152",2019,0,142,83,225
"76153",2016,0,13,13,26
"76153",2017,0,215,15,230
"76153",2019,0,133,28,161
"76154",2016,0,13,0,13
"76154",2017,0,15,0,15
"76154",2019,0,67,28,95
"76155",2016,0,13,0,13
"76155",2017,0,15,0,15
"76155",2019,0,0,70,70
"76156",2016,0,13,0,13
"76156",2017,0,77,0,77
"76156",2019,0,142,114,256
"76157",2016,0,13,122,135
"76157",2017,0,15,63,78
"76157",2019,0,28,28,56
"76158",2016,0,13,0,13
"76158",2017,0,77,0,77
"76158",2019,0,142,114,256
"76159",2016,0,13,0,13
"76159",2017,0,77,0,77
"76159",2019,0,142,114,256
"76160",2016,0,13,122,135
"76160",2017,0,15,63,78
"76160",2019,0,28,28,56
"76161",2016,0,13,0,13
"76161",2017,0,77,0,77
"76161",2019,0,142,114,256
"76162",2016,0,13,13,26
"76162",2017,0,215,15,230
"76162",2019,0,133,28,161
"76163",2016,0,13,0,13
"76163",2017,0,246,0,246
"76163",2019,0,0,133,133
"76164",2016,0,13,118,131
"76164",2017,0,30,15,45
"76164",2019,0,28,28,56
"76165",2016,0,13,0,13
"76165",2017,0,74,15,89
"76165",2019,0,142,114,256
"76166",2016,0,13,0,13
"76166",2017,0,15,0,15
"76166",2019,0,0,59,59
"76167",2016,0,13,118,131
"76167",2017,0,161,0,161
"76167",2019,0,28,0,28
"76168",2016,0,13,13,26
"76168",2017,0,215,15,230
"76168",2019,0,133,28,161
"76169",2016,0,13,118,131
"76169",2017,0,161,0,161
"76169",2019,0,28,0,28
"76170",2016,0,13,13,26
"76170",2017,0,215,15,230
"76170",2019,0,133,28,161
"76171",2016,0,13,0,13
"76171",2017,0,246,0,246
"76171",2019,0,0,133,133
"76172",2016,0,13,0,13
"76172",2017,0,77,0,77
"76172",2019,0,142,114,256
"76173",2016,0,13,13,26
"76173",2017,0,215,15,230
"76173",2019,0,133,28,161
"76174",2016,0,13,122,135
"76174",2017,0,15,63,78
"76174",2019,0,28,28,56
"76175",2016,0,13,0,13
"76175",2017,0,15,0,15
"76175",2019,0,0,70,70
"76176",2016,0,13,0,13
"76176",2017,0,77,0,77
"76176",2019,0,142,114,256
"76177",2016,0,13,13,26
"76177",2017,0,215,15,230
"76177",2019,0,142,83,225
"76178",2016,0,13,0,13
"76178",2017,0,74,15,89
"76178",2019,0,142,114,256
"76179",2016,0,13,0,13
"76179",2017,0,74,15,89
"76179",2019,0,185,28,213
"76180",2016,0,13,0,13
"76180",2017,0,77,0,77
"76180",2019,0,142,114,256
"76181",2016,0,13,0,13
"76181",2017,0,77,0,77
"76181",2019,0,142,114,256
"76182",2016,0,13,0,13
"76182",2017,0,77,0,77
"76182",2019,0,142,114,256
"76183",2016,0,13,0,13
"76183",2017,0,77,0,77
"76183",2019,0,142,114,256
"76184",2016,0,13,13,26
"76184",2017,0,215,15,230
"76184",2019,0,133,28,161
"76185",2016,0,13,0,13
"76185",2017,0,52,0,52
"76185",2019,0,0,70,70
"76186",2016,0,13,0,13
"76186",2017,0,15,0,15
"76186",2019,0,0,59,59
"76187",2016,0,13,0,13
"76187",2017,0,77,0,77
"76187",2019,0,142,114,256
"76188",2016,0,13,13,26
"76188",2017,0,215,15,230
"76188",2019,0,142,83,225
"76189",2016,0,13,0,13
"76189",2017,0,77,0,77
"76189",2019,0,142,114,256
"76190",2016,0,13,0,13
"76190",2017,0,77,0,77
"76190",2019,0,142,114,256
"76192",2016,0,13,0,13
"76192",2017,0,15,0,15
"76192",2019,0,0,59,59
"76193",2016,0,13,13,26
"76193",2017,0,215,15,230
"76193",2019,0,133,28,161
"76194",2016,0,13,118,131
"76194",2017,0,161,0,161
"76194",2019,0,28,0,28
"76195",2016,0,13,0,13
"76195",2017,0,77,0,77
"76195",2019,0,142,114,256
"76196",2016,0,13,118,131
"76196",2017,0,161,0,161
"76196",2019,0,28,0,28
"76197",2016,0,13,13,26
"76197",2017,0,215,15,230
"76197",2019,0,133,28,161
"76198",2016,0,13,122,135
"76198",2017,0,15,15,30
"76198",2019,0,28,28,56
"76199",2016,0,13,0,13
"76199",2017,0,52,0,52
"76199",2019,0,0,59,59
"76200",2016,0,13,13,26
"76200",2017,0,215,15,230
"76200",2019,0,142,83,225
"76201",2016,0,13,0,13
"76201",2017,0,246,0,246
"76201",2019,0,0,133,133
"76202",2016,0,13,0,13
"76202",2017,0,15,0,15
"76202",2019,0,0,70,70
"76203",2016,0,13,122,135
"76203",2017,0,15,63,78
"76203",2019,0,28,28,56
"76204",2016,0,13,13,26
"76204",2017,0,215,15,230
"76204",2019,0,133,28,161
"76205",2016,0,13,13,26
"76205",2017,0,215,15,230
"76205",2019,0,133,28,161
"76206",2016,0,13,118,131
"76206",2017,0,161,0,161
"76206",2019,0,28,0,28
"76207",2016,0,13,0,13
"76207",2017,0,15,0,15
"76207",2019,0,0,59,59
"76208",2016,0,13,0,13
"76208",2017,0,246,0,246
"76209",2016,0,13,0,13
"76209",2017,0,246,0,246
"76210",2016,0,13,13,26
"76210",2017,0,21,15,36
"76210",2019,0,66,39,105
"76211",2016,0,13,0,13
"76211",2017,0,15,0,15
"76211",2019,0,0,59,59
"76212",2016,0,13,0,13
"76212",2017,0,74,15,89
"76212",2019,0,142,114,256
"76213",2016,0,13,0,13
"76213",2017,0,77,0,77
"76213",2019,0,142,114,256
"76214",2016,0,13,13,26
"76214",2017,0,215,15,230
"76214",2019,0,133,28,161
"76216",2016,0,13,0,13
"76216",2017,0,74,15,89
"76216",2019,0,142,114,256
"76217",2016,0,13,13,26
"76217",2017,0,21,15,36
"76217",2019,0,66,39,105
"76218",2016,0,13,0,13
"76218",2017,0,246,0,246
"76219",2016,0,13,0,13
"76219",2017,0,77,0,77
"76219",2019,0,142,114,256
"76220",2016,0,13,0,13
"76220",2017,0,15,0,15
"76220",2019,0,0,70,70
"76221",2016,0,13,0,13
"76221",2017,0,77,0,77
"76221",2019,0,142,114,256
"76222",2016,0,13,122,135
"76222",2017,0,15,63,78
"76222",2019,0,28,28,56
"76223",2016,0,13,122,135
"76223",2017,0,15,15,30
"76223",2019,0,28,28,56
"76224",2016,0,13,118,131
"76224",2017,0,161,0,161
"76224",2019,0,28,0,28
"76225",2016,0,13,0,13
"76225",2017,0,77,0,77
"76225",2019,0,142,114,256
"76226",2016,0,13,0,13
"76226",2017,0,77,0,77
"76226",2019,0,142,114,256
"76227",2016,0,13,122,135
"76227",2017,0,15,15,30
"76227",2019,0,28,28,56
"76228",2016,0,13,122,135
"76228",2017,0,15,15,30
"76228",2019,0,28,28,56
"76229",2016,0,13,0,13
"76229",2017,0,246,0,246
"76229",2019,0,0,133,133
"76230",2016,0,13,0,13
"76230",2017,0,246,0,246
"76230",2019,0,0,133,133
"76231",2016,0,13,0,13
"76231",2017,0,74,15,89
"76231",2019,0,142,114,256
"76232",2016,0,13,0,13
"76232",2017,0,77,0,77
"76232",2019,0,142,114,256
"76233",2016,0,13,0,13
"76233",2017,0,15,0,15
"76233",2019,0,67,28,95
"76234",2016,0,13,122,135
"76234",2017,0,15,37,52
"76234",2019,0,28,28,56
"76235",2016,0,13,0,13
"76235",2017,0,15,0,15
"76235",2019,0,0,70,70
"76236",2016,0,13,0,13
"76236",2017,0,77,0,77
"76236",2019,0,142,114,256
"76237",2016,0,13,122,135
"76237",2017,0,15,63,78
"76237",2019,0,28,28,56
"76238",2016,0,13,118,131
"76238",2017,0,161,0,161
"76238",2019,0,28,0,28
"76239",2016,0,13,118,131
"76239",2017,0,161,0,161
"76239",2019,0,28,0,28
"76240",2016,0,13,118,131
"76240",2017,0,92,0,92
"76240",2019,0,142,114,256
"76241",2016,0,13,0,13
"76241",2017,0,77,0,77
"76241",2019,0,142,114,256
"76242",2016,0,13,0,13
"76242",2017,0,246,0,246
"76243",2016,0,13,0,13
"76243",2017,0,246,0,246
"76243",2019,0,0,133,133
"76244",2016,0,13,13,26
"76244",2017,0,21,15,36
"76244",2019,0,66,39,105
"76245",2016,0,13,122,135
"76245",2017,0,15,63,78
"76245",2019,0,28,28,56
"76247",2016,0,13,13,26
"76247",2017,0,215,15,230
"76247",2019,0,142,83,225
"76249",2016,0,13,13,26
"76249",2017,0,215,15,230
"76249",2019,0,142,83,225
"76250",2016,0,13,118,131
"76250",2017,0,161,0,161
"76250",2019,0,28,0,28
"76251",2016,0,13,0,13
"76251",2017,0,77,0,77
"76251",2019,0,142,114,256
"76252",2016,0,13,0,13
"76252",2017,0,15,0,15
"76252",2019,0,0,59,59
"76253",2016,0,13,0,13
"76253",2017,0,77,0,77
"76253",2019,0,142,114,256
"76254",2016,0,13,118,131
"76254",2017,0,161,0,161
"76254",2019,0,28,0,28
"76255",2016,0,13,0,13
"76255",2017,0,15,0,15
"76255",2019,0,67,28,95
"76257",2016,0,13,0,13
"76257",2017,0,15,0,15
"76257",2019,0,0,59,59
"76258",2016,0,13,0,13
"76258",2017,0,77,0,77
"76258",2019,0,142,114,256
"76259",2016,0,13,118,131
"76259",2017,0,92,0,92
"76259",2019,0,142,114,256
"76260",2016,0,13,0,13
"76260",2017,0,246,0,246
"76261",2016,0,13,0,13
"76261",2017,0,246,0,246
"76261",2019,0,0,133,133
"76262",2016,0,13,0,13
"76262",2017,0,15,0,15
"76262",2019,0,0,70,70
"76263",2016,0,13,0,13
"76263",2017,0,246,0,246
"76263",2019,0,0,133,133
"76264",2016,0,13,122,135
"76264",2017,0,15,15,30
"76264",2019,0,28,28,56
"76265",2016,0,13,0,13
"76265",2017,0,15,0,15
"76265",2019,0,0,59,59
"76266",2016,0,13,0,13
"76266",2017,0,15,0,15
"76266",2019,0,0,59,59
"76268",2016,0,13,118,131
"76268",2017,0,161,0,161
"76268",2019,0,28,0,28
"76269",2016,0,13,13,26
"76269",2017,0,21,15,36
"76269",2019,0,66,39,105
"76270",2016,0,13,118,131
"76270",2017,0,161,0,161
"76270",2019,0,28,0,28
"76271",2016,0,13,0,13
"76271",2017,0,74,15,89
"76271",2019,0,142,114,256
"76272",2016,0,13,0,13
"76272",2017,0,77,0,77
"76272",2019,0,142,114,256
"76273",2016,0,13,0,13
"76273",2017,0,74,15,89
"76273",2019,0,142,114,256
"76274",2016,0,13,13,26
"76274",2017,0,215,15,230
"76274",2019,0,133,28,161
"76275",2016,0,13,118,131
"76275",2017,0,161,0,161
"76275",2019,0,28,0,28
"76276",2016,0,13,0,13
"76276",2017,0,52,0,52
"76276",2019,0,0,133,133
"76278",2016,0,13,0,13
"76278",2017,0,15,0,15
"76278",2019,0,0,59,59
"76279",2016,0,13,0,13
"76279",2017,0,77,0,77
"76279",2019,0,142,114,256
"76280",2016,0,13,0,13
"76280",2017,0,15,0,15
"76280",2019,0,0,70,70
"76281",2016,0,13,118,131
"76281",2017,0,161,0,161
"76281",2019,0,28,0,28
"76282",2016,0,13,0,13
"76282",2017,0,74,15,89
"76282",2019,0,142,114,256
"76283",2016,0,13,13,26
"76283",2017,0,21,15,36
"76283",2019,0,66,39,105
"76284",2016,0,13,13,26
"76284",2017,0,215,15,230
"76284",2019,0,142,83,225
"76285",2016,0,13,0,13
"76285",2017,0,246,15,261
"76285",2019,0,142,142,284
"76286",2016,0,13,0,13
"76286",2017,0,15,0,15
"76286",2019,0,0,70,70
"76287",2016,0,13,122,135
"76287",2017,0,15,63,78
"76287",2019,0,28,28,56
"76288",2016,0,13,13,26
"76288",2017,0,21,15,36
"76288",2019,0,66,39,105
"76289",2016,0,13,122,135
"76289",2017,0,15,63,78
"76289",2019,0,28,28,56
"76290",2016,0,13,13,26
"76290",2017,0,215,15,230
"76290",2019,0,142,83,225
"76291",2016,0,13,118,131
"76291",2017,0,161,0,161
"76291",2019,0,28,0,28
"76292",2016,0,13,0,13
"76292",2017,0,246,0,246
"76292",2019,0,0,133,133
"76293",2016,0,13,0,13
"76293",2017,0,77,0,77
"76293",2019,0,142,114,256
"76294",2016,0,13,13,26
"76294",2017,0,77,15,92
"76294",2019,0,142,83,225
"76295",2016,0,13,0,13
"76295",2017,0,52,0,52
"76295",2019,0,0,59,59
"76296",2016,0,13,118,131
"76296",2017,0,161,0,161
"76296",2019,0,28,0,28
"76297",2016,0,13,0,13
"76297",2017,0,246,0,246
"76298",2016,0,13,0,13
"76298",2017,0,77,0,77
"76298",2019,0,142,114,256
"76299",2016,0,13,0,13
"76299",2017,0,77,0,77
"76299",2019,0,142,114,256
"76300",2016,0,13,118,131
"76300",2017,0,161,0,161
"76300",2019,0,28,0,28
"76302",2016,0,13,118,131
"76302",2017,0,161,0,161
"76302",2019,0,28,0,28
"76303",2016,0,13,118,131
"76303",2017,0,161,0,161
"76303",2019,0,28,0,28
"76304",2016,0,13,118,131
"76304",2017,0,92,0,92
"76304",2019,0,142,114,256
"76305",2016,0,13,118,131
"76305",2017,0,161,0,161
"76305",2019,0,28,0,28
"76306",2016,0,13,13,26
"76306",2017,0,77,15,92
"76306",2019,0,142,83,225
"76307",2016,0,13,118,131
"76307",2017,0,161,0,161
"76307",2019,0,28,0,28
"76308",2016,0,13,13,26
"76308",2017,0,215,15,230
"76308",2019,0,133,28,161
"76309",2016,0,13,0,13
"76309",2017,0,77,0,77
"76309",2019,0,142,114,256
"76311",2016,0,13,122,135
"76311",2017,0,15,63,78
"76311",2019,0,28,28,56
"76312",2016,0,13,0,13
"76312",2017,0,246,0,246
"76313",2016,0,13,0,13
"76313",2017,0,74,15,89
"76313",2019,0,142,114,256
"76314",2016,0,13,118,131
"76314",2017,0,161,0,161
"76314",2019,0,28,0,28
"76315",2016,0,13,0,13
"76315",2017,0,77,0,77
"76315",2019,0,142,114,256
"76316",2016,0,13,0,13
"76316",2017,0,246,15,261
"76316",2019,0,142,142,284
"76317",2016,0,13,118,131
"76317",2017,0,92,0,92
"76317",2019,0,142,114,256
"76318",2016,0,13,118,131
"76318",2017,0,30,15,45
"76318",2019,0,28,28,56
"76319",2016,0,13,0,13
"76319",2017,0,74,15,89
"76319",2019,0,142,114,256
"76320",2016,0,13,0,13
"76320",2017,0,15,0,15
"76320",2019,0,0,59,59
"76321",2016,0,13,13,26
"76321",2017,0,21,15,36
"76321",2019,0,66,39,105
"76322",2016,0,13,0,13
"76322",2017,0,74,15,89
"76322",2019,0,142,114,256
"76323",2016,0,13,0,13
"76323",2017,0,15,0,15
"76323",2019,0,0,70,70
"76324",2016,0,13,13,26
"76324",2017,0,21,15,36
"76324",2019,0,66,39,105
"76325",2016,0,13,122,135
"76325",2017,0,15,15,30
"76325",2019,0,28,28,56
"76327",2016,0,13,13,26
"76327",2017,0,77,15,92
"76327",2019,0,142,83,225
"76328",2016,0,13,13,26
"76328",2017,0,215,15,230
"76328",2019,0,133,28,161
"76329",2016,0,13,118,131
"76329",2017,0,161,0,161
"76329",2019,0,28,0,28
"76330",2016,0,13,0,13
"76330",2017,0,77,0,77
"76330",2019,0,142,114,256
"76331",2016,0,13,0,13
"76331",2017,0,74,15,89
"76331",2019,0,142,114,256
"76332",2016,0,13,0,13
"76332",2017,0,52,0,52
"76332",2019,0,0,70,70
"76333",2016,0,13,0,13
"76333",2017,0,15,0,15
"76333",2019,0,67,28,95
"76334",2016,0,13,13,26
"76334",2017,0,77,15,92
"76334",2019,0,142,83,225
"76335",2016,0,13,122,135
"76335",2017,0,215,15,230
"76335",2019,0,185,28,213
"76336",2016,0,13,0,13
"76336",2017,0,77,0,77
"76336",2019,0,142,114,256
"76338",2016,0,13,0,13
"76338",2017,0,246,0,246
"76338",2019,0,0,133,133
"76339",2016,0,13,0,13
"76339",2017,0,77,0,77
"76339",2019,0,142,114,256
"76340",2016,0,13,0,13
"76340",2017,0,77,0,77
"76340",2019,0,142,114,256
"76341",2016,0,13,118,131
"76341",2017,0,161,0,161
"76341",2019,0,28,0,28
"76342",2016,0,13,0,13
"76342",2017,0,77,0,77
"76342",2019,0,142,114,256
"76343",2016,0,13,0,13
"76343",2017,0,52,0,52
"76343",2019,0,0,59,59
"76344",2016,0,13,0,13
"76344",2017,0,15,0,15
"76344",2019,0,0,59,59
"76345",2016,0,13,0,13
"76345",2017,0,246,0,246
"76346",2016,0,13,0,13
"76346",2017,0,77,0,77
"76346",2019,0,142,114,256
"76347",2016,0,13,0,13
"76347",2017,0,77,0,77
"76347",2019,0,142,114,256
"76348",2016,0,13,0,13
"76348",2017,0,77,0,77
"76348",2019,0,142,114,256
"76349",2016,0,13,13,26
"76349",2017,0,215,15,230
"76349",2019,0,133,28,161
"76350",2016,0,13,0,13
"76350",2017,0,74,15,89
"76350",2019,0,142,114,256
"76351",2016,0,13,118,131
"76351",2017,0,161,0,161
"76351",2019,0,28,0,28
"76352",2016,0,13,0,13
"76352",2017,0,246,0,246
"76352",2019,0,0,133,133
"76353",2016,0,13,0,13
"76353",2017,0,77,0,77
"76353",2019,0,142,114,256
"76354",2016,0,13,122,135
"76354",2017,0,15,63,78
"76354",2019,0,28,28,56
"76355",2016,0,13,0,13
"76355",2017,0,77,0,77
"76355",2019,0,142,114,256
"76356",2016,0,13,13,26
"76356",2017,0,215,15,230
"76356",2019,0,133,28,161
"76357",2016,0,13,118,131
"76357",2017,0,161,0,161
"76357",2019,0,28,0,28
"76358",2016,0,13,0,13
"76358",2017,0,246,0,246
"76358",2019,0,0,133,133
"76359",2016,0,13,0,13
"76359",2017,0,246,0,246
"76359",2019,0,0,133,133
"76360",2016,0,13,13,26
"76360",2017,0,215,15,230
"76360",2019,0,133,28,161
"76361",2016,0,13,118,131
"76361",2017,0,161,0,161
"76361",2019,0,28,0,28
"76362",2016,0,13,122,135
"76362",2017,0,15,63,78
"76362",2019,0,28,28,56
"76363",2016,0,13,0,13
"76363",2017,0,15,0,15
"76363",2019,0,67,28,95
"76364",2016,0,13,0,13
"76364",2017,0,246,0,246
"76364",2019,0,0,133,133
"76365",2016,0,13,0,13
"76365",2017,0,77,0,77
"76365",2019,0,142,114,256
"76366",2016,0,13,0,13
"76366",2017,0,74,15,89
"76366",2019,0,142,114,256
"76367",2016,0,13,0,13
"76367",2017,0,74,15,89
"76367",2019,0,142,114,256
"76368",2016,0,13,118,131
"76368",2017,0,161,0,161
"76368",2019,0,28,0,28
"76369",2016,0,13,13,26
"76369",2017,0,215,15,230
"76369",2019,0,142,83,225
"76370",2016,0,13,122,135
"76370",2017,0,15,37,52
"76370",2019,0,28,28,56
"76371",2016,0,13,0,13
"76371",2017,0,15,0,15
"76371",2019,0,0,70,70
"76372",2016,0,13,0,13
"76372",2017,0,15,0,15
"76372",2019,0,0,59,59
"76373",2016,0,13,13,26
"76373",2017,0,215,15,230
"76373",2019,0,133,28,161
"76374",2016,0,13,0,13
"76374",2017,0,15,0,15
"76374",2019,0,67,28,95
"76375",2016,0,13,0,13
"76375",2017,0,77,0,77
"76375",2019,0,142,114,256
"76377",2016,0,13,0,13
"76377",2017,0,74,15,89
"76377",2019,0,142,114,256
"76378",2016,0,13,122,135
"76378",2017,0,15,63,78
"76378",2019,0,28,28,56
"76379",2016,0,13,13,26
"76379",2017,0,215,15,230
"76379",2019,0,133,28,161
"76380",2016,0,13,13,26
"76380",2017,0,215,15,230
"76380",2019,0,133,28,161
"76381",2016,0,13,0,13
"76381",2017,0,15,0,15
"76381",2019,0,0,59,59
"76382",2016,0,13,118,131
"76382",2017,0,92,0,92
"76382",2019,0,142,114,256
"76383",2016,0,13,13,26
"76383",2017,0,215,15,230
"76383",2019,0,133,28,161
"76384",2016,0,13,118,131
"76384",2017,0,161,0,161
"76384",2019,0,28,0,28
"76385",2016,0,13,122,135
"76385",2017,0,15,63,78
"76385",2019,0,28,28,56
"76386",2016,0,13,0,13
"76386",2017,0,77,0,77
"76386",2019,0,142,114,256
"76387",2016,0,13,13,26
"76387",2017,0,77,15,92
"76387",2019,0,142,83,225
"76388",2016,0,13,118,131
"76388",2017,0,30,15,45
"76388",2019,0,28,28,56
"76389",2016,0,13,13,26
"76389",2017,0,215,15,230
"76389",2019,0,133,28,161
"76390",2016,0,13,118,131
"76390",2017,0,161,0,161
"76390",2019,0,28,0,28
"76391",2016,0,13,0,13
"76391",2017,0,74,15,89
"76391",2019,0,142,114,256
"76392",2016,0,13,0,13
"76392",2017,0,15,0,15
"76392",2019,0,0,70,70
"76393",2016,0,13,0,13
"76393",2017,0,52,0,52
"76393",2019,0,0,70,70
"76394",2016,0,13,0,13
"76394",2017,0,15,0,15
"76394",2019,0,67,28,95
"76395",2016,0,13,13,26
"76395",2017,0,77,15,92
"76395",2019,0,142,83,225
"76396",2016,0,13,0,13
"76396",2017,0,246,15,261
"76396",2019,0,142,142,284
"76397",2016,0,13,13,26
"76397",2017,0,215,15,230
"76397",2019,0,133,28,161
"76398",2016,0,13,122,135
"76398",2017,0,15,63,78
"76398",2019,0,28,28,56
"76399",2016,0,13,0,13
"76399",2017,0,15,0,15
"76399",2019,0,0,70,70
"76400",2016,0,13,13,26
"76400",2017,0,77,15,92
"76400",2019,0,142,83,225
"76401",2016,0,13,118,131
"76401",2017,0,30,15,45
"76401",2019,0,28,28,56
"76402",2016,0,13,122,135
"76402",2017,0,15,63,78
"76402",2019,0,28,28,56
"76403",2016,0,13,0,13
"76403",2017,0,77,0,77
"76403",2019,0,142,114,256
"76404",2016,0,13,118,131
"76404",2017,0,161,0,161
"76404",2019,0,28,0,28
"76405",2016,0,13,13,26
"76405",2017,0,215,15,230
"76405",2019,0,133,28,161
"76406",2016,0,13,118,131
"76406",2017,0,161,0,161
"76406",2019,0,28,0,28
"76407",2016,0,13,0,13
"76407",2017,0,77,0,77
"76407",2019,0,142,114,256
"76408",2016,0,13,118,131
"76408",2017,0,161,0,161
"76408",2019,0,28,0,28
"76409",2016,0,13,118,131
"76409",2017,0,161,0,161
"76409",2019,0,28,0,28
"76410",2016,0,13,122,135
"76410",2017,0,15,63,78
"76410",2019,0,28,28,56
"76411",2016,0,13,0,13
"76411",2017,0,15,0,15
"76411",2019,0,67,28,95
"76412",2016,0,13,0,13
"76412",2017,0,246,15,261
"76412",2019,0,142,142,284
"76413",2016,0,13,13,26
"76413",2017,0,21,15,36
"76413",2019,0,66,39,105
"76414",2016,0,13,13,26
"76414",2017,0,21,15,36
"76414",2019,0,66,39,105
"76415",2016,0,13,13,26
"76415",2017,0,21,15,36
"76415",2019,0,66,39,105
"76416",2016,0,13,13,26
"76416",2017,0,21,15,36
"76416",2019,0,66,39,105
"76417",2016,0,13,13,26
"76417",2017,0,21,15,36
"76417",2019,0,66,39,105
"76418",2016,0,13,122,135
"76418",2017,0,15,63,78
"76418",2019,0,28,28,56
"76419",2016,0,13,122,135
"76419",2017,0,15,63,78
"76419",2019,0,28,28,56
"76420",2016,0,13,13,26
"76420",2017,0,52,15,67
"76420",2019,0,66,74,140
"76421",2016,0,13,118,131
"76421",2017,0,161,0,161
"76421",2019,0,28,0,28
"76422",2016,0,13,0,13
"76422",2017,0,15,0,15
"76422",2019,0,0,59,59
"76423",2016,0,13,0,13
"76423",2017,0,246,0,246
"76424",2016,0,13,0,13
"76424",2017,0,15,0,15
"76424",2019,0,0,70,70
"76425",2016,0,13,118,131
"76425",2017,0,92,0,92
"76425",2019,0,142,114,256
"76426",2016,0,13,0,13
"76426",2017,0,246,0,246
"76426",2019,0,0,133,133
"76427",2016,0,13,0,13
"76427",2017,0,15,0,15
"76427",2019,0,0,70,70
"76428",2016,0,13,0,13
"76428",2017,0,77,0,77
"76428",2019,0,142,114,256
"76429",2016,0,13,0,13
"76429",2017,0,74,15,89
"76429",2019,0,142,114,256
"76430",2016,0,13,13,26
"76430",2017,0,21,15,36
"76430",2019,0,66,39,105
"76431",2016,0,13,0,13
"76431",2017,0,246,0,246
"76431",2019,0,0,133,133
"76432",2016,0,13,0,13
"76432",2017,0,15,0,15
"76432",2019,0,0,70,70
"76433",2016,0,13,122,135
"76433",2017,0,15,63,78
"76433",2019,0,28,28,56
"76434",2016,0,13,0,13
"76434",2017,0,246,15,261
"76434",2019,0,142,142,284
"76435",2016,0,13,0,13
"76435",2017,0,15,0,15
"76435",2019,0,0,59,59
"76436",2016,0,13,122,135
"76436",2017,0,15,63,78
"76436",2019,0,28,28,56
"76437",2016,0,13,13,26
"76437",2017,0,21,15,36
"76437",2019,0,66,39,105
"76438",2016,0,13,0,13
"76438",2017,0,15,0,15
"76438",2019,0,67,28,95
"76439",2016,0,13,118,131
"76439",2017,0,161,0,161
"76439",2019,0,28,0,28
"76440",2016,0,13,0,13
"76440",2017,0,246,0,246
"76441",2016,0,13,0,13
"76441",2017,0,15,0,15
"76441",2019,0,67,28,95
"76442",2016,0,13,0,13
"76442",2017,0,15,0,15
"76442",2019,0,67,28,95
"76443",2016,0,13,0,13
"76443",2017,0,74,15,89
"76443",2019,0,142,114,256
"76445",2016,0,13,13,26
"76445",2017,0,246,15,261
"76445",2019,0,133,74,207
"76446",2016,0,13,122,135
"76446",2017,0,15,63,78
"76446",2019,0,28,28,56
"76447",2016,0,13,118,131
"76447",2017,0,161,0,161
"76447",2019,0,28,0,28
"76448",2016,0,13,0,13
"76448",2017,0,74,15,89
"76448",2019,0,142,142,284
"76449",2016,0,13,13,26
"76449",2017,0,215,15,230
"76449",2019,0,133,28,161
"76450",2016,0,13,0,13
"76450",2017,0,246,0,246
"76451",2016,0,13,0,13
"76451",2017,0,74,15,89
"76451",2019,0,142,114,256
"76452",2016,0,13,122,135
"76452",2017,0,15,63,78
"76452",2019,0,28,28,56
"76453",2016,0,13,0,13
"76453",2017,0,246,15,261
"76453",2019,0,142,142,284
"76454",2016,0,13,0,13
"76454",2017,0,15,0,15
"76454",2019,0,0,70,70
"76455",2016,0,13,0,13
"76455",2017,0,246,0,246
"76455",2019,0,0,133,133
"76456",2016,0,13,122,135
"76456",2017,0,15,15,30
"76456",2019,0,28,28,56
"76457",2016,0,13,0,13
"76457",2017,0,74,15,89
"76457",2019,0,142,114,256
"76458",2016,0,13,13,26
"76458",2017,0,215,15,230
"76458",2019,0,133,28,161
"76459",2016,0,13,0,13
"76459",2017,0,15,0,15
"76459",2019,0,0,70,70
"76460",2016,0,13,0,13
"76460",2017,0,15,0,15
"76460",2019,0,67,28,95
"76461",2016,0,13,13,26
"76461",2017,0,21,15,36
"76461",2019,0,66,39,105
"76462",2016,0,13,0,13
"76462",2017,0,15,0,15
"76462",2019,0,0,70,70
"76463",2016,0,13,0,13
"76463",2017,0,246,0,246
"76464",2016,0,13,0,13
"76464",2017,0,74,15,89
"76464",2019,0,142,114,256
"76465",2016,0,13,0,13
"76465",2017,0,15,0,15
"76465",2019,0,0,70,70
"76467",2016,0,13,0,13
"76467",2017,0,77,0,77
"76467",2019,0,142,114,256
"76468",2016,0,13,118,131
"76468",2017,0,92,0,92
"76468",2019,0,142,114,256
"76469",2016,0,13,0,13
"76469",2017,0,246,0,246
"76469",2019,0,0,133,133
"76470",2016,0,13,0,13
"76470",2017,0,77,0,77
"76470",2019,0,142,114,256
"76471",2016,0,13,118,131
"76471",2017,0,30,15,45
"76471",2019,0,28,28,56
"76472",2016,0,13,0,13
"76472",2017,0,15,0,15
"76472",2019,0,0,70,70
"76473",2016,0,13,122,135
"76473",2017,0,15,63,78
"76473",2019,0,28,28,56
"76474",2016,0,13,0,13
"76474",2017,0,74,15,89
"76474",2019,0,142,114,256
"76475",2016,0,13,0,13
"76475",2017,0,74,15,89
"76475",2019,0,142,114,256
"76476",2016,0,13,118,131
"76476",2017,0,30,15,45
"76476",2019,0,28,28,56
"76477",2016,0,13,118,131
"76477",2017,0,161,0,161
"76477",2019,0,28,0,28
"76478",2016,0,13,13,26
"76478",2017,0,215,15,230
"76478",2019,0,133,28,161
"76479",2016,0,13,0,13
"76479",2017,0,15,0,15
"76479",2019,0,0,59,59
"76480",2016,0,13,0,13
"76480",2017,0,77,0,77
"76480",2019,0,142,114,256
"76481",2016,0,13,118,131
"76481",2017,0,161,0,161
"76481",2019,0,28,0,28
"76482",2016,0,13,13,26
"76482",2017,0,215,15,230
"76482",2019,0,133,28,161
"76483",2016,0,13,0,13
"76483",2017,0,77,0,77
"76483",2019,0,142,114,256
"76484",2016,0,13,0,13
"76484",2017,0,74,15,89
"76484",2019,0,142,114,256
"76485",2016,0,13,13,26
"76485",2017,0,215,15,230
"76485",2019,0,133,28,161
"76486",2016,0,13,0,13
"76486",2017,0,74,15,89
"76486",2019,0,142,114,256
"76487",2016,0,13,13,26
"76487",2017,0,21,15,36
"76487",2019,0,66,39,105
"76488",2016,0,13,0,13
"76488",2017,0,77,0,77
"76488",2019,0,142,114,256
"76489",2016,0,13,118,131
"76489",2017,0,161,0,161
"76489",2019,0,28,0,28
"76490",2016,0,13,0,13
"76490",2017,0,77,0,77
"76490",2019,0,142,114,256
"76491",2016,0,13,13,26
"76491",2017,0,77,15,92
"76491",2019,0,142,83,225
"76492",2016,0,13,13,26
"76492",2017,0,215,15,230
"76492",2019,0,133,28,161
"76493",2016,0,13,0,13
"76493",2017,0,77,0,77
"76493",2019,0,142,114,256
"76494",2016,0,13,118,131
"76494",2017,0,161,0,161
"76494",2019,0,28,0,28
"76495",2016,0,13,122,135
"76495",2017,0,15,63,78
"76495",2019,0,28,28,56
"76497",2016,0,13,0,13
"76497",2017,0,74,15,89
"76497",2019,0,142,114,256
"76498",2016,0,13,0,13
"76498",2017,0,74,15,89
"76498",2019,0,142,114,256
"76499",2016,0,13,118,131
"76499",2017,0,161,0,161
"76499",2019,0,28,0,28
"76500",2016,0,13,0,13
"76500",2017,0,15,0,15
"76500",2019,0,67,28,95
"76501",2016,0,13,118,131
"76501",2017,0,161,0,161
"76501",2019,0,28,0,28
"76502",2016,0,13,0,13
"76502",2017,0,246,15,261
"76502",2019,0,142,142,284
"76503",2016,0,13,122,135
"76503",2017,0,15,63,78
"76503",2019,0,28,28,56
"76504",2016,0,13,0,13
"76504",2017,0,77,0,77
"76504",2019,0,142,114,256
"76505",2016,0,13,0,13
"76505",2017,0,52,0,52
"76505",2019,0,0,70,70
"76506",2016,0,13,13,26
"76506",2017,0,21,15,36
"76506",2019,0,66,39,105
"76507",2016,0,13,0,13
"76507",2017,0,15,0,15
"76507",2019,0,67,28,95
"76508",2016,0,13,118,131
"76508",2017,0,161,0,161
"76508",2019,0,28,0,28
"76509",2016,0,13,0,13
"76509",2017,0,74,15,89
"76509",2019,0,142,114,256
"76510",2016,0,13,13,26
"76510",2017,0,77,15,92
"76510",2019,0,142,83,225
"76511",2016,0,13,0,13
"76511",2017,0,15,0,15
"76511",2019,0,0,70,70
"76512",2016,0,13,0,13
"76512",2017,0,15,0,15
"76512",2019,0,0,70,70
"76513",2016,0,13,122,135
"76513",2017,0,15,63,78
"76513",2019,0,28,28,56
"76514",2016,0,13,0,13
"76514",2017,0,74,15,89
"76514",2019,0,142,114,256
"76515",2016,0,13,13,26
"76515",2017,0,77,15,92
"76515",2019,0,142,83,225
"76516",2016,0,13,0,13
"76516",2017,0,15,0,15
"76516",2019,0,0,70,70
"76517",2016,0,13,0,13
"76517",2017,0,246,15,261
"76517",2019,0,142,142,284
"76518",2016,0,13,118,131
"76518",2017,0,92,0,92
"76518",2019,0,142,114,256
"76519",2016,0,13,13,26
"76519",2017,0,77,15,92
"76519",2019,0,142,83,225
"76520",2016,0,13,0,13
"76520",2017,0,15,0,15
"76520",2019,0,0,59,59
"76521",2016,0,13,0,13
"76521",2017,0,246,0,246
"76521",2019,0,0,133,133
"76522",2016,0,13,118,131
"76522",2017,0,161,0,161
"76522",2019,0,28,0,28
"76523",2016,0,13,0,13
"76523",2017,0,15,0,15
"76523",2019,0,0,70,70
"76524",2016,0,13,13,26
"76524",2017,0,77,15,92
"76524",2019,0,142,83,225
"76526",2016,0,13,13,26
"76526",2017,0,21,15,36
"76526",2019,0,66,39,105
"76527",2016,0,13,0,13
"76527",2017,0,15,0,15
"76527",2019,0,0,59,59
"76528",2016,0,13,0,13
"76528",2017,0,15,0,15
"76528",2019,0,0,59,59
"76529",2016,0,13,0,13
"76529",2017,0,77,0,77
"76529",2019,0,142,114,256
"76530",2016,0,13,0,13
"76530",2017,0,77,0,77
"76530",2019,0,142,114,256
"76531",2016,0,13,0,13
"76531",2017,0,77,0,77
"76531",2019,0,142,114,256
"76532",2016,0,13,13,26
"76532",2017,0,246,15,261
"76532",2019,0,142,83,225
"76533",2016,0,13,118,131
"76533",2017,0,161,0,161
"76533",2019,0,28,0,28
"76534",2016,0,13,118,131
"76534",2017,0,161,0,161
"76534",2019,0,28,0,28
"76535",2016,0,13,0,13
"76535",2017,0,52,0,52
"76535",2019,0,0,133,133
"76536",2016,0,13,0,13
"76536",2017,0,74,15,89
"76536",2019,0,142,114,256
"76537",2016,0,13,0,13
"76537",2017,0,15,0,15
"76537",2019,0,0,59,59
"76538",2016,0,13,13,26
"76538",2017,0,215,15,230
"76538",2019,0,133,28,161
"76540",2016,0,13,0,13
"76540",2017,0,74,15,89
"76540",2019,0,142,114,256
"76541",2016,0,13,122,135
"76541",2017,0,15,63,78
"76541",2019,0,28,28,56
"76542",2016,0,13,0,13
"76542",2017,0,77,0,77
"76542",2019,0,142,114,256
"76543",2016,0,13,118,131
"76543",2017,0,92,0,92
"76543",2019,0,142,114,256
"76544",2016,0,13,0,13
"76544",2017,0,246,0,246
"76544",2019,0,0,133,133
"76545",2016,0,13,13,26
"76545",2017,0,215,15,230
"76545",2019,0,133,28,161
"76546",2016,0,13,13,26
"76546",2017,0,215,15,230
"76546",2019,0,133,28,161
"76547",2016,0,13,0,13
"76547",2017,0,246,15,261
"76547",2019,0,142,142,284
"76548",2016,0,13,0,13
"76548",2017,0,246,0,246
"76548",2019,0,0,133,133
"76549",2016,0,13,13,26
"76549",2017,0,215,15,230
"76549",2019,0,133,28,161
"76550",2016,0,13,0,13
"76550",2017,0,74,15,89
"76550",2019,0,142,114,256
"76551",2016,0,13,118,131
"76551",2017,0,161,0,161
"76551",2019,0,28,0,28
"76552",2016,0,13,118,131
"76552",2017,0,161,0,161
"76552",2019,0,28,0,28
"76553",2016,0,13,0,13
"76553",2017,0,15,0,15
"76553",2019,0,0,70,70
"76554",2016,0,13,0,13
"76554",2017,0,246,0,246
"76554",2019,0,0,133,133
"76555",2016,0,13,0,13
"76555",2017,0,246,15,261
"76555",2019,0,142,142,284
"76556",2016,0,13,118,131
"76556",2017,0,161,0,161
"76556",2019,0,28,0,28
"76557",2016,0,13,118,131
"76557",2017,0,30,15,45
"76557",2019,0,28,28,56
"76558",2016,0,13,0,13
"76558",2017,0,74,15,89
"76558",2019,0,142,114,256
"76559",2016,0,13,122,135
"76559",2017,0,15,15,30
"76559",2019,0,28,28,56
"76560",2016,0,13,0,13
"76560",2017,0,74,15,89
"76560",2019,0,142,114,256
"76561",2016,0,13,0,13
"76561",2017,0,74,15,89
"76561",2019,0,142,114,256
"76562",2016,0,13,13,26
"76562",2017,0,21,15,36
"76562",2019,0,66,39,105
"76563",2016,0,13,118,131
"76563",2017,0,161,0,161
"76563",2019,0,28,0,28
"76564",2016,0,13,0,13
"76564",2017,0,77,0,77
"76564",2019,0,142,83,225
"76565",2016,0,13,13,26
"76565",2017,0,215,15,230
"76565",2019,0,133,28,161
"76566",2016,0,13,122,135
"76566",2017,0,15,63,78
"76566",2019,0,28,28,56
"76567",2016,0,13,0,13
"76567",2017,0,15,0,15
"76567",2019,0,0,70,70
"76568",2016,0,13,122,135
"76568",2017,0,15,63,78
"76568",2019,0,28,28,56
"76569",2016,0,13,0,13
"76569",2017,0,77,0,77
"76569",2019,0,142,114,256
"76570",2016,0,13,13,26
"76570",2017,0,215,15,230
"76570",2019,0,133,28,161
"76571",2016,0,13,0,13
"76571",2017,0,246,0,246
"76571",2019,0,0,133,133
"76572",2016,0,13,13,26
"76572",2017,0,77,15,92
"76572",2019,0,142,83,225
"76573",2016,0,13,0,13
"76573",2017,0,246,0,246
"76573",2019,0,0,133,133
"76574",2016,0,13,13,26
"76574",2017,0,215,15,230
"76574",2019,0,133,28,161
"76575",2016,0,13,0,13
"76575",2017,0,74,15,89
"76575",2019,0,142,114,256
"76576",2016,0,13,118,131
"76576",2017,0,161,0,161
"76576",2019,0,28,0,28
"76577",2016,0,13,13,26
"76577",2017,0,215,15,230
"76577",2019,0,133,28,161
"76578",2016,0,13,13,26
"76578",2017,0,21,15,36
"76578",2019,0,66,39,105
"76580",2016,0,13,0,13
"76580",2017,0,74,15,89
"76580",2019,0,142,114,256
"76581",2016,0,13,0,13
"76581",2017,0,246,0,246
"76581",2019,0,0,133,133
"76582",2016,0,13,13,26
"76582",2017,0,21,15,36
"76582",2019,0,66,39,105
"76583",2016,0,13,0,13
"76583",2017,0,74,15,89
"76583",2019,0,142,114,256
"76584",2016,0,13,0,13
"76584",2017,0,15,0,15
"76584",2019,0,0,70,70
"76585",2016,0,13,122,135
"76585",2017,0,15,63,78
"76585",2019,0,28,28,56
"76586",2016,0,13,118,131
"76586",2017,0,161,0,161
"76586",2019,0,28,0,28
"76587",2016,0,13,0,13
"76587",2017,0,77,0,77
"76587",2019,0,142,114,256
"76588",2016,0,13,13,26
"76588",2017,0,215,15,230
"76588",2019,0,133,28,161
"76589",2016,0,13,13,26
"76589",2017,0,215,15,230
"76589",2019,0,133,28,161
"76590",2016,0,13,13,26
"76590",2017,0,21,15,36
"76590",2019,0,66,39,105
"76591",2016,0,13,0,13
"76591",2017,0,74,15,89
"76591",2019,0,142,114,256
"76592",2016,0,13,118,131
"76592",2017,0,161,0,161
"76592",2019,0,28,0,28
"76593",2016,0,13,118,131
"76593",2017,0,161,0,161
"76593",2019,0,28,0,28
"76594",2016,0,13,122,135
"76594",2017,0,15,63,78
"76594",2019,0,28,28,56
"76595",2016,0,13,118,131
"76595",2017,0,161,0,161
"76595",2019,0,28,0,28
"76596",2016,0,13,118,131
"76596",2017,0,161,0,161
"76596",2019,0,28,0,28
"76597",2016,0,13,13,26
"76597",2017,0,77,15,92
"76597",2019,0,142,83,225
"76598",2016,0,13,0,13
"76598",2017,0,15,0,15
"76598",2019,0,0,59,59
"76599",2016,0,13,0,13
"76599",2017,0,74,15,89
"76599",2019,0,142,114,256
"76600",2016,0,13,118,131
"76600",2017,0,92,0,92
"76600",2019,0,142,114,256
"76601",2016,0,13,0,13
"76601",2017,0,246,0,246
"76601",2019,0,0,133,133
"76602",2016,0,13,13,26
"76602",2017,0,215,15,230
"76602",2019,0,133,28,161
"76603",2016,0,13,118,131
"76603",2017,0,92,0,92
"76603",2019,0,142,114,256
"76604",2016,0,13,13,26
"76604",2017,0,215,15,230
"76604",2019,0,133,28,161
"76605",2016,0,13,13,26
"76605",2017,0,215,15,230
"76605",2019,0,133,28,161
"76606",2016,0,13,0,13
"76606",2017,0,15,0,15
"76606",2019,0,67,28,95
"76608",2016,0,13,122,135
"76608",2017,0,15,63,78
"76608",2019,0,28,28,56
"76609",2016,0,13,118,131
"76609",2017,0,161,0,161
"76609",2019,0,28,0,28
"76610",2016,0,13,122,135
"76610",2017,0,15,15,30
"76610",2019,0,28,28,56
"76611",2016,0,13,122,135
"76611",2017,0,15,15,30
"76611",2019,0,28,28,56
"76612",2016,0,13,0,13
"76612",2017,0,15,0,15
"76612",2019,0,0,59,59
"76613",2016,0,13,0,13
"76613",2017,0,77,0,77
"76613",2019,0,142,114,256
"76614",2016,0,13,122,135
"76614",2017,0,15,63,78
"76614",2019,0,28,28,56
"76615",2016,0,13,118,131
"76615",2017,0,161,0,161
"76615",2019,0,28,0,28
"76616",2016,0,13,118,131
"76616",2017,0,161,0,161
"76616",2019,0,28,0,28
"76617",2016,0,13,0,13
"76617",2017,0,74,15,89
"76617",2019,0,142,114,256
"76618",2016,0,13,13,26
"76618",2017,0,21,15,36
"76618",2019,0,66,39,105
"76619",2016,0,13,0,13
"76619",2017,0,15,0,15
"76619",2019,0,0,59,59
"76620",2016,0,13,0,13
"76620",2017,0,15,0,15
"76620",2019,0,0,70,70
"76621",2016,0,13,13,26
"76621",2017,0,215,15,230
"76621",2019,0,133,28,161
"76622",2016,0,13,118,131
"76622",2017,0,30,15,45
"76622",2019,0,28,28,56
"76623",2016,0,13,0,13
"76623",2017,0,52,0,52
"76623",2019,0,0,70,70
"76624",2016,0,13,0,13
"76624",2017,0,21,0,21
"76624",2019,0,66,39,105
"76626",2016,0,13,122,135
"76626",2017,0,15,15,30
"76626",2019,0,28,28,56
"76627",2016,0,13,118,131
"76627",2017,0,161,0,161
"76627",2019,0,28,0,28
"76628",2016,0,13,122,135
"76628",2017,0,15,37,52
"76628",2019,0,28,28,56
"76629",2016,0,13,13,26
"76629",2017,0,215,15,230
"76629",2019,0,133,28,161
"76630",2016,0,13,0,13
"76630",2017,0,15,0,15
"76630",2019,0,0,70,70
"76631",2016,0,13,122,135
"76631",2017,0,15,63,78
"76631",2019,0,28,28,56
"76632",2016,0,13,13,26
"76632",2017,0,215,15,230
"76632",2019,0,133,28,161
"76634",2016,0,13,122,135
"76634",2017,0,15,63,78
"76634",2019,0,28,28,56
"76635",2016,0,13,0,13
"76635",2017,0,15,0,15
"76635",2019,0,0,70,70
"76636",2016,0,13,122,135
"76636",2017,0,15,63,78
"76636",2019,0,28,28,56
"76637",2016,0,13,0,13
"76637",2017,0,77,0,77
"76637",2019,0,142,114,256
"76638",2016,0,13,0,13
"76638",2017,0,15,0,15
"76638",2019,0,67,28,95
"76640",2016,0,13,0,13
"76640",2017,0,74,15,89
"76640",2019,0,142,114,256
"76641",2016,0,13,13,26
"76641",2017,0,77,15,92
"76641",2019,0,142,83,225
"76642",2016,0,13,0,13
"76642",2017,0,77,0,77
"76642",2019,0,142,114,256
"76644",2016,0,13,0,13
"76644",2017,0,15,0,15
"76644",2019,0,0,59,59
"76645",2016,0,13,0,13
"76645",2017,0,15,0,15
"76645",2019,0,0,59,59
"76646",2016,0,13,0,13
"76646",2017,0,77,0,77
"76646",2019,0,142,114,256
"76647",2016,0,13,118,131
"76647",2017,0,161,0,161
"76647",2019,0,28,0,28
"76648",2016,0,13,13,26
"76648",2017,0,21,15,36
"76648",2019,0,66,39,105
"76649",2016,0,13,0,13
"76649",2017,0,15,0,15
"76649",2019,0,0,70,70
"76650",2016,0,13,118,131
"76650",2017,0,161,0,161
"76650",2019,0,28,0,28
"76651",2016,0,13,0,13
"76651",2017,0,77,0,77
"76651",2019,0,142,114,256
"76652",2016,0,13,13,26
"76652",2017,0,21,15,36
"76652",2019,0,66,39,105
"76653",2016,0,13,0,13
"76653",2017,0,77,0,77
"76653",2019,0,142,114,256
"76654",2016,0,13,13,26
"76654",2017,0,215,15,230
"76654",2019,0,133,28,161
"76655",2016,0,13,0,13
"76655",2017,0,77,0,77
"76655",2019,0,142,114,256
"76656",2016,0,13,13,26
"76656",2017,0,215,15,230
"76656",2019,0,133,28,161
"76657",2016,0,13,118,131
"76657",2017,0,161,0,161
"76657",2019,0,28,0,28
"76658",2016,0,13,118,131
"76658",2017,0,161,0,161
"76658",2019,0,28,0,28
"76660",2016,0,13,118,131
"76660",2017,0,161,0,161
"76660",2019,0,28,0,28
"76662",2016,0,13,13,26
"76662",2017,0,77,15,92
"76662",2019,0,142,83,225
"76663",2016,0,13,0,13
"76663",2017,0,77,0,77
"76663",2019,0,142,114,256
"76664",2016,0,13,0,13
"76664",2017,0,77,0,77
"76664",2019,0,142,114,256
"76665",2016,0,13,0,13
"76665",2017,0,15,0,15
"76665",2019,0,0,70,70
"76666",2016,0,13,0,13
"76666",2017,0,246,0,246
"76667",2016,0,13,13,26
"76667",2017,0,215,15,230
"76667",2019,0,133,28,161
"76668",2016,0,13,122,135
"76668",2017,0,15,37,52
"76668",2019,0,28,28,56
"76669",2016,0,13,118,131
"76669",2017,0,161,0,161
"76669",2019,0,28,0,28
"76670",2016,0,13,0,13
"76670",2017,0,77,0,77
"76670",2019,0,142,114,256
"76671",2016,0,13,0,13
"76671",2017,0,15,0,15
"76671",2019,0,0,59,59
"76672",2016,0,13,0,13
"76672",2017,0,52,0,52
"76672",2019,0,0,133,133
"76673",2016,0,13,0,13
"76673",2017,0,246,15,261
"76673",2019,0,142,142,284
"76675",2016,0,13,122,135
"76675",2017,0,15,63,78
"76675",2019,0,28,28,56
"76676",2016,0,13,0,13
"76676",2017,0,246,0,246
"76676",2019,0,0,133,133
"76677",2016,0,13,0,13
"76677",2017,0,15,0,15
"76677",2019,0,0,70,70
"76678",2016,0,13,13,26
"76678",2017,0,52,15,67
"76678",2019,0,66,74,140
"76679",2016,0,13,0,13
"76679",2017,0,77,0,77
"76679",2019,0,142,114,256
"76680",2016,0,13,0,13
"76680",2017,0,77,0,77
"76680",2019,0,142,114,256
"76681",2016,0,13,0,13
"76681",2017,0,74,15,89
"76681",2019,0,142,114,256
"76682",2016,0,13,0,13
"76682",2017,0,74,15,89
"76682",2019,0,142,114,256
"76683",2016,0,13,0,13
"76683",2017,0,77,0,77
"76683",2019,0,142,114,256
"76684",2016,0,13,118,131
"76684",2017,0,161,0,161
"76684",2019,0,28,0,28
"76685",2016,0,13,0,13
"76685",2017,0,77,0,77
"76685",2019,0,142,114,256
"76686",2016,0,13,0,13
"76686",2017,0,77,0,77
"76686",2019,0,142,114,256
"76688",2016,0,13,0,13
"76688",2017,0,77,0,77
"76688",2019,0,142,114,256
"76689",2016,0,13,0,13
"76689",2017,0,77,0,77
"76689",2019,0,142,114,256
"76690",2016,0,13,13,26
"76690",2017,0,215,15,230
"76690",2019,0,133,28,161
"76691",2016,0,13,0,13
"76691",2017,0,52,0,52
"76691",2019,0,0,70,70
"76692",2016,0,13,0,13
"76692",2017,0,77,0,77
"76692",2019,0,142,114,256
"76693",2016,0,13,118,131
"76693",2017,0,161,0,161
"76693",2019,0,28,0,28
"76694",2016,0,13,13,26
"76694",2017,0,77,15,92
"76694",2019,0,142,83,225
"76695",2016,0,13,0,13
"76695",2017,0,77,0,77
"76695",2019,0,142,114,256
"76697",2016,0,13,13,26
"76697",2017,0,215,15,230
"76697",2019,0,133,28,161
"76698",2016,0,13,13,26
"76698",2017,0,215,15,230
"76698",2019,0,133,28,161
"76699",2016,0,13,13,26
"76699",2017,0,77,15,92
"76699",2019,0,142,83,225
"76700",2016,0,13,13,26
"76700",2017,0,215,15,230
"76700",2019,0,133,28,161
"76702",2016,0,13,122,135
"76702",2017,0,15,63,78
"76702",2019,0,28,28,56
"76703",2016,0,13,0,13
"76703",2017,0,15,0,15
"76703",2019,0,0,70,70
"76705",2016,0,13,0,13
"76705",2017,0,74,15,89
"76705",2019,0,142,114,256
"76706",2016,0,13,118,131
"76706",2017,0,92,0,92
"76706",2019,0,142,114,256
"76707",2016,0,13,13,26
"76707",2017,0,215,15,230
"76707",2019,0,133,28,161
"76708",2016,0,13,0,13
"76708",2017,0,77,0,77
"76708",2019,0,142,114,256
"76709",2016,0,13,122,135
"76709",2017,0,15,63,78
"76709",2019,0,28,28,56
"76710",2016,0,13,0,13
"76710",2017,0,77,0,77
"76710",2019,0,142,114,256
"76711",2016,0,13,0,13
"76711",2017,0,15,0,15
"76711",2019,0,0,59,59
"76712",2016,0,13,118,131
"76712",2017,0,161,0,161
"76712",2019,0,28,0,28
"76714",2016,0,13,118,131
"76714",2017,0,161,0,161
"76714",2019,0,28,0,28
"76715",2016,0,13,118,131
"76715",2017,0,30,15,45
"76715",2019,0,28,28,56
"76716",2016,0,13,118,131
"76716",2017,0,161,0,161
"76716",2019,0,28,0,28
"76717",2016,0,13,0,13
"76717",2017,0,74,15,89
"76717",2019,0,142,114,256
"76718",2016,0,13,122,135
"76718",2017,0,15,15,30
"76718",2019,0,28,28,56
"76719",2016,0,13,0,13
"76719",2017,0,77,0,77
"76719",2019,0,142,114,256
"76720",2016,0,13,13,26
"76720",2017,0,215,15,230
"76720",2019,0,133,28,161
"76721",2016,0,13,13,26
"76721",2017,0,215,15,230
"76721",2019,0,142,83,225
"76723",2016,0,13,13,26
"76723",2017,0,215,15,230
"76723",2019,0,133,28,161
"76724",2016,0,13,0,13
"76724",2017,0,15,0,15
"76724",2019,0,0,70,70
"76725",2016,0,13,118,131
"76725",2017,0,92,0,92
"76725",2019,0,142,114,256
"76726",2016,0,13,118,131
"76726",2017,0,161,0,161
"76726",2019,0,28,0,28
"76727",2016,0,13,118,131
"76727",2017,0,30,15,45
"76727",2019,0,28,28,56
"76728",2016,0,13,122,135
"76728",2017,0,15,63,78
"76728",2019,0,28,28,56
"76730",2016,0,13,0,13
"76730",2017,0,77,0,77
"76730",2019,0,142,114,256
"76731",2016,0,13,13,26
"76731",2017,0,77,15,92
"76731",2019,0,142,83,225
"76732",2016,0,13,0,13
"76732",2017,0,77,0,77
"76732",2019,0,142,114,256
"76733",2016,0,13,13,26
"76733",2017,0,21,15,36
"76733",2019,0,66,39,105
"76734",2016,0,13,118,131
"76734",2017,0,161,0,161
"76734",2019,0,28,0,28
"76735",2016,0,13,0,13
"76735",2017,0,77,0,77
"76735",2019,0,142,114,256
"76736",2016,0,13,0,13
"76736",2017,0,77,0,77
"76736",2019,0,142,114,256
"76737",2016,0,13,13,26
"76737",2017,0,77,15,92
"76737",2019,0,142,83,225
"76738",2016,0,13,0,13
"76738",2017,0,246,15,261
"76738",2019,0,142,142,284
"76739",2016,0,13,0,13
"76739",2017,0,15,0,15
"76739",2019,0,67,28,95
"76740",2016,0,13,0,13
"76740",2017,0,246,15,261
"76740",2019,0,142,142,284
"76741",2016,0,13,118,131
"76741",2017,0,161,0,161
"76741",2019,0,28,0,28
"76743",2016,0,13,122,135
"76743",2017,0,15,63,78
"76743",2019,0,28,28,56
"76744",2016,0,13,0,13
"76744",2017,0,15,0,15
"76744",2019,0,0,70,70
"76745",2016,0,13,0,13
"76745",2017,0,15,0,15
"76745",2019,0,0,59,59
"76746",2016,0,13,0,13
"76746",2017,0,77,0,77
"76746",2019,0,142,114,256
"76747",2016,0,13,118,131
"76747",2017,0,161,0,161
"76747",2019,0,28,0,28
"76748",2016,0,13,0,13
"76748",2017,0,77,0,77
"76748",2019,0,142,114,256
"76749",2016,0,13,0,13
"76749",2017,0,15,0,15
"76749",2019,0,0,70,70
"76750",2016,0,13,122,135
"76750",2017,0,15,63,78
"76750",2019,0,28,28,56
"76751",2016,0,13,0,13
"76751",2017,0,77,0,77
"76751",2019,0,142,114,256
"76752",2016,0,13,122,135
"76752",2017,0,15,15,30
"76752",2019,0,28,28,56
"76753",2016,0,13,0,13
"76753",2017,0,74,15,89
"76753",2019,0,142,114,256
"76754",2016,0,13,118,131
"76754",2017,0,161,0,161
"76754",2019,0,28,0,28
"76755",2016,0,13,0,13
"76755",2017,0,77,0,77
"76755",2019,0,142,114,256
"76756",2016,0,13,13,26
"76756",2017,0,215,15,230
"76756",2019,0,142,83,225
"76757",2016,0,13,0,13
"76757",2017,0,77,0,77
"76757",2019,0,142,114,256
"76758",2016,0,13,122,135
"76758",2017,0,15,15,30
"76758",2019,0,28,28,56
"76759",2016,0,13,122,135
"76759",2017,0,15,63,78
"76759",2019,0,28,28,56
"77001",2019,0,0,49,49
"77001",2020,0,0,85,85
"77002",2013,0,62,0,62
"77002",2015,0,0,68,68
"77002",2017,0,0,33,33
"77002",2018,0,0,114,114
"77002",2019,0,0,51,51
"77002",2020,0,0,98,98
"77004",2013,0,62,0,62
"77004",2017,0,0,13,13
"77004",2018,0,0,140,140
"77004",2019,0,0,137,137
"77004",2020,0,0,20,20
"77005",2017,0,0,36,36
"77005",2019,0,0,4,4
"77005",2020,0,0,14,14
"77006",2019,0,0,49,49
"77006",2020,0,0,85,85
"77007",2013,0,62,0,62
"77008",2017,0,0,36,36
"77008",2019,0,0,4,4
"77008",2020,0,0,14,14
"77009",2015,0,0,6,6
"77010",2013,0,62,0,62
"77010",2017,0,0,13,13
"77010",2018,0,0,140,140
"77010",2019,0,0,137,137
"77010",2020,0,0,20,20
"77012",2015,0,0,68,68
"77012",2017,0,0,33,33
"77012",2018,0,0,114,114
"77012",2019,0,0,51,51
"77012",2020,0,0,98,98
"77013",2015,0,0,68,68
"77013",2017,0,0,33,33
"77013",2018,0,0,114,114
"77013",2019,0,0,51,51
"77013",2020,0,0,98,98
"77014",2013,0,62,0,62
"77014",2019,0,0,49,49
"77014",2020,0,0,93,93
"77015",2020,0,0,8,8
"77016",2019,0,0,49,49
"77016",2020,0,0,85,85
"77018",2013,0,62,0,62
"77018",2015,0,0,68,68
"77018",2017,0,0,33,33
"77018",2018,0,0,114,114
"77018",2019,0,0,51,51
"77018",2020,0,0,98,98
"77019",2020,0,0,8,8
"77020",2015,0,0,68,68
"77020",2017,0,0,33,33
"77020",2018,0,0,114,114
"77020",2019,0,0,51,51
"77020",2020,0,0,98,98
"77021",2019,0,0,78,78
"77021",2020,0,0,85,85
"77022",2019,0,0,49,49
"77022",2020,0,0,85,85
"77023",2015,0,0,28,28
"77023",2018,0,0,128,128
"77023",2019,0,0,110,110
"77023",2020,0,0,79,79
"77024",2015,0,0,58,58
"77024",2017,0,0,78,78
"77024",2019,0,0,28,28
"77024",2020,0,0,13,13
"77025",2020,0,0,8,8
"77029",2013,0,62,0,62
"77030",2015,0,0,58,58
"77030",2017,0,0,78,78
"77030",2018,0,0,50,50
"77030",2019,0,0,17,17
"77030",2020,0,0,13,13
"77031",2013,0,62,0,62
"77032",2015,0,0,68,68
"77032",2017,0,0,33,33
"77032",2018,0,0,114,114
"77032",2019,0,0,51,51
"77032",2020,0,0,98,98
"77033",2015,0,0,68,68
"77033",2017,0,0,33,33
"77033",2018,0,0,114,114
"77033",2019,0,0,51,51
"77033",2020,0,0,98,98
"77034",2013,0,62,0,62
"77034",2017,0,0,13,13
"77034",2018,0,0,140,140
"77034",2019,0,0,137,137
"77034",2020,0,0,20,20
"77035",2015,0,0,117,117
"77035",2017,0,0,34,34
"77035",2018,0,0,114,114
"77035",2019,0,0,32,32
"77035",2020,0,0,6,6
"77036",2013,0,62,0,62
"77036",2015,0,0,68,68
"77036",2017,0,0,33,33
"77036",2018,0,0,114,114
"77036",2019,0,0,51,51
"77036",2020,0,0,98,98
"77037",2013,0,62,0,62
"77037",2019,0,0,49,49
"77037",2020,0,0,93,93
"77038",2013,0,62,0,62
"77038",2020,0,0,8,8
"77039",2013,0,62,0,62
"77039",2017,0,0,13,13
"77039",2018,0,0,140,140
"77039",2019,0,0,137,137
"77039",2020,0,0,28,28
"77040",2013,0,62,0,62
"77040",2020,0,0,8,8
"77042",2015,0,0,68,68
"77042",2017,0,0,33,33
"77042",2018,0,0,114,114
"77042",2019,0,0,51,51
"77042",2020,0,0,98,98
"77043",2015,0,0,58,58
"77043",2017,0,0,78,78
"77043",2019,0,0,28,28
"77043",2020,0,0,13,13
"77044",2013,0,62,0,62
"77044",2017,0,0,13,13
"77044",2018,0,0,140,140
"77044",2019,0,0,137,137
"77044",2020,0,0,20,20
"77046",2015,0,0,123,123
"77046",2020,0,0,79,79
"77047",2015,0,0,68,68
"77047",2017,0,0,33,33
"77047",2018,0,0,114,114
"77047",2019,0,0,51,51
"77047",2020,0,0,98,98
"77048",2019,0,0,49,49
"77048",2020,0,0,85,85
"77049",2015,0,0,68,68
"77049",2017,0,0,49,49
"77049",2018,0,0,114,114
"77049",2019,0,0,51,51
"77049",2020,0,0,98,98
"77050",2019,0,0,49,49
"77050",2020,0,0,85,85
"77051",2020,0,0,8,8
"77052",2013,0,62,0,62
"77052",2017,0,0,13,13
"77052",2018,0,0,140,140
"77052",2019,0,0,137,137
"77052",2020,0,0,20,20
"77053",2013,0,62,0,62
"77053",2015,0,0,52,52
"77053",2017,0,0,29,29
"77053",2019,0,0,39,39
"77054",2015,0,0,117,117
"77054",2017,0,0,34,34
"77054",2018,0,0,114,114
"77054",2019,0,0,13,13
"77054",2020,0,0,6,6
"77055",2017,0,0,36,36
"77055",2019,0,0,4,4
"77055",2020,0,0,14,14
"77056",2015,0,0,123,123
"77056",2019,0,0,49,49
"77056",2020,0,0,85,85
"77057",2015,0,0,58,58
"77057",2017,0,0,78,78
"77057",2019,0,0,32,32
"77057",2020,0,0,13,13
"77058",2013,0,62,0,62
"77058",2017,0,0,36,36
"77058",2019,0,0,4,4
"77058",2020,0,0,14,14
"77059",2017,0,0,36,36
"77059",2019,0,0,4,4
"77059",2020,0,0,14,14
"77060",2015,0,0,123,123
"77060",2020,0,0,79,79
"77061",2013,0,62,0,62
"77061",2015,0,0,117,117
"77061",2017,0,0,34,34
"77061",2018,0,0,114,114
"77061",2019,0,0,13,13
"77061",2020,0,0,6,6
"77062",2017,0,0,36,36
"77062",2019,0,0,4,4
"77062",2020,0,0,14,14
"77063",2013,0,62,0,62
"77063",2015,0,0,68,68
"77063",2017,0,0,33,33
"77063",2018,0,0,114,114
"77063",2019,0,0,51,51
"77063",2020,0,0,98,98
"77066",2015,0,0,68,68
"77066",2017,0,0,33,33
"77066",2018,0,0,114,114
"77066",2019,0,0,51,51
"77066",2020,0,0,98,98
"77067",2013,0,62,0,62
"77067",2017,0,0,13,13
"77067",2018,0,0,140,140
"77067",2019,0,0,137,137
"77067",2020,0,0,28,28
"77069",2019,0,0,49,49
"77069",2020,0,0,85,85
"77070",2015,0,0,68,68
"77070",2017,0,0,33,33
"77070",2018,0,0,114,114
"77070",2019,0,0,51,51
"77070",2020,0,0,98,98
"77071",2017,0,0,34,34
"77071",2019,0,0,115,115
"77071",2020,0,0,85,85
"77075",2015,0,0,68,68
"77075",2017,0,0,49,49
"77075",2018,0,0,114,114
"77075",2019,0,0,51,51
"77075",2020,0,0,98,98
"77077",2015,0,0,28,28
"77077",2018,0,0,128,128
"77077",2019,0,0,110,110
"77077",2020,0,0,79,79
"77078",2015,0,0,58,58
"77078",2017,0,0,78,78
"77078",2019,0,0,32,32
"77078",2020,0,0,13,13
"77079",2013,0,62,0,62
"77079",2019,0,0,49,49
"77079",2020,0,0,93,93
"77080",2015,0,0,68,68
"77080",2017,0,0,33,33
"77080",2018,0,0,114,114
"77080",2019,0,0,51,51
"77080",2020,0,0,98,98
"77081",2013,0,62,0,62
"77081",2017,0,0,13,13
"77081",2018,0,0,140,140
"77081",2019,0,0,137,137
"77081",2020,0,0,20,20
"77082",2013,0,62,0,62
"77082",2017,0,0,13,13
"77082",2018,0,0,140,140
"77082",2019,0,0,137,137
"77082",2020,0,0,20,20
"77083",2017,0,0,36,36
"77083",2019,0,0,4,4
"77083",2020,0,0,14,14
"77084",2017,0,0,36,36
"77084",2019,0,0,4,4
"77084",2020,0,0,14,14
"77085",2013,0,62,0,62
"77085",2017,0,0,36,36
"77085",2019,0,0,4,4
"77085",2020,0,0,14,14
"77086",2013,0,62,0,62
"77086",2017,0,0,13,13
"77086",2018,0,0,140,140
"77086",2019,0,0,137,137
"77086",2020,0,0,28,28
"77087",2013,0,62,0,62
"77089",2013,0,62,0,62
"77089",2017,0,0,13,13
"77089",2018,0,0,140,140
"77089",2019,0,0,137,137
"77089",2020,0,0,28,28
"77091",2013,0,62,0,62
"77093",2015,0,0,68,68
"77093",2017,0,0,33,33
"77093",2018,0,0,114,114
"77093",2019,0,0,51,51
"77093",2020,0,0,98,98
"77094",2017,0,0,36,36
"77094",2019,0,0,4,4
"77094",2020,0,0,14,14
"77095",2017,0,0,36,36
"77095",2019,0,0,4,4
"77095",2020,0,0,14,14
"77096",2013,0,62,0,62
"77096",2017,0,0,13,13
"77096",2018,0,0,140,140
"77096",2019,0,0,137,137
"77096",2020,0,0,28,28
"77097",2015,0,0,68,68
"77097",2017,0,0,33,33
"77097",2018,0,0,114,114
"77097",2019,0,0,51,51
"77097",2020,0,0,98,98
"77098",2013,0,62,0,62
"77100",2013,0,62,0,62
"77100",2017,0,0,13,13
"77100",2018,0,0,140,140
"77100",2019,0,0,137,137
"77100",2020,0,0,28,28
"77101",2013,0,62,0,62
"77102",2019,0,0,49,49
"77102",2020,0,0,85,85
"77103",2013,0,62,0,62
"77103",2017,0,0,13,13
"77103",2018,0,0,140,140
"77103",2019,0,0,137,137
"77103",2020,0,0,20,20
"77104",2013,0,62,0,62
"77106",2015,0,0,68,68
"77106",2017,0,0,33,33
"77106",2018,0,0,114,114
"77106",2019,0,0,51,51
"77106",2020,0,0,98,98
"77107",2013,0,62,0,62
"77108",2017,0,0,36,36
"77108",2019,0,0,4,4
"77108",2020,0,0,14,14
"77111",2013,0,62,0,62
"77111",2015,0,0,68,68
"77111",2017,0,0,49,49
"77111",2018,0,0,114,114
"77111",2019,0,0,51,51
"77111",2020,0,0,98,98
"77112",2019,0,0,49,49
"77112",2020,0,0,85,85
"77113",2015,0,0,68,68
"77113",2017,0,0,33,33
"77113",2018,0,0,114,114
"77113",2019,0,0,51,51
"77113",2020,0,0,98,98
"77114",2013,0,62,0,62
"77114",2015,0,0,52,52
"77114",2017,0,0,29,29
"77114",2019,0,0,39,39
"77115",2015,0,0,117,117
"77115",2017,0,0,34,34
"77115",2018,0,0,114,114
"77115",2019,0,0,32,32
"77115",2020,0,0,6,6
"77116",2015,0,0,68,68
"77116",2017,0,0,33,33
"77116",2018,0,0,114,114
"77116",2019,0,0,51,51
"77116",2020,0,0,98,98
"77117",2015,0,0,58,58
"77117",2017,0,0,78,78
"77117",2019,0,0,32,32
"77117",2020,0,0,13,13
"77118",2020,0,0,14,14
"77119",2013,0,62,0,62
"77119",2017,0,0,13,13
"77119",2018,0,0,140,140
"77119",2019,0,0,137,137
"77119",2020,0,0,20,20
"77120",2017,0,0,36,36
"77120",2019,0,0,4,4
"77120",2020,0,0,14,14
"77121",2013,0,62,0,62
"77121",2017,0,0,36,36
"77121",2019,0,0,4,4
"77121",2020,0,0,14,14
"77122",2013,0,62,0,62
"77122",2020,0,0,8,8
"77123",2020,0,0,14,14
"77124",2017,0,0,36,36
"77124",2019,0,0,4,4
"77124",2020,0,0,14,14
"77125",2015,0,0,68,68
"77125",2017,0,0,49,49
"77125",2018,0,0,114,114
"77125",2019,0,0,51,51
"77125",2020,0,0,98,98
"77126",2015,0,0,28,28
"77126",2018,0,0,128,128
"77126",2019,0,0,110,110
"77126",2020,0,0,79,79
"77127",2013,0,62,0,62
"77128",2015,0,0,68,68
"77128",2017,0,0,33,33
"77128",2018,0,0,114,114
"77128",2019,0,0,51,51
"77128",2020,0,0,98,98
"77129",2020,0,0,14,14
"77130",2015,0,0,68,68
"77130",2017,0,0,33,33
"77130",2018,0,0,114,114
"77130",2019,0,0,51,51
"77130",2020,0,0,98,98
"77131",2015,0,0,68,68
"77131",2017,0,0,33,33
"77131",2018,0,0,114,114
"77131",2019,0,0,51,51
"77131",2020,0,0,98,98
"77132",2013,0,62,0,62
"77132",2015,0,0,68,68
"77132",2017,0,0,49,49
"77132",2018,0,0,114,114
"77132",2019,0,0,51,51
"77132",2020,0,0,98,98
"77133",2013,0,62,0,62
"77133",2020,0,0,8,8
"77134",2015,0,0,68,68
"77134",2017,0,0,33,33
"77134",2018,0,0,114,114
"77134",2019,0,0,51,51
"77134",2020,0,0,98,98
"77135",2013,0,62,0,62
"77136",2013,0,62,0,62
"77137",2015,0,0,68,68
"77137",2017,0,0,33,33
"77137",2018,0,0,114,114
"77137",2019,0,0,51,51
"77137",2020,0,0,98,98
"77138",2013,0,62,0,62
"77139",2017,0,0,36,36
"77139",2019,0,0,4,4
"77139",2020,0,0,14,14
"77140",2013,0,62,0,62
"77140",2017,0,0,13,13
"77140",2018,0,0,140,140
"77140",2019,0,0,137,137
"77140",2020,0,0,28,28
"77141",2013,0,62,0,62
"77141",2015,0,0,68,68
"77141",2017,0,0,33,33
"77141",2018,0,0,114,114
"77141",2019,0,0,51,51
"77141",2020,0,0,98,98
"77142",2015,0,0,68,68
"77142",2017,0,0,33,33
"77142",2018,0,0,114,114
"77142",2019,0,0,51,51
"77142",2020,0,0,98,98
"77143",2017,0,0,36,36
"77143",2019,0,0,4,4
"77143",2020,0,0,14,14
"77144",2013,0,62,0,62
"77144",2015,0,0,68,68
"77144",2017,0,0,33,33
"77144",2018,0,0,114,114
"77144",2019,0,0,51,51
"77144",2020,0,0,98,98
"77145",2013,0,62,0,62
"77145",2017,0,0,13,13
"77145",2018,0,0,140,140
"77145",2019,0,0,137,137
"77145",2020,0,0,20,20
"77146",2013,0,62,0,62
"77146",2017,0,0,36,36
"77146",2019,0,0,4,4
"77146",2020,0,0,14,14
"77147",2013,0,62,0,62
"77147",2017,0,0,13,13
"77147",2018,0,0,140,140
"77147",2019,0,0,137,137
"77147",2020,0,0,20,20
"77148",2020,0,0,14,14
"77150",2015,0,0,28,28
"77150",2018,0,0,128,128
"77150",2019,0,0,106,106
"77150",2020,0,0,79,79
"77151",2013,0,62,0,62
"77151",2015,0,0,68,68
"77151",2017,0,0,33,33
"77151",2018,0,0,114,114
"77151",2019,0,0,51,51
"77151",2020,0,0,98,98
"77152",2013,0,62,0,62
"77152",2017,0,0,13,13
"77152",2018,0,0,140,140
"77152",2019,0,0,115,115
"77152",2020,0,0,28,28
"77153",2020,0,0,14,14
"77154",2013,0,62,0,62
"77154",2015,0,0,68,68
"77154",2017,0,0,33,33
"77154",2018,0,0,114,114
"77154",2019,0,0,51,51
"77154",2020,0,0,98,98
"77155",2017,0,0,36,36
"77155",2019,0,0,4,4
"77155",2020,0,0,14,14
"77156",2017,0,0,34,34
"77156",2019,0,0,115,115
"77156",2020,0,0,85,85
"77157",2017,0,0,36,36
"77157",2019,0,0,4,4
"77157",2020,0,0,14,14
"77158",2015,0,0,117,117
"77158",2017,0,0,34,34
"77158",2018,0,0,114,114
"77158",2019,0,0,32,32
"77158",2020,0,0,6,6
"77161",2015,0,0,117,117
"77161",2017,0,0,34,34
"77161",2018,0,0,114,114
"77161",2019,0,0,32,32
"77161",2020,0,0,6,6
"77162",2015,0,0,58,58
"77162",2017,0,0,78,78
"77162",2018,0,0,50,50
"77162",2019,0,0,17,17
"77162",2020,0,0,13,13
"77163",2015,0,0,28,28
"77163",2018,0,0,128,128
"77163",2019,0,0,106,106
"77163",2020,0,0,79,79
"77164",2013,0,62,0,62
"77164",2017,0,0,13,13
"77164",2018,0,0,140,140
"77164",2019,0,0,137,137
"77164",2020,0,0,28,28
"77165",2013,0,62,0,62
"77165",2017,0,0,13,13
"77165",2018,0,0,140,140
"77165",2019,0,0,137,137
"77165",2020,0,0,28,28
"77168",2017,0,0,34,34
"77168",2019,0,0,115,115
"77168",2020,0,0,85,85
"77169",2013,0,62,0,62
"77169",2015,0,0,52,52
"77169",2017,0,0,29,29
"77169",2019,0,0,39,39
"77171",2015,0,0,68,68
"77171",2017,0,0,49,49
"77171",2018,0,0,114,114
"77171",2019,0,0,51,51
"77171",2020,0,0,98,98
"77172",2015,0,0,117,117
"77172",2017,0,0,34,34
"77172",2018,0,0,114,114
"77172",2019,0,0,13,13
"77172",2020,0,0,6,6
"77173",2015,0,0,28,28
"77173",2018,0,0,128,128
"77173",2019,0,0,110,110
"77173",2020,0,0,79,79
"77174",2020,0,0,8,8
"77175",2013,0,62,0,62
"77175",2020,0,0,8,8
"77176",2013,0,62,0,62
"77176",2015,0,0,68,68
"77176",2017,0,0,33,33
"77176",2018,0,0,114,114
"77176",2019,0,0,51,51
"77176",2020,0,0,98,98
"77177",2013,0,62,0,62
"77177",2017,0,0,36,36
"77177",2019,0,0,4,4
"77177",2020,0,0,14,14
"77178",2019,0,0,49,49
"77178",2020,0,0,85,85
"77179",2013,0,62,0,62
"77179",2020,0,0,8,8
"77180",2013,0,62,0,62
"77180",2015,0,0,52,52
"77180",2017,0,0,29,29
"77180",2019,0,0,39,39
"77181",2013,0,62,0,62
"77181",2017,0,0,36,36
"77181",2019,0,0,4,4
"77181",2020,0,0,14,14
"77182",2015,0,0,68,68
"77182",2017,0,0,33,33
"77182",2018,0,0,114,114
"77182",2019,0,0,51,51
"77182",2020,0,0,98,98
"77183",2015,0,0,58,58
"77183",2017,0,0,78,78
"77183",2019,0,0,32,32
"77183",2020,0,0,13,13
"77184",2015,0,0,117,117
"77184",2017,0,0,34,34
"77184",2018,0,0,114,114
"77184",2019,0,0,32,32
"77184",2020,0,0,6,6
"77186",2013,0,62,0,62
"77186",2019,0,0,49,49
"77186",2020,0,0,93,93
"77187",2020,0,0,8,8
"77188",2013,0,62,0,62
"77188",2017,0,0,13,13
"77188",2018,0,0,140,140
"77188",2019,0,0,137,137
"77188",2020,0,0,28,28
"77190",2013,0,62,0,62
"77190",2017,0,0,13,13
"77190",2018,0,0,140,140
"77190",2019,0,0,137,137
"77190",2020,0,0,20,20
"77191",2013,0,62,0,62
"77191",2017,0,0,13,13
"77191",2018,0,0,140,140
"77191",2019,0,0,137,137
"77191",2020,0,0,20,20
"77192",2013,0,62,0,62
"77193",2015,0,0,28,28
"77193",2018,0,0,128,128
"77193",2019,0,0,106,106
"77193",2020,0,0,79,79
"77194",2013,0,62,0,62
"77194",2017,0,0,13,13
"77194",2018,0,0,140,140
"77194",2019,0,0,110,110
"77194",2020,0,0,28,28
"77195",2013,0,62,0,62
"77195",2017,0,0,13,13
"77195",2018,0,0,140,140
"77195",2019,0,0,137,137
"77195",2020,0,0,20,20
"77196",2017,0,0,36,36
"77196",2019,0,0,4,4
"77196",2020,0,0,14,14
"77197",2013,0,62,0,62
"77197",2015,0,0,68,68
"77197",2017,0,0,33,33
"77197",2018,0,0,114,114
"77197",2019,0,0,51,51
"77197",2020,0,0,98,98
"77198",2015,0,0,123,123
"77198",2020,0,0,79,79
"77199",2015,0,0,68,68
"77199",2017,0,0,49,49
"77199",2018,0,0,114,114
"77199",2019,0,0,51,51
"77199",2020,0,0,98,98
"77200",2019,0,0,49,49
"77200",2020,0,0,85,85
"77201",2013,0,62,0,62
"77202",2017,0,0,34,34
"77202",2019,0,0,115,115
"77202",2020,0,0,85,85
"77203",2015,0,0,28,28
"77203",2018,0,0,128,128
"77203",2019,0,0,110,110
"77203",2020,0,0,79,79
"77204",2020,0,0,14,14
"77205",2015,0,0,28,28
"77205",2018,0,0,128,128
"77205",2019,0,0,106,106
"77205",2020,0,0,79,79
"77206",2015,0,0,68,68
"77206",2017,0,0,33,33
"77206",2018,0,0,114,114
"77206",2019,0,0,51,51
"77206",2020,0,0,98,98
"77207",2015,0,0,6,6
"77209",2020,0,0,14,14
"77210",2013,0,62,0,62
"77210",2015,0,0,117,117
"77210",2017,0,0,34,34
"77210",2018,0,0,114,114
"77210",2019,0,0,13,13
"77210",2020,0,0,14,14
"77211",2013,0,62,0,62
"77211",2017,0,0,13,13
"77211",2018,0,0,140,140
"77211",2019,0,0,137,137
"77211",2020,0,0,20,20
"77212",2019,0,0,78,78
"77212",2020,0,0,85,85
"77214",2020,0,0,14,14
"77215",2013,0,62,0,62
"77215",2015,0,0,52,52
"77215",2017,0,0,29,29
"77215",2019,0,0,39,39
"77216",2019,0,0,49,49
"77216",2020,0,0,85,85
"77217",2013,0,62,0,62
"77218",2020,0,0,8,8
"77219",2013,0,62,0,62
"77219",2015,0,0,68,68
"77219",2017,0,0,33,33
"77219",2018,0,0,114,114
"77219",2019,0,0,51,51
"77219",2020,0,0,98,98
"77220",2019,0,0,49,49
"77220",2020,0,0,85,85
"77221",2020,0,0,14,14
"77222",2013,0,62,0,62
"77223",2017,0,0,13,13
"77223",2018,0,0,140,140
"77223",2019,0,0,137,137
"77223",2020,0,0,20,20
"77224",2013,0,62,0,62
"77224",2015,0,0,68,68
"77224",2017,0,0,33,33
"77224",2018,0,0,114,114
"77224",2019,0,0,51,51
"77224",2020,0,0,98,98
"77225",2015,0,0,68,68
"77225",2017,0,0,33,33
"77225",2018,0,0,114,114
"77225",2019,0,0,51,51
"77225",2020,0,0,98,98
"77226",2013,0,62,0,62
"77226",2020,0,0,8,8
"77227",2020,0,0,8,8
"77228",2015,0,0,58,58
"77228",2017,0,0,78,78
"77228",2019,0,0,28,28
"77228",2020,0,0,13,13
"77229",2013,0,62,0,62
"77229",2015,0,0,68,68
"77229",2017,0,0,33,33
"77229",2018,0,0,114,114
"77229",2019,0,0,51,51
"77229",2020,0,0,98,98
"77230",2015,0,0,123,123
"77230",2019,0,0,49,49
"77230",2020,0,0,85,85
"77231",2015,0,0,28,28
"77231",2018,0,0,128,128
"77231",2019,0,0,110,110
"77231",2020,0,0,79,79
"77232",2015,0,0,68,68
"77232",2017,0,0,49,49
"77232",2018,0,0,114,114
"77232",2019,0,0,51,51
"77232",2020,0,0,98,98
"77233",2017,0,0,36,36
"77233",2019,0,0,4,4
"77233",2020,0,0,14,14
"77234",2017,0,0,36,36
"77234",2019,0,0,4,4
"77234",2020,0,0,14,14
"77235",2017,0,0,36,36
"77235",2019,0,0,4,4
"77235",2020,0,0,14,14
"77236",2020,0,0,8,8
"77237",2013,0,62,0,62
"77237",2017,0,0,36,36
"77237",2019,0,0,4,4
"77237",2020,0,0,14,14
"77238",2015,0,0,58,58
"77238",2017,0,0,78,78
"77238",2018,0,0,50,50
"77238",2019,0,0,17,17
"77238",2020,0,0,13,13
"77239",2013,0,62,0,62
"77239",2015,0,0,68,68
"77239",2017,0,0,33,33
"77239",2018,0,0,114,114
"77239",2019,0,0,51,51
"77239",2020,0,0,98,98
"77240",2015,0,0,68,68
"77240",2017,0,0,33,33
"77240",2018,0,0,114,114
"77240",2019,0,0,51,51
"77240",2020,0,0,98,98
"77241",2020,0,0,14,14
"77243",2017,0,0,36,36
"77243",2019,0,0,4,4
"77243",2020,0,0,14,14
"77244",2019,0,0,49,49
"77244",2020,0,0,85,85
"77245",2013,0,62,0,62
"77245",2017,0,0,13,13
"77245",2018,0,0,140,140
"77245",2019,0,0,137,137
"77245",2020,0,0,28,28
"77247",2015,0,0,68,68
"77247",2017,0,0,33,33
"77247",2018,0,0,114,114
"77247",2019,0,0,51,51
"77247",2020,0,0,98,98
"77248",2015,0,0,68,68
"77248",2017,0,0,49,49
"77248",2018,0,0,114,114
"77248",2019,0,0,51,51
"77248",2020,0,0,98,98
"77249",2013,0,62,0,62
"77249",2015,0,0,52,52
"77249",2017,0,0,29,29
"77249",2019,0,0,39,39
"77250",2015,0,0,68,68
"77250",2017,0,0,33,33
"77250",2018,0,0,114,114
"77250",2019,0,0,51,51
"77250",2020,0,0,98,98
"77251",2013,0,62,0,62
"77251",2020,0,0,8,8
"77252",2013,0,62,0,62
"77252",2017,0,0,13,13
"77252",2018,0,0,140,140
"77252",2019,0,0,137,137
"77252",2020,0,0,28,28
"77253",2013,0,62,0,62
"77253",2017,0,0,13,13
"77253",2018,0,0,140,140
"77253",2019,0,0,137,137
"77253",2020,0,0,28,28
"77254",2013,0,62,0,62
"77255",2013,0,62,0,62
"77255",2020,0,0,8,8
"77257",2015,0,0,28,28
"77257",2018,0,0,128,128
"77257",2019,0,0,106,106
"77257",2020,0,0,79,79
"77258",2017,0,0,36,36
"77258",2019,0,0,4,4
"77258",2020,0,0,14,14
"77259",2020,0,0,14,14
"77261",2015,0,0,117,117
"77261",2017,0,0,34,34
"77261",2018,0,0,114,114
"77261",2019,0,0,32,32
"77261",2020,0,0,6,6
"77264",2013,0,62,0,62
"77264",2015,0,0,68,68
"77264",2017,0,0,33,33
"77264",2018,0,0,114,114
"77264",2019,0,0,51,51
"77264",2020,0,0,98,98
"77265",2015,0,0,58,58
"77265",2017,0,0,78,78
"77265",2019,0,0,32,32
"77265",2020,0,0,13,13
"77266",2013,0,62,0,62
"77266",2020,0,0,8,8
"77267",2019,0,0,49,49
"77267",2020,0,0,85,85
"77268",2013,0,62,0,62
"77268",2015,0,0,68,68
"77268",2017,0,0,33,33
"77268",2018,0,0,114,114
"77268",2019,0,0,51,51
"77268",2020,0,0,98,98
"77269",2013,0,62,0,62
"77269",2017,0,0,13,13
"77269",2018,0,0,140,140
"77269",2019,0,0,137,137
"77269",2020,0,0,28,28
"77270",2015,0,0,68,68
"77270",2017,0,0,33,33
"77270",2018,0,0,114,114
"77270",2019,0,0,51,51
"77270",2020,0,0,98,98
"77273",2015,0,0,28,28
"77273",2018,0,0,128,128
"77273",2019,0,0,106,106
"77273",2020,0,0,79,79
"77274",2015,0,0,28,28
"77274",2018,0,0,128,128
"77274",2019,0,0,106,106
"77274",2020,0,0,79,79
"77275",2015,0,0,68,68
"77275",2017,0,0,33,33
"77275",2018,0,0,114,114
"77275",2019,0,0,51,51
"77275",2020,0,0,98,98
"77276",2015,0,0,68,68
"77276",2017,0,0,49,49
"77276",2018,0,0,114,114
"77276",2019,0,0,51,51
"77276",2020,0,0,98,98
"77277",2013,0,62,0,62
"77278",2015,0,0,68,68
"77278",2017,0,0,33,33
"77278",2018,0,0,114,114
"77278",2019,0,0,51,51
"77278",2020,0,0,98,98
"77279",2013,0,62,0,62
"77279",2019,0,0,78,78
"77279",2020,0,0,93,93
"77280",2015,0,0,28,28
"77280",2018,0,0,128,128
"77280",2019,0,0,110,110
"77280",2020,0,0,79,79
"77281",2015,0,0,68,68
"77281",2017,0,0,33,33
"77281",2018,0,0,114,114
"77281",2019,0,0,51,51
"77281",2020,0,0,98,98
"77282",2020,0,0,14,14
"77283",2015,0,0,28,28
"77283",2018,0,0,128,128
"77283",2019,0,0,106,106
"77283",2020,0,0,79,79
"77284",2017,0,0,36,36
"77284",2019,0,0,4,4
"77284",2020,0,0,14,14
"77285",2013,0,62,0,62
"77285",2017,0,0,13,13
"77285",2018,0,0,140,140
"77285",2019,0,0,137,137
"77285",2020,0,0,28,28
"77286",2017,0,0,13,13
"77286",2018,0,0,140,140
"77286",2019,0,0,137,137
"77286",2020,0,0,20,20
"77287",2015,0,0,68,68
"77287",2017,0,0,33,33
"77287",2018,0,0,114,114
"77287",2019,0,0,51,51
"77287",2020,0,0,98,98
"77288",2013,0,62,0,62
"77288",2017,0,0,13,13
"77288",2018,0,0,140,140
"77288",2019,0,0,137,137
"77288",2020,0,0,28,28
"77289",2020,0,0,8,8
"77290",2015,0,0,58,58
"77290",2017,0,0,78,78
"77290",2019,0,0,32,32
"77290",2020,0,0,13,13
"77291",2020,0,0,14,14
"77292",2020,0,0,14,14
"77293",2019,0,0,78,78
"77293",2020,0,0,85,85
"77294",2020,0,0,14,14
"77295",2013,0,62,0,62
"77295",2017,0,0,13,13
"77295",2018,0,0,140,140
"77295",2019,0,0,137,137
"77295",2020,0,0,20,20
"77296",2013,0,62,0,62
"77296",2020,0,0,8,8
"77297",2015,0,0,6,6
"77300",2015,0,0,68,68
"77300",2017,0,0,49,49
"77300",2018,0,0,114,114
"77300",2019,0,0,51,51
"77300",2020,0,0,98,98
"77301",2015,0,0,68,68
"77301",2017,0,0,33,33
"77301",2018,0,0,114,114
"77301",2019,0,0,51,51
"77301",2020,0,0,98,98
"77302",2017,0,0,34,34
"77302",2019,0,0,115,115
"77302",2020,0,0,85,85
"77303",2015,0,0,58,58
"77303",2017,0,0,78,78
"77303",2019,0,0,28,28
"77303",2020,0,0,13,13
"77304",2015,0,0,58,58
"77304",2017,0,0,78,78
"77304",2019,0,0,28,28
"77304",2020,0,0,13,13
"77305",2013,0,62,0,62
"77305",2019,0,0,78,78
"77305",2020,0,0,93,93
"77306",2013,0,62,0,62
"77306",2017,0,0,13,13
"77306",2018,0,0,140,140
"77306",2019,0,0,137,137
"77306",2020,0,0,28,28
"77307",2013,0,62,0,62
"77307",2017,0,0,36,36
"77307",2019,0,0,4,4
"77307",2020,0,0,14,14
"77308",2015,0,0,28,28
"77308",2018,0,0,128,128
"77308",2019,0,0,106,106
"77308",2020,0,0,79,79
"77309",2015,0,0,28,28
"77309",2018,0,0,128,128
"77309",2019,0,0,110,110
"77309",2020,0,0,79,79
"77310",2020,0,0,8,8
"77311",2017,0,0,13,13
"77311",2018,0,0,140,140
"77311",2019,0,0,137,137
"77311",2020,0,0,28,28
"77312",2019,0,0,49,49
"77312",2020,0,0,85,85
"77313",2015,0,0,117,117
"77313",2017,0,0,34,34
"77313",2018,0,0,114,114
"77313",2019,0,0,13,13
"77313",2020,0,0,6,6
"77314",2015,0,0,58,58
"77314",2017,0,0,78,78
"77314",2018,0,0,50,50
"77314",2019,0,0,17,17
"77314",2020,0,0,13,13
"77315",2015,0,0,68,68
"77315",2017,0,0,33,33
"77315",2018,0,0,114,114
"77315",2019,0,0,51,51
"77315",2020,0,0,98,98
"77316",2013,0,62,0,62
"77316",2015,0,0,117,117
"77316",2017,0,0,34,34
"77316",2018,0,0,114,114
"77316",2019,0,0,32,32
"77316",2020,0,0,14,14
"77317",2013,0,62,0,62
"77317",2017,0,0,13,13
"77317",2018,0,0,140,140
"77317",2019,0,0,137,137
"77317",2020,0,0,20,20
"77318",2013,0,62,0,62
"77318",2015,0,0,68,68
"77318",2017,0,0,33,33
"77318",2018,0,0,114,114
"77318",2019,0,0,51,51
"77318",2020,0,0,98,98
"77320",2015,0,0,68,68
"77320",2017,0,0,33,33
"77320",2018,0,0,114,114
"77320",2019,0,0,51,51
"77320",2020,0,0,98,98
"77321",2020,0,0,8,8
"77322",2020,0,0,14,14
"77323",2020,0,0,14,14
"77325",2020,0,0,8,8
"77326",2013,0,62,0,62
"77326",2020,0,0,8,8
"77327",2013,0,62,0,62
"77327",2017,0,0,13,13
"77327",2018,0,0,140,140
"77327",2019,0,0,137,137
"77327",2020,0,0,20,20
"77328",2015,0,0,123,123
"77328",2020,0,0,79,79
"77329",2017,0,0,34,34
"77329",2019,0,0,137,137
"77329",2020,0,0,85,85
"77330",2015,0,0,68,68
"77330",2017,0,0,49,49
"77330",2018,0,0,114,114
"77330",2019,0,0,51,51
"77330",2020,0,0,98,98
"77331",2015,0,0,58,58
"77331",2017,0,0,78,78
"77331",2019,0,0,32,32
"77331",2020,0,0,13,13
"77332",2020,0,0,14,14
"77333",2019,0,0,49,49
"77333",2020,0,0,85,85
"77335",2015,0,0,28,28
"77335",2018,0,0,128,128
"77335",2019,0,0,110,110
"77335",2020,0,0,79,79
"77336",2013,0,62,0,62
"77336",2015,0,0,68,68
"77336",2017,0,0,33,33
"77336",2018,0,0,114,114
"77336",2019,0,0,51,51
"77336",2020,0,0,98,98
"77337",2017,0,0,36,36
"77337",2019,0,0,4,4
"77337",2020,0,0,14,14
"77338",2015,0,0,117,117
"77338",2017,0,0,34,34
"77338",2018,0,0,114,114
"77338",2019,0,0,13,13
"77338",2020,0,0,6,6
"77339",2019,0,0,49,49
"77339",2020,0,0,85,85
"77340",2017,0,0,34,34
"77340",2019,0,0,115,115
"77340",2020,0,0,85,85
"77341",2020,0,0,8,8
"77342",2019,0,0,49,49
"77342",2020,0,0,85,85
"77343",2020,0,0,14,14
"77344",2015,0,0,28,28
"77344",2018,0,0,128,128
"77344",2019,0,0,106,106
"77344",2020,0,0,79,79
"77345",2015,0,0,58,58
"77345",2017,0,0,78,78
"77345",2019,0,0,28,28
"77345",2020,0,0,13,13
"77348",2019,0,0,49,49
"77348",2020,0,0,85,85
"77349",2020,0,0,14,14
"77350",2013,0,62,0,62
"77350",2015,0,0,52,52
"77350",2017,0,0,29,29
"77350",2019,0,0,39,39
"77352",2013,0,62,0,62
"77353",2017,0,0,34,34
"77353",2019,0,0,137,137
"77353",2020,0,0,85,85
"77354",2013,0,62,0,62
"77354",2017,0,0,13,13
"77354",2018,0,0,140,140
"77354",2019,0,0,137,137
"77354",2020,0,0,28,28
"77356",2020,0,0,8,8
"77357",2013,0,62,0,62
"77358",2015,0,0,28,28
"77358",2018,0,0,128,128
"77358",2019,0,0,110,110
"77358",2020,0,0,79,79
"77360",2013,0,62,0,62
"77360",2015,0,0,68,68
"77360",2017,0,0,33,33
"77360",2018,0,0,114,114
"77360",2019,0,0,51,51
"77360",2020,0,0,98,98
"77361",2015,0,0,68,68
"77361",2017,0,0,49,49
"77361",2018,0,0,114,114
"77361",2019,0,0,51,51
"77361",2020,0,0,98,98
"77363",2017,0,0,36,36
"77363",2019,0,0,4,4
"77363",2020,0,0,14,14
"77364",2017,0,0,36,36
"77364",2019,0,0,4,4
"77364",2020,0,0,14,14
"77365",2013,0,62,0,62
"77366",2015,0,0,28,28
"77366",2018,0,0,128,128
"77366",2019,0,0,110,110
"77366",2020,0,0,79,79
"77367",2015,0,0,28,28
"77367",2018,0,0,128,128
"77367",2019,0,0,106,106
"77367",2020,0,0,79,79
"77369",2017,0,0,36,36
"77369",2019,0,0,4,4
"77369",2020,0,0,14,14
"77370",2017,0,0,34,34
"77370",2019,0,0,115,115
"77370",2020,0,0,85,85
"77371",2015,0,0,68,68
"77371",2017,0,0,33,33
"77371",2018,0,0,114,114
"77371",2019,0,0,51,51
"77371",2020,0,0,98,98
"77372",2017,0,0,36,36
"77372",2019,0,0,4,4
"77372",2020,0,0,14,14
"77373",2013,0,62,0,62
"77373",2015,0,0,52,52
"77373",2017,0,0,29,29
"77373",2019,0,0,39,39
"77374",2013,0,62,0,62
"77374",2015,0,0,52,52
"77374",2017,0,0,29,29
"77374",2019,0,0,39,39
"77376",2017,0,0,36,36
"77376",2019,0,0,4,4
"77376",2020,0,0,14,14
"77377",2013,0,62,0,62
"77377",2015,0,0,52,52
"77377",2017,0,0,29,29
"77377",2019,0,0,39,39
"77380",2015,0,0,28,28
"77380",2018,0,0,128,128
"77380",2019,0,0,106,106
"77380",2020,0,0,79,79
"77381",2013,0,62,0,62
"77381",2017,0,0,13,13
"77381",2018,0,0,140,140
"77381",2019,0,0,137,137
"77381",2020,0,0,20,20
"77382",2015,0,0,68,68
"77382",2017,0,0,49,49
"77382",2018,0,0,114,114
"77382",2019,0,0,51,51
"77382",2020,0,0,98,98
"77383",2017,0,0,13,13
"77383",2018,0,0,140,140
"77383",2019,0,0,137,137
"77383",2020,0,0,20,20
"77384",2013,0,62,0,62
"77384",2017,0,0,13,13
"77384",2018,0,0,140,140
"77384",2019,0,0,137,137
"77384",2020,0,0,28,28
"77385",2015,0,0,58,58
"77385",2017,0,0,78,78
"77385",2018,0,0,50,50
"77385",2019,0,0,17,17
"77385",2020,0,0,13,13
"77386",2019,0,0,49,49
"77386",2020,0,0,85,85
"77387",2017,0,0,34,34
"77387",2019,0,0,115,115
"77387",2020,0,0,85,85
"77388",2015,0,0,58,58
"77388",2017,0,0,78,78
"77388",2019,0,0,32,32
"77388",2020,0,0,13,13
"77389",2017,0,0,13,13
"77389",2018,0,0,140,140
"77389",2019,0,0,115,115
"77389",2020,0,0,28,28
"77390",2013,0,62,0,62
"77390",2015,0,0,52,52
"77390",2017,0,0,29,29
"77390",2019,0,0,39,39
"77392",2015,0,0,28,28
"77392",2018,0,0,128,128
"77392",2019,0,0,106,106
"77392",2020,0,0,79,79
"77393",2013,0,62,0,62
"77394",2013,0,62,0,62
"77394",2017,0,0,13,13
"77394",2018,0,0,140,140
"77394",2019,0,0,137,137
"77394",2020,0,0,20,20
"77395",2015,0,0,123,123
"77395",2020,0,0,79,79
"77396",2015,0,0,68,68
"77396",2017,0,0,33,33
"77396",2018,0,0,114,114
"77396",2019,0,0,51,51
"77396",2020,0,0,98,98
"77397",2015,0,0,58,58
"77397",2017,0,0,78,78
"77397",2019,0,0,32,32
"77397",2020,0,0,13,13
"77398",2015,0,0,58,58
"77398",2017,0,0,78,78
"77398",2018,0,0,50,50
"77398",2019,0,0,17,17
"77398",2020,0,0,13,13
"77400",2015,0,0,68,68
"77400",2017,0,0,33,33
"77400",2018,0,0,114,114
"77400",2019,0,0,51,51
"77400",2020,0,0,98,98
"77401",2017,0,0,36,36
"77401",2019,0,0,4,4
"77401",2020,0,0,14,14
"77402",2015,0,0,58,58
"77402",2017,0,0,78,78
"77402",2018,0,0,50,50
"77402",2019,0,0,17,17
"77402",2020,0,0,13,13
"77405",2015,0,0,58,58
"77405",2017,0,0,78,78
"77405",2018,0,0,50,50
"77405",2019,0,0,17,17
"77405",2020,0,0,13,13
"77406",2015,0,0,68,68
"77406",2017,0,0,33,33
"77406",2018,0,0,114,114
"77406",2019,0,0,51,51
"77406",2020,0,0,98,98
"77407",2013,0,62,0,62
"77407",2020,0,0,8,8
"77408",2015,0,0,68,68
"77408",2017,0,0,49,49
"77408",2018,0,0,114,114
"77408",2019,0,0,51,51
"77408",2020,0,0,98,98
"77409",2013,0,62,0,62
"77409",2019,0,0,78,78
"77409",2020,0,0,93,93
"77410",2013,0,62,0,62
"77410",2017,0,0,13,13
"77410",2018,0,0,140,140
"77410",2019,0,0,137,137
"77410",2020,0,0,20,20
"77411",2015,0,0,68,68
"77411",2017,0,0,33,33
"77411",2018,0,0,114,114
"77411",2019,0,0,51,51
"77411",2020,0,0,98,98
"77413",2015,0,0,68,68
"77413",2017,0,0,33,33
"77413",2018,0,0,114,114
"77413",2019,0,0,51,51
"77413",2020,0,0,98,98
"77414",2015,0,0,68,68
"77414",2017,0,0,33,33
"77414",2018,0,0,114,114
"77414",2019,0,0,51,51
"77414",2020,0,0,98,98
"77415",2015,0,0,68,68
"77415",2017,0,0,49,49
"77415",2018,0,0,114,114
"77415",2019,0,0,51,51
"77415",2020,0,0,98,98
"77417",2015,0,0,68,68
"77417",2017,0,0,33,33
"77417",2018,0,0,114,114
"77417",2019,0,0,51,51
"77417",2020,0,0,98,98
"77419",2013,0,62,0,62
"77419",2015,0,0,117,117
"77419",2017,0,0,34,34
"77419",2018,0,0,114,114
"77419",2019,0,0,13,13
"77419",2020,0,0,14,14
"77420",2015,0,0,28,28
"77420",2018,0,0,128,128
"77420",2019,0,0,106,106
"77420",2020,0,0,79,79
"77421",2015,0,0,68,68
"77421",2017,0,0,33,33
"77421",2018,0,0,114,114
"77421",2019,0,0,51,51
"77421",2020,0,0,98,98
"77423",2015,0,0,68,68
"77423",2017,0,0,33,33
"77423",2018,0,0,114,114
"77423",2019,0,0,51,51
"77423",2020,0,0,98,98
"77424",2015,0,0,68,68
"77424",2017,0,0,33,33
"77424",2018,0,0,114,114
"77424",2019,0,0,51,51
"77424",2020,0,0,98,98
"77425",2019,0,0,49,49
"77425",2020,0,0,85,85
"77426",2013,0,62,0,62
"77426",2017,0,0,13,13
"77426",2018,0,0,140,140
"77426",2019,0,0,137,137
"77426",2020,0,0,20,20
"77427",2020,0,0,14,14
"77428",2013,0,62,0,62
"77428",2017,0,0,13,13
"77428",2018,0,0,140,140
"77428",2019,0,0,137,137
"77428",2020,0,0,20,20
"77429",2015,0,0,58,58
"77429",2017,0,0,78,78
"77429",2019,0,0,28,28
"77429",2020,0,0,13,13
"77430",2015,0,0,28,28
"77430",2018,0,0,128,128
"77430",2019,0,0,106,106
"77430",2020,0,0,79,79
"77431",2019,0,0,49,49
"77431",2020,0,0,85,85
"77432",2015,0,0,68,68
"77432",2017,0,0,33,33
"77432",2018,0,0,114,114
"77432",2019,0,0,51,51
"77432",2020,0,0,98,98
"77433",2013,0,62,0,62
"77433",2015,0,0,68,68
"77433",2017,0,0,33,33
"77433",2018,0,0,114,114
"77433",2019,0,0,51,51
"77433",2020,0,0,98,98
"77434",2020,0,0,8,8
"77436",2015,0,0,68,68
"77436",2017,0,0,33,33
"77436",2018,0,0,114,114
"77436",2019,0,0,51,51
"77436",2020,0,0,98,98
"77437",2015,0,0,28,28
"77437",2018,0,0,128,128
"77437",2019,0,0,106,106
"77437",2020,0,0,79,79
"77438",2017,0,0,36,36
"77438",2019,0,0,4,4
"77438",2020,0,0,14,14
"77439",2013,0,62,0,62
"77439",2020,0,0,8,8
"77440",2015,0,0,58,58
"77440",2017,0,0,78,78
"77440",2018,0,0,50,50
"77440",2019,0,0,17,17
"77440",2020,0,0,13,13
"77441",2013,0,62,0,62
"77441",2019,0,0,49,49
"77441",2020,0,0,93,93
"77442",2013,0,62,0,62
"77442",2020,0,0,8,8
"77443",2015,0,0,68,68
"77443",2017,0,0,33,33
"77443",2018,0,0,114,114
"77443",2019,0,0,51,51
"77443",2020,0,0,98,98
"77444",2015,0,0,68,68
"77444",2017,0,0,33,33
"77444",2018,0,0,114,114
"77444",2019,0,0,51,51
"77444",2020,0,0,98,98
"77445",2013,0,62,0,62
"77445",2020,0,0,8,8
"77447",2013,0,62,0,62
"77447",2020,0,0,8,8
"77448",2015,0,0,58,58
"77448",2017,0,0,78,78
"77448",2019,0,0,32,32
"77448",2020,0,0,13,13
"77449",2013,0,62,0,62
"77449",2015,0,0,68,68
"77449",2017,0,0,49,49
"77449",2018,0,0,114,114
"77449",2019,0,0,51,51
"77449",2020,0,0,98,98
"77450",2013,0,62,0,62
"77450",2015,0,0,52,52
"77450",2017,0,0,29,29
"77450",2019,0,0,39,39
"77451",2015,0,0,68,68
"77451",2017,0,0,49,49
"77451",2018,0,0,114,114
"77451",2019,0,0,51,51
"77451",2020,0,0,98,98
"77453",2013,0,62,0,62
"77453",2017,0,0,13,13
"77453",2018,0,0,140,140
"77453",2019,0,0,137,137
"77453",2020,0,0,28,28
"77455",2013,0,62,0,62
"77455",2017,0,0,13,13
"77455",2018,0,0,140,140
"77455",2019,0,0,137,137
"77455",2020,0,0,28,28
"77457",2013,0,62,0,62
"77460",2017,0,0,36,36
"77460",2019,0,0,4,4
"77460",2020,0,0,14,14
"77462",2020,0,0,14,14
"77463",2013,0,62,0,62
"77463",2019,0,0,49,49
"77463",2020,0,0,93,93
"77464",2017,0,0,36,36
"77464",2019,0,0,4,4
"77464",2020,0,0,14,14
"77465",2015,0,0,117,117
"77465",2017,0,0,34,34
"77465",2018,0,0,114,114
"77465",2019,0,0,32,32
"77465",2020,0,0,6,6
"77466",2015,0,0,68,68
"77466",2017,0,0,33,33
"77466",2018,0,0,114,114
"77466",2019,0,0,51,51
"77466",2020,0,0,98,98
"77467",2019,0,0,78,78
"77467",2020,0,0,85,85
"77468",2017,0,0,36,36
"77468",2019,0,0,4,4
"77468",2020,0,0,14,14
"77469",2013,0,62,0,62
"77469",2015,0,0,68,68
"77469",2017,0,0,33,33
"77469",2018,0,0,114,114
"77469",2019,0,0,51,51
"77469",2020,0,0,98,98
"77470",2013,0,62,0,62
"77472",2015,0,0,58,58
"77472",2017,0,0,78,78
"77472",2018,0,0,50,50
"77472",2019,0,0,17,17
"77472",2020,0,0,13,13
"77473",2017,0,0,34,34
"77473",2019,0,0,115,115
"77473",2020,0,0,85,85
"77474",2017,0,0,36,36
"77474",2019,0,0,4,4
"77474",2020,0,0,14,14
"77475",2015,0,0,68,68
"77475",2017,0,0,49,49
"77475",2018,0,0,114,114
"77475",2019,0,0,51,51
"77475",2020,0,0,98,98
"77476",2015,0,0,28,28
"77476",2018,0,0,128,128
"77476",2019,0,0,106,106
"77476",2020,0,0,79,79
"77477",2019,0,0,49,49
"77477",2020,0,0,85,85
"77478",2015,0,0,58,58
"77478",2017,0,0,78,78
"77478",2019,0,0,32,32
"77478",2020,0,0,13,13
"77479",2017,0,0,36,36
"77479",2019,0,0,4,4
"77479",2020,0,0,14,14
"77480",2013,0,62,0,62
"77480",2017,0,0,13,13
"77480",2018,0,0,140,140
"77480",2019,0,0,137,137
"77480",2020,0,0,28,28
"77482",2013,0,62,0,62
"77482",2015,0,0,117,117
"77482",2017,0,0,34,34
"77482",2018,0,0,114,114
"77482",2019,0,0,13,13
"77482",2020,0,0,14,14
"77483",2015,0,0,28,28
"77483",2018,0,0,128,128
"77483",2019,0,0,110,110
"77483",2020,0,0,79,79
"77484",2015,0,0,68,68
"77484",2017,0,0,33,33
"77484",2018,0,0,114,114
"77484",2019,0,0,51,51
"77484",2020,0,0,98,98
"77486",2013,0,62,0,62
"77486",2015,0,0,68,68
"77486",2017,0,0,33,33
"77486",2018,0,0,114,114
"77486",2019,0,0,51,51
"77486",2020,0,0,98,98
"77487",2013,0,62,0,62
"77487",2017,0,0,13,13
"77487",2018,0,0,140,140
"77487",2019,0,0,137,137
"77487",2020,0,0,28,28
"77489",2017,0,0,34,34
"77489",2019,0,0,137,137
"77489",2020,0,0,85,85
"77490",2020,0,0,14,14
"77492",2015,0,0,58,58
"77492",2017,0,0,78,78
"77492",2018,0,0,50,50
"77492",2019,0,0,17,17
"77492",2020,0,0,13,13
"77493",2013,0,62,0,62
"77494",2013,0,62,0,62
"77494",2015,0,0,117,117
"77494",2017,0,0,34,34
"77494",2018,0,0,114,114
"77494",2019,0,0,13,13
"77494",2020,0,0,14,14
"77495",2013,0,62,0,62
"77495",2017,0,0,13,13
"77495",2018,0,0,140,140
"77495",2019,0,0,137,137
"77495",2020,0,0,28,28
"77498",2017,0,0,36,36
"77498",2019,0,0,4,4
"77498",2020,0,0,14,14
"77500",2017,0,0,34,34
"77500",2019,0,0,137,137
"77500",2020,0,0,85,85
"77501",2015,0,0,117,117
"77501",2017,0,0,34,34
"77501",2018,0,0,114,114
"77501",2019,0,0,32,32
"77501",2020,0,0,6,6
"77504",2015,0,0,117,117
"77504",2017,0,0,34,34
"77504",2018,0,0,114,114
"77504",2019,0,0,32,32
"77504",2020,0,0,6,6
"77505",2015,0,0,68,68
"77505",2017,0,0,49,49
"77505",2018,0,0,114,114
"77505",2019,0,0,51,51
"77505",2020,0,0,98,98
"77506",2017,0,0,34,34
"77506",2019,0,0,137,137
"77506",2020,0,0,85,85
"77507",2020,0,0,8,8
"77508",2013,0,62,0,62
"77508",2015,0,0,68,68
"77508",2017,0,0,33,33
"77508",2018,0,0,114,114
"77508",2019,0,0,51,51
"77508",2020,0,0,98,98
"77509",2017,0,0,13,13
"77509",2018,0,0,140,140
"77509",2019,0,0,137,137
"77509",2020,0,0,28,28
"77510",2013,0,62,0,62
"77510",2020,0,0,14,14
"77511",2020,0,0,14,14
"77512",2015,0,0,58,58
"77512",2017,0,0,78,78
"77512",2019,0,0,28,28
"77512",2020,0,0,13,13
"77513",2017,0,0,36,36
"77513",2019,0,0,4,4
"77513",2020,0,0,14,14
"77514",2017,0,0,36,36
"77514",2019,0,0,4,4
"77514",2020,0,0,14,14
"77515",2017,0,0,36,36
"77515",2019,0,0,4,4
"77515",2020,0,0,14,14
"77516",2013,0,62,0,62
"77516",2015,0,0,117,117
"77516",2017,0,0,34,34
"77516",2018,0,0,114,114
"77516",2019,0,0,13,13
"77516",2020,0,0,14,14
"77517",2017,0,0,36,36
"77517",2019,0,0,4,4
"77517",2020,0,0,14,14
"77518",2019,0,0,49,49
"77518",2020,0,0,93,93
"77519",2015,0,0,68,68
"77519",2017,0,0,33,33
"77519",2018,0,0,114,114
"77519",2019,0,0,51,51
"77519",2020,0,0,98,98
"77520",2019,0,0,49,49
"77520",2020,0,0,85,85
"77521",2013,0,62,0,62
"77521",2015,0,0,68,68
"77521",2017,0,0,33,33
"77521",2018,0,0,114,114
"77521",2019,0,0,51,51
"77521",2020,0,0,98,98
"77522",2020,0,0,8,8
"77523",2020,0,0,8,8
"77524",2020,0,0,8,8
"77525",2020,0,0,14,14
"77526",2015,0,0,28,28
"77526",2018,0,0,128,128
"77526",2019,0,0,106,106
"77526",2020,0,0,79,79
"77527",2013,0,62,0,62
"77528",2013,0,62,0,62
"77528",2017,0,0,13,13
"77528",2018,0,0,140,140
"77528",2019,0,0,137,137
"77528",2020,0,0,20,20
"77529",2013,0,62,0,62
"77529",2015,0,0,68,68
"77529",2017,0,0,33,33
"77529",2018,0,0,114,114
"77529",2019,0,0,51,51
"77529",2020,0,0,98,98
"77531",2015,0,0,117,117
"77531",2017,0,0,34,34
"77531",2018,0,0,114,114
"77531",2019,0,0,32,32
"77531",2020,0,0,6,6
"77533",2013,0,62,0,62
"77533",2020,0,0,8,8
"77534",2013,0,62,0,62
"77534",2017,0,0,13,13
"77534",2018,0,0,140,140
"77534",2019,0,0,137,137
"77534",2020,0,0,20,20
"78003",2019,0,0,35,35
"78003",2020,0,0,22,22
"78005",2015,0,0,61,61
"78005",2019,0,0,50,50
"78005",2020,0,0,99,99
"78006",2019,0,0,35,35
"78006",2020,0,0,22,22
"78007",2019,0,0,50,50
"78007",2020,0,0,99,99
"78009",2019,0,0,35,35
"78009",2020,0,0,22,22
"78010",2019,0,0,50,50
"78010",2020,0,0,99,99
"78013",2019,0,0,35,35
"78013",2020,0,0,99,99
"78015",2019,0,0,50,50
"78015",2020,0,0,99,99
"78020",2019,0,0,35,35
"78020",2020,0,0,99,99
"78029",2019,0,0,50,50
"78029",2020,0,0,99,99
"78030",2019,0,0,35,35
"78030",2020,0,0,22,22
"78031",2019,0,0,35,35
"78031",2020,0,0,99,99
"78033",2019,0,0,50,50
"78033",2020,0,0,99,99
"78034",2019,0,0,35,35
"78034",2020,0,0,99,99
"78036",2019,0,0,35,35
"78036",2020,0,0,99,99
"78043",2019,0,0,50,50
"78043",2020,0,0,99,99
"78048",2019,0,0,35,35
"78048",2020,0,0,22,22
"78049",2019,0,0,50,50
"78049",2020,0,0,99,99
"78050",2019,0,0,35,35
"78050",2020,0,0,99,99
"78053",2019,0,0,35,35
"78053",2020,0,0,99,99
"78057",2015,0,0,61,61
"78057",2019,0,0,50,50
"78057",2020,0,0,99,99
"78062",2019,0,0,35,35
"78062",2020,0,0,99,99
"78068",2019,0,0,35,35
"78068",2020,0,0,99,99
"78070",2019,0,0,35,35
"78070",2020,0,0,99,99
"78071",2019,0,0,35,35
"78071",2020,0,0,22,22
"78072",2019,0,0,35,35
"78072",2020,0,0,99,99
"78073",2019,0,0,50,50
"78073",2020,0,0,22,22
"78076",2019,0,0,35,35
"78076",2020,0,0,22,22
"78077",2019,0,0,35,35
"78077",2020,0,0,22,22
"78082",2019,0,0,35,35
"78082",2020,0,0,99,99
"78084",2019,0,0,35,35
"78084",2020,0,0,99,99
"78087",2019,0,0,35,35
"78087",2020,0,0,22,22
"78089",2019,0,0,35,35
"78089",2020,0,0,99,99
"78090",2019,0,0,50,50
"78090",2020,0,0,99,99
"78092",2019,0,0,50,50
"78092",2020,0,0,99,99
"78096",2019,0,0,35,35
"78096",2020,0,0,22,22
"78104",2019,0,0,35,35
"78104",2020,0,0,99,99
"78107",2019,0,0,35,35
"78107",2020,0,0,99,99
"78108",2019,0,0,35,35
"78108",2020,0,0,22,22
"78113",2019,0,0,35,35
"78113",2020,0,0,99,99
"78117",2019,0,0,50,50
"78117",2020,0,0,22,22
"78118",2019,0,0,35,35
"78118",2020,0,0,99,99
"78120",2019,0,0,35,35
"78120",2020,0,0,22,22
"78123",2019,0,0,50,50
"78123",2020,0,0,99,99
"78124",2019,0,0,50,50
"78124",2020,0,0,99,99
"78125",2019,0,0,35,35
"78125",2020,0,0,22,22
"78126",2019,0,0,50,50
"78126",2020,0,0,99,99
"78128",2019,0,0,35,35
"78128",2020,0,0,22,22
"78133",2019,0,0,50,50
"78133",2020,0,0,99,99
"78138",2019,0,0,50,50
"78138",2020,0,0,99,99
"78140",2019,0,0,50,50
"78140",2020,0,0,99,99
"78143",2019,0,0,35,35
"78143",2020,0,0,22,22
"78146",2019,0,0,50,50
"78146",2020,0,0,99,99
"78147",2019,0,0,35,35
"78147",2020,0,0,99,99
"78152",2019,0,0,50,50
"78152",2020,0,0,99,99
"78158",2019,0,0,50,50
"78158",2020,0,0,99,99
"78160",2019,0,0,35,35
"78160",2020,0,0,22,22
"78162",2019,0,0,35,35
"78162",2020,0,0,22,22
"78163",2019,0,0,35,35
"78163",2020,0,0,22,22
"78164",2019,0,0,35,35
"78164",2020,0,0,22,22
"78165",2019,0,0,50,50
"78165",2020,0,0,22,22
"78168",2019,0,0,35,35
"78168",2020,0,0,22,22
"78171",2019,0,0,35,35
"78171",2020,0,0,22,22
"78172",2015,0,0,61,61
"78172",2019,0,0,50,50
"78172",2020,0,0,99,99
"78185",2019,0,0,35,35
"78185",2020,0,0,99,99
"78188",2019,0,0,35,35
"78188",2020,0,0,99,99
"78189",2019,0,0,35,35
"78189",2020,0,0,99,99
"78190",2019,0,0,50,50
"78190",2020,0,0,99,99
"78192",2019,0,0,35,35
"78192",2020,0,0,99,99
"78193",2019,0,0,35,35
"78193",2020,0,0,22,22
"78194",2019,0,0,35,35
"78194",2020,0,0,22,22
"78196",2019,0,0,50,50
"78196",2020,0,0,99,99
"78202",2019,0,0,35,35
"78202",2020,0,0,99,99
"78206",2019,0,0,50,50
"78206",2020,0,0,99,99
"78208",2019,0,0,35,35
"78208",2020,0,0,22,22
"78209",2019,0,0,35,35
"78209",2020,0,0,22,22
"78217",2019,0,0,35,35
"78217",2020,0,0,99,99
"78220",2019,0,0,35,35
"78220",2020,0,0,22,22
"78224",2019,0,0,50,50
"78224",2020,0,0,99,99
"78227",2019,0,0,35,35
"78227",2020,0,0,99,99
"78230",2019,0,0,50,50
"78230",2020,0,0,99,99
"78231",2019,0,0,35,35
"78231",2020,0,0,99,99
"78233",2019,0,0,50,50
"78233",2020,0,0,99,99
"78234",2019,0,0,35,35
"78234",2020,0,0,99,99
"78236",2019,0,0,35,35
"78236",2020,0,0,99,99
"78237",2019,0,0,35,35
"78237",2020,0,0,99,99
"78238",2019,0,0,50,50
"78238",2020,0,0,99,99
"78239",2019,0,0,35,35
"78239",2020,0,0,99,99
"78242",2019,0,0,50,50
"78242",2020,0,0,22,22
"78245",2019,0,0,35,35
"78245",2020,0,0,99,99
"78246",2019,0,0,35,35
"78246",2020,0,0,99,99
"78255",2015,0,0,61,61
"78255",2019,0,0,50,50
"78255",2020,0,0,99,99
"78261",2019,0,0,35,35
"78261",2020,0,0,99,99
"78262",2019,0,0,35,35
"78262",2020,0,0,99,99
"78263",2019,0,0,35,35
"78263",2020,0,0,22,22
"78264",2019,0,0,35,35
"78264",2020,0,0,22,22
"78265",2019,0,0,35,35
"78265",2020,0,0,99,99
"78267",2019,0,0,35,35
"78267",2020,0,0,99,99
"78269",2019,0,0,35,35
"78269",2020,0,0,22,22
"78276",2015,0,0,61,61
"78276",2019,0,0,50,50
"78276",2020,0,0,99,99
"78278",2019,0,0,35,35
"78278",2020,0,0,99,99
"78281",2019,0,0,35,35
"78281",2020,0,0,99,99
"78283",2019,0,0,35,35
"78283",2020,0,0,22,22
"78285",2019,0,0,35,35
"78285",2020,0,0,22,22
"78289",2019,0,0,35,35
"78289",2020,0,0,22,22
"78290",2015,0,0,61,61
"78290",2019,0,0,50,50
"78290",2020,0,0,99,99
"78291",2019,0,0,35,35
"78291",2020,0,0,99,99
"78296",2019,0,0,35,35
"78296",2020,0,0,99,99
"78297",2019,0,0,35,35
"78297",2020,0,0,22,22
"78299",2019,0,0,35,35
"78299",2020,0,0,99,99
"78300",2019,0,0,35,35
"78300",2020,0,0,99,99
"78302",2019,0,0,35,35
"78302",2020,0,0,22,22
"78305",2019,0,0,35,35
"78305",2020,0,0,99,99
"78307",2019,0,0,35,35
"78307",2020,0,0,22,22
"78310",2019,0,0,35,35
"78310",2020,0,0,22,22
"78311",2019,0,0,50,50
"78311",2020,0,0,99,99
"78314",2019,0,0,50,50
"78314",2020,0,0,99,99
"78317",2019,0,0,35,35
"78317",2020,0,0,99,99
"78320",2019,0,0,35,35
"78320",2020,0,0,99,99
"78321",2019,0,0,35,35
"78321",2020,0,0,99,99
"78322",2019,0,0,50,50
"78322",2020,0,0,22,22
"78324",2019,0,0,35,35
"78324",2020,0,0,99,99
"78325",2019,0,0,35,35
"78325",2020,0,0,99,99
"78327",2019,0,0,35,35
"78327",2020,0,0,99,99
"78329",2019,0,0,35,35
"78329",2020,0,0,99,99
"78334",2019,0,0,35,35
"78334",2020,0,0,22,22
"78335",2019,0,0,35,35
"78335",2020,0,0,99,99
"78337",2015,0,0,61,61
"78337",2019,0,0,50,50
"78337",2020,0,0,99,99
"78343",2019,0,0,50,50
"78343",2020,0,0,22,22
"78344",2019,0,0,35,35
"78344",2020,0,0,99,99
"78346",2019,0,0,35,35
"78346",2020,0,0,99,99
"78349",2019,0,0,35,35
"78349",2020,0,0,22,22
"78350",2019,0,0,50,50
"78350",2020,0,0,99,99
"78354",2019,0,0,35,35
"78354",2020,0,0,99,99
"78356",2019,0,0,35,35
"78356",2020,0,0,22,22
"78358",2015,0,0,61,61
"78358",2019,0,0,50,50
"78358",2020,0,0,99,99
"78361",2019,0,0,50,50
"78361",2020,0,0,99,99
"78362",2019,0,0,35,35
"78362",2020,0,0,99,99
"78364",2019,0,0,35,35
"78364",2020,0,0,99,99
"78366",2019,0,0,35,35
"78366",2020,0,0,99,99
"78367",2019,0,0,50,50
"78367",2020,0,0,99,99
"78368",2019,0,0,35,35
"78368",2020,0,0,99,99
"78372",2019,0,0,50,50
"78372",2020,0,0,99,99
"78380",2019,0,0,35,35
"78380",2020,0,0,99,99
"78381",2019,0,0,35,35
"78381",2020,0,0,22,22
"78382",2015,0,0,61,61
"78382",2019,0,0,50,50
"78382",2020,0,0,99,99
"78383",2019,0,0,35,35
"78383",2020,0,0,22,22
"78384",2019,0,0,50,50
"78384",2020,0,0,99,99
"78385",2019,0,0,35,35
"78385",2020,0,0,99,99
"78389",2019,0,0,35,35
"78389",2020,0,0,99,99
"78391",2015,0,0,61,61
"78391",2019,0,0,50,50
"78391",2020,0,0,99,99
"78396",2015,0,0,61,61
"78396",2019,0,0,50,50
"78396",2020,0,0,99,99
"78397",2019,0,0,35,35
"78397",2020,0,0,22,22
"78398",2019,0,0,35,35
"78398",2020,0,0,22,22
"78401",2019,0,0,35,35
"78401",2020,0,0,99,99
"78402",2019,0,0,35,35
"78402",2020,0,0,99,99
"78403",2019,0,0,35,35
"78403",2020,0,0,99,99
"78404",2019,0,0,35,35
"78404",2020,0,0,22,22
"78406",2019,0,0,35,35
"78406",2020,0,0,22,22
"78407",2019,0,0,35,35
"78407",2020,0,0,22,22
"78410",2015,0,0,61,61
"78410",2019,0,0,50,50
"78410",2020,0,0,99,99
"78413",2019,0,0,35,35
"78413",2020,0,0,99,99
"78415",2019,0,0,35,35
"78415",2020,0,0,99,99
"78416",2019,0,0,35,35
"78416",2020,0,0,99,99
"78417",2019,0,0,35,35
"78417",2020,0,0,99,99
"78418",2019,0,0,50,50
"78418",2020,0,0,99,99
"78420",2019,0,0,35,35
"78420",2020,0,0,22,22
"78423",2019,0,0,35,35
"78423",2020,0,0,22,22
"78431",2019,0,0,50,50
"78431",2020,0,0,99,99
"78437",2015,0,0,61,61
"78437",2019,0,0,50,50
"78437",2020,0,0,99,99
"78439",2019,0,0,35,35
"78439",2020,0,0,99,99
"78440",2019,0,0,50,50
"78440",2020,0,0,99,99
"78442",2019,0,0,35,35
"78442",2020,0,0,99,99
"78443",2019,0,0,35,35
"78443",2020,0,0,99,99
"78444",2019,0,0,35,35
"78444",2020,0,0,99,99
"78451",2019,0,0,50,50
"78451",2020,0,0,99,99
"78455",2019,0,0,50,50
"78455",2020,0,0,99,99
"78460",2019,0,0,35,35
"78460",2020,0,0,99,99
"78464",2019,0,0,35,35
"78464",2020,0,0,22,22
"78465",2019,0,0,35,35
"78465",2020,0,0,22,22
"78466",2019,0,0,50,50
"78466",2020,0,0,99,99
"78470",2019,0,0,35,35
"78470",2020,0,0,22,22
"78472",2019,0,0,35,35
"78472",2020,0,0,22,22
"78474",2019,0,0,35,35
"78474",2020,0,0,22,22
"78475",2019,0,0,35,35
"78475",2020,0,0,99,99
"78478",2019,0,0,35,35
"78478",2020,0,0,22,22
"78481",2019,0,0,50,50
"78481",2020,0,0,99,99
"78484",2019,0,0,35,35
"78484",2020,0,0,99,99
"78486",2019,0,0,35,35
"78486",2020,0,0,22,22
"78490",2019,0,0,35,35
"78490",2020,0,0,22,22
"78497",2019,0,0,35,35
"78497",2020,0,0,22,22
"78498",2019,0,0,50,50
"78498",2020,0,0,99,99
"78499",2019,0,0,35,35
"78499",2020,0,0,22,22
"78501",2019,0,0,50,50
"78501",2020,0,0,99,99
"78502",2019,0,0,50,50
"78502",2020,0,0,99,99
"78505",2019,0,0,35,35
"78505",2020,0,0,22,22
"78506",2019,0,0,35,35
"78506",2020,0,0,22,22
"78513",2019,0,0,35,35
"78513",2020,0,0,99,99
"78516",2019,0,0,35,35
"78516",2020,0,0,22,22
"78517",2019,0,0,35,35
"78517",2020,0,0,22,22
"78518",2019,0,0,50,50
"78518",2020,0,0,99,99
"78520",2019,0,0,35,35
"78520",2020,0,0,22,22
"78522",2019,0,0,35,35
"78522",2020,0,0,22,22
"78528",2015,0,0,61,61
"78528",2019,0,0,50,50
"78528",2020,0,0,99,99
"78530",2019,0,0,35,35
"78530",2020,0,0,99,99
"78531",2019,0,0,35,35
"78531",2020,0,0,99,99
"78536",2019,0,0,35,35
"78536",2020,0,0,99,99
"78537",2019,0,0,35,35
"78537",2020,0,0,22,22
"78545",2019,0,0,50,50
"78545",2020,0,0,22,22
"78548",2019,0,0,35,35
"78548",2020,0,0,22,22
"78550",2019,0,0,35,35
"78550",2020,0,0,99,99
"78551",2019,0,0,50,50
"78551",2020,0,0,99,99
"78557",2019,0,0,35,35
"78557",2020,0,0,22,22
"78558",2019,0,0,35,35
"78558",2020,0,0,99,99
"78559",2019,0,0,35,35
"78559",2020,0,0,99,99
"78561",2019,0,0,35,35
"78561",2020,0,0,22,22
"78562",2019,0,0,35,35
"78562",2020,0,0,22,22
"78564",2019,0,0,35,35
"78564",2020,0,0,22,22
"78565",2019,0,0,35,35
"78565",2020,0,0,99,99
"78567",2015,0,0,61,61
"78567",2019,0,0,50,50
"78567",2020,0,0,99,99
"78569",2019,0,0,35,35
"78569",2020,0,0,22,22
"78571",2019,0,0,50,50
"78571",2020,0,0,99,99
"78575",2019,0,0,35,35
"78575",2020,0,0,22,22
"78576",2019,0,0,35,35
"78576",2020,0,0,22,22
"78586",2019,0,0,50,50
"78586",2020,0,0,99,99
"78588",2019,0,0,35,35
"78588",2020,0,0,99,99
"78590",2019,0,0,50,50
"78590",2020,0,0,22,22
"78591",2019,0,0,35,35
"78591",2020,0,0,99,99
"78597",2019,0,0,35,35
"78597",2020,0,0,99,99
"78601",2019,0,0,35,35
"78601",2020,0,0,22,22
"78605",2019,0,0,35,35
"78605",2020,0,0,22,22
"78606",2019,0,0,35,35
"78606",2020,0,0,22,22
"78608",2019,0,0,35,35
"78608",2020,0,0,99,99
"78609",2019,0,0,35,35
"78609",2020,0,0,99,99
"78615",2019,0,0,35,35
"78615",2020,0,0,99,99
"78616",2019,0,0,35,35
"78616",2020,0,0,99,99
"78618",2019,0,0,35,35
"78618",2020,0,0,99,99
"78620",2019,0,0,50,50
"78620",2020,0,0,22,22
"78621",2019,0,0,35,35
"78621",2020,0,0,22,22
"78623",2019,0,0,35,35
"78623",2020,0,0,99,99
"78624",2019,0,0,50,50
"78624",2020,0,0,99,99
"78638",2019,0,0,50,50
"78638",2020,0,0,99,99
"78640",2019,0,0,50,50
"78640",2020,0,0,22,22
"78642",2019,0,0,50,50
"78642",2020,0,0,99,99
"78643",2019,0,0,50,50
"78643",2020,0,0,99,99
"78644",2019,0,0,35,35
"78644",2020,0,0,22,22
"78646",2019,0,0,50,50
"78646",2020,0,0,22,22
"78647",2019,0,0,35,35
"78647",2020,0,0,99,99
"78650",2019,0,0,50,50
"78650",2020,0,0,99,99
"78653",2019,0,0,35,35
"78653",2020,0,0,99,99
"78655",2019,0,0,35,35
"78655",2020,0,0,22,22
"78668",2019,0,0,35,35
"78668",2020,0,0,99,99
"78672",2019,0,0,50,50
"78672",2020,0,0,99,99
"78674",2019,0,0,50,50
"78674",2020,0,0,22,22
"78677",2019,0,0,35,35
"78677",2020,0,0,99,99
"78681",2019,0,0,35,35
"78681",2020,0,0,99,99
"78683",2019,0,0,35,35
"78683",2020,0,0,99,99
"78686",2019,0,0,50,50
"78686",2020,0,0,22,22
"78688",2019,0,0,35,35
"78688",2020,0,0,22,22
"79002",2020,0,0,37,37
"79005",2020,0,0,22,22
"79008",2020,0,0,22,22
"79013",2013,0,0,18,18
"79013",2020,0,0,13,13
"79014",2013,0,0,18,18
"79014",2020,0,0,13,13
"79015",2015,0,10,0,10
"79016",2020,0,0,37,37
"79018",2015,0,10,0,10
"79019",2020,0,0,37,37
"79022",2020,0,0,37,37
"79025",2020,0,0,37,37
"79029",2020,0,0,37,37
"79030",2015,0,10,0,10
"79031",2015,0,10,0,10
"79038",2020,0,0,22,22
"79047",2020,0,0,22,22
"79049",2020,0,0,22,22
"79050",2020,0,0,38,38
"79055",2015,0,10,0,10
"79056",2018,0,0,32,32
"79056",2020,0,0,25,25
"79057",2015,0,10,0,10
"79058",2015,0,10,0,10
"79060",2018,0,0,21,21
"79061",2015,0,10,0,10
"79062",2020,0,0,38,38
"79063",2013,0,0,18,18
"79063",2020,0,0,13,13
"79064",2015,0,10,0,10
"79069",2020,0,0,22,22
"79071",2020,0,0,37,37
"79074",2016,0,7,0,7
"79074",2017,0,58,0,58
"79074",2018,0,0,21,21
"79076",2020,0,0,22,22
"79078",2015,0,10,0,10
"79079",2020,0,0,38,38
"79080",2020,0,0,37,37
"79083",2015,0,10,0,10
"79085",2015,0,10,0,10
"79087",2015,0,10,0,10
"79088",2020,0,0,22,22
"79089",2020,0,0,37,37
"79090",2015,0,10,0,10
"79091",2020,0,0,38,38
"79094",2020,0,0,22,22
"79095",2015,0,10,0,10
"79095",2018,0,0,21,21
"79096",2020,0,0,38,38
"79102",2020,0,0,22,22
"79103",2020,0,0,22,22
"79111",2015,0,10,0,10
"79116",2020,0,0,22,22
"79118",2020,0,0,37,37
"79120",2020,0,0,37,37
"79122",2015,0,10,0,10
"79123",2020,0,0,38,38
"79126",2015,0,10,0,10
"79131",2020,0,0,22,22
"79132",2013,0,0,18,18
"79134",2020,0,0,22,22
"79135",2020,0,0,37,37
"79136",2015,0,10,0,10
"79136",2016,0,7,0,7
"79136",2018,0,0,21,21
"79140",2015,0,10,0,10
"79141",2020,0,0,37,37
"79142",2015,0,10,0,10
"79145",2020,0,0,37,37
"79148",2015,0,10,0,10
"79149",2020,0,0,37,37
"79150",2017,0,51,0,51
"79152",2017,0,73,0,73
"79153",2015,0,10,0,10
"79156",2020,0,0,22,22
"79157",2018,0,0,32,32
"79157",2020,0,0,25,25
"79158",2015,0,10,0,10
"79159",2020,0,0,22,22
"79160",2015,0,10,0,10
"79161",2020,0,0,22,22
"79163",2016,0,7,0,7
"79163",2017,0,58,0,58
"79163",2018,0,0,21,21
"79164",2015,0,10,0,10
"79165",2020,0,0,22,22
"79166",2015,0,10,0,10
"79172",2020,0,0,37,37
"79174",2015,0,10,0,10
"79175",2015,0,10,0,10
"79175",2016,0,7,0,7
"79175",2018,0,0,21,21
"79177",2018,0,0,21,21
"79179",2020,0,0,22,22
"79180",2017,0,51,0,51
"79185",2015,0,10,0,10
"79195",2020,0,0,38,38
"79196",2020,0,0,22,22
"79197",2020,0,0,37,37
"79198",2015,0,10,0,10
"79202",2020,0,0,37,37
"79204",2015,0,10,0,10
"79208",2020,0,0,37,37
"79209",2020,0,0,22,22
"79210",2020,0,0,38,38
"79212",2016,0,7,0,7
"79212",2017,0,50,0,50
"79212",2018,0,0,21,21
"79213",2020,0,0,37,37
"79217",2015,0,10,0,10
"79218",2020,0,0,37,37
"79230",2018,0,0,21,21
"79238",2020,0,0,38,38
"79239",2020,0,0,37,37
"79242",2020,0,0,38,38
"79244",2018,0,0,32,32
"79244",2020,0,0,25,25
"79250",2020,0,0,22,22
"79251",2015,0,10,0,10
"79252",2020,0,0,37,37
"79255",2020,0,0,22,22
"79258",2018,0,0,32,32
"79258",2020,0,0,25,25
"79259",2018,0,0,32,32
"79259",2020,0,0,25,25
"79265",2018,0,0,32,32
"79265",2020,0,0,25,25
"79268",2020,0,0,37,37
"79273",2015,0,10,0,10
"79274",2018,0,0,32,32
"79274",2020,0,0,25,25
"79277",2020,0,0,38,38
"79278",2020,0,0,37,37
"79280",2013,0,0,18,18
"79280",2020,0,0,13,13
"79289",2020,0,0,38,38
"79294",2015,0,10,0,10
"79295",2015,0,10,0,10
"79299",2020,0,0,22,22
"79300",2018,0,0,32,32
"79300",2020,0,0,25,25
"79301",2015,0,10,0,10
"79301",2018,0,0,21,21
"79306",2020,0,0,37,37
"79307",2016,0,7,0,7
"79307",2017,0,51,0,51
"79307",2018,0,0,21,21
"79310",2015,0,10,0,10
"79312",2015,0,10,0,10
"79313",2015,0,10,0,10
"79322",2020,0,0,37,37
"79326",2020,0,0,37,37
"79329",2020,0,0,22,22
"79331",2018,0,0,32,32
"79331",2020,0,0,25,25
"79338",2018,0,0,21,21
"79343",2015,0,10,0,10
"79345",2020,0,0,37,37
"79346",2015,0,10,0,10
"79347",2020,0,0,37,37
"79348",2015,0,10,0,10
"79350",2015,0,10,0,10
"79352",2015,0,10,0,10
"79354",2020,0,0,37,37
"80002",2019,0,0,77,77
"80003",2017,0,0,94,94
"80004",2019,0,70,0,70
"80004",2020,0,0,63,63
"80005",2017,0,0,94,94
"80008",2019,0,70,0,70
"80008",2020,0,0,63,63
"80010",2019,0,70,77,147
"80014",2019,0,0,77,77
"80015",2019,0,0,77,77
"80017",2019,0,0,77,77
"80018",2019,0,70,0,70
"80018",2020,0,0,63,63
"80021",2019,0,70,77,147
"80022",2019,0,70,0,70
"80022",2020,0,0,63,63
"80023",2019,0,70,77,147
"80025",2017,0,0,94,94
"80026",2019,0,70,0,70
"80026",2020,0,0,63,63
"80027",2019,0,70,77,147
"80028",2017,0,0,94,94
"80030",2019,0,0,38,38
"80031",2019,0,70,77,147
"80032",2019,0,70,77,147
"80033",2019,0,0,77,77
"80034",2019,0,0,77,77
"80035",2019,0,0,77,77
"80036",2019,0,0,77,77
"80037",2019,0,70,77,147
"80039",2019,0,70,0,70
"80039",2020,0,0,63,63
"80040",2019,0,70,0,70
"80041",2019,0,70,0,70
"80041",2020,0,0,63,63
"80042",2017,0,0,94,94
"80043",2017,0,0,94,94
"80044",2017,0,0,94,94
"80046",2020,0,0,63,63
"80049",2019,0,70,77,147
"80053",2019,0,0,77,77
"80054",2019,0,0,77,77
"80055",2017,0,0,94,94
"80057",2017,0,0,94,94
"80058",2019,0,0,77,77
"80060",2017,0,0,94,94
"80061",2019,0,70,0,70
"80061",2020,0,0,63,63
"80062",2019,0,70,0,70
"80062",2020,0,0,63,63
"80063",2019,0,70,0,70
"80063",2020,0,0,63,63
"80064",2019,0,70,77,147
"80067",2019,0,70,77,147
"80068",2017,0,0,94,94
"80070",2017,0,0,94,94
"80071",2017,0,0,94,94
"80074",2019,0,70,77,147
"80080",2019,0,0,77,77
"80081",2019,0,70,0,70
"80081",2020,0,0,63,63
"80084",2019,0,70,0,70
"80084",2020,0,0,63,63
"80085",2017,0,0,94,94
"80086",2017,0,0,94,94
"80087",2019,0,0,38,38
"80088",2019,0,0,77,77
"80090",2019,0,0,77,77
"80094",2019,0,70,77,147
"80095",2017,0,0,94,94
"80096",2019,0,70,0,70
"80096",2020,0,0,63,63
"80097",2019,0,0,77,77
"80098",2019,0,70,0,70
"80098",2020,0,0,63,63
"80101",2019,0,70,77,147
"80102",2019,0,0,77,77
"80103",2019,0,0,77,77
"80104",2019,0,70,0,70
"80104",2020,0,0,63,63
"80105",2019,0,0,77,77
"80107",2019,0,0,77,77
"80108",2017,0,0,94,94
"80109",2019,0,0,38,38
"80110",2019,0,0,38,38
"80112",2019,0,0,77,77
"80113",2017,0,0,94,94
"80114",2019,0,70,77,147
"80115",2019,0,0,77,77
"80116",2019,0,0,77,77
"80118",2017,0,0,94,94
"80120",2019,0,70,0,70
"80120",2020,0,0,63,63
"80121",2019,0,70,77,147
"80122",2017,0,0,94,94
"80125",2019,0,70,77,147
"80126",2019,0,70,0,70
"80126",2020,0,0,63,63
"80127",2019,0,70,0,70
"80127",2020,0,0,63,63
"80128",2019,0,0,77,77
"80131",2019,0,0,77,77
"80132",2019,0,70,77,147
"80133",2019,0,0,38,38
"80136",2019,0,0,77,77
"80139",2019,0,0,77,77
"80140",2017,0,0,94,94
"80141",2019,0,0,77,77
"80143",2019,0,70,0,70
"80143",2020,0,0,63,63
"80144",2019,0,0,77,77
"80148",2019,0,70,0,70
"80148",2020,0,0,63,63
"80149",2019,0,0,38,38
"80150",2019,0,0,77,77
"80152",2019,0,70,77,147
"80153",2017,0,0,94,94
"80154",2019,0,0,77,77
"80156",2019,0,0,77,77
"80158",2019,0,0,77,77
"80159",2019,0,0,77,77
"80160",2019,0,70,77,147
"80162",2019,0,0,77,77
"80164",2019,0,70,77,147
"80165",2019,0,70,0,70
"80165",2020,0,0,63,63
"80167",2019,0,0,38,38
"80168",2017,0,0,94,94
"80169",2019,0,70,0,70
"80169",2020,0,0,63,63
"80170",2019,0,70,77,147
"80172",2019,0,0,77,77
"80174",2019,0,70,77,147
"80176",2019,0,0,77,77
"80177",2019,0,0,77,77
"80179",2019,0,70,0,70
"80179",2020,0,0,63,63
"80181",2019,0,70,77,147
"80183",2019,0,70,0,70
"80183",2020,0,0,63,63
"80184",2019,0,0,77,77
"80185",2019,0,0,77,77
"80186",2019,0,0,77,77
"80188",2019,0,70,77,147
"80189",2019,0,0,77,77
"80190",2019,0,70,0,70
"80190",2020,0,0,63,63
"80191",2019,0,0,77,77
"80192",2019,0,0,77,77
"80193",2019,0,70,77,147
"80194",2019,0,0,77,77
"80195",2019,0,0,77,77
"80197",2019,0,0,77,77
"80199",2019,0,0,77,77
"80201",2017,0,0,94,94
"80203",2017,0,0,94,94
"80204",2019,0,0,77,77
"80208",2017,0,0,94,94
"80212",2019,0,0,77,77
"80213",2019,0,70,77,147
"80214",2019,0,70,77,147
"80215",2017,0,0,94,94
"80217",2017,0,0,94,94
"80220",2019,0,70,77,147
"80221",2017,0,0,94,94
"80222",2019,0,0,38,38
"80223",2019,0,0,77,77
"80224",2019,0,0,77,77
"80226",2019,0,0,77,77
"80227",2019,0,70,0,70
"80227",2020,0,0,63,63
"80228",2019,0,0,38,38
"80230",2019,0,0,77,77
"80231",2019,0,0,77,77
"80232",2019,0,70,77,147
"80233",2019,0,70,77,147
"80234",2019,0,0,77,77
"80235",2019,0,70,0,70
"80235",2020,0,0,63,63
"80236",2019,0,70,77,147
"80237",2019,0,0,77,77
"80239",2019,0,0,77,77
"80240",2019,0,0,77,77
"80242",2019,0,0,77,77
"80243",2017,0,0,94,94
"80244",2017,0,0,94,94
"80245",2017,0,0,94,94
"80246",2019,0,70,77,147
"80247",2019,0,0,77,77
"80248",2019,0,0,38,38
"80250",2019,0,0,38,38
"80251",2019,0,70,0,70
"80251",2020,0,0,63,63
"80252",2019,0,0,77,77
"80253",2017,0,0,94,94
"80258",2019,0,0,77,77
"80259",2019,0,70,0,70
"80259",2020,0,0,63,63
"80260",2019,0,0,38,38
"80261",2019,0,70,77,147
"80263",2019,0,70,77,147
"80264",2019,0,0,77,77
"80265",2019,0,70,0,70
"80265",2020,0,0,63,63
"80267",2019,0,0,77,77
"80270",2017,0,0,94,94
"80271",2019,0,0,77,77
"80272",2019,0,0,77,77
"80273",2019,0,70,0,70
"80273",2020,0,0,63,63
"80274",2019,0,0,77,77
"80275",2019,0,0,77,77
"80278",2019,0,70,77,147
"80279",2019,0,0,77,77
"80283",2019,0,70,77,147
"80284",2019,0,0,77,77
"80285",2019,0,70,77,147
"80288",2019,0,0,77,77
"80290",2019,0,0,38,38
"80291",2019,0,70,77,147
"80292",2019,0,0,77,77
"80293",2019,0,70,77,147
"80294",2019,0,0,77,77
"80295",2019,0,0,77,77
"80298",2019,0,0,77,77
"80299",2019,0,70,77,147
"80300",2019,0,0,77,77
"80302",2019,0,70,77,147
"80303",2019,0,0,38,38
"80304",2019,0,0,77,77
"80306",2019,0,70,77,147
"80307",2019,0,0,77,77
"80308",2019,0,70,0,70
"80308",2020,0,0,63,63
"80310",2017,0,0,94,94
"80311",2019,0,70,77,147
"80312",2019,0,0,77,77
"80313",2019,0,0,77,77
"80315",2019,0,70,77,147
"80320",2019,0,0,77,77
"80321",2019,0,70,77,147
"80322",2019,0,0,77,77
"80324",2019,0,70,0,70
"80324",2020,0,0,63,63
"80325",2019,0,0,77,77
"80326",2019,0,70,77,147
"80327",2019,0,0,38,38
"80329",2017,0,0,94,94
"80330",2019,0,70,0,70
"80330",2020,0,0,63,63
"80331",2019,0,0,38,38
"80332",2019,0,0,38,38
"80333",2017,0,0,94,94
"80335",2019,0,0,77,77
"80336",2019,0,70,0,70
"80336",2020,0,0,63,63
"80337",2019,0,70,77,147
"80338",2019,0,0,77,77
"80339",2019,0,0,77,77
"80340",2019,0,70,0,70
"80340",2020,0,0,63,63
"80342",2019,0,0,77,77
"80343",2019,0,70,0,70
"80343",2020,0,0,63,63
"80347",2019,0,0,77,77
"80349",2019,0,70,77,147
"80353",2019,0,0,77,77
"80354",2019,0,70,0,70
"80354",2020,0,0,63,63
"80355",2019,0,70,0,70
"80355",2020,0,0,63,63
"80356",2019,0,70,0,70
"80356",2020,0,0,63,63
"80358",2019,0,70,77,147
"80359",2019,0,0,77,77
"80360",2019,0,70,0,70
"80360",2020,0,0,63,63
"80362",2019,0,70,0,70
"80362",2020,0,0,63,63
"80364",2019,0,70,0,70
"80364",2020,0,0,63,63
"80365",2019,0,70,0,70
"80365",2020,0,0,63,63
"80366",2019,0,0,77,77
"80367",2019,0,0,77,77
"80368",2019,0,70,0,70
"80368",2020,0,0,63,63
"80369",2017,0,0,94,94
"80371",2019,0,0,38,38
"80373",2019,0,70,0,70
"80373",2020,0,0,63,63
"80374",2019,0,0,38,38
"80375",2019,0,70,0,70
"80375",2020,0,0,63,63
"80376",2019,0,0,77,77
"80377",2017,0,0,94,94
"80378",2019,0,0,77,77
"80379",2019,0,0,77,77
"80381",2017,0,0,94,94
"80383",2019,0,70,77,147
"80386",2019,0,70,77,147
"80387",2019,0,70,77,147
"80388",2019,0,70,0,70
"80388",2020,0,0,63,63
"80390",2019,0,70,77,147
"80391",2019,0,70,77,147
"80392",2017,0,0,94,94
"80393",2019,0,0,77,77
"80395",2019,0,70,77,147
"80396",2019,0,0,38,38
"80400",2019,0,0,77,77
"80401",2019,0,0,77,77
"80403",2019,0,70,77,147
"80404",2019,0,0,77,77
"80405",2019,0,70,77,147
"80407",2019,0,70,77,147
"80409",2019,0,0,77,77
"80410",2019,0,0,77,77
"80411",2019,0,0,77,77
"80412",2019,0,0,77,77
"80413",2019,0,0,77,77
"80414",2019,0,0,77,77
"80415",2019,0,70,77,147
"80417",2019,0,0,77,77
"80418",2019,0,0,77,77
"80421",2019,0,0,77,77
"80422",2019,0,0,38,38
"80424",2019,0,70,77,147
"80426",2019,0,0,77,77
"80427",2017,0,0,94,94
"80428",2019,0,0,77,77
"80430",2019,0,0,77,77
"80431",2017,0,0,94,94
"80432",2019,0,0,77,77
"80433",2019,0,0,77,77
"80434",2019,0,0,77,77
"80435",2019,0,0,77,77
"80436",2019,0,70,0,70
"80436",2020,0,0,63,63
"80438",2019,0,0,77,77
"80439",2017,0,0,94,94
"80440",2017,0,0,94,94
"80442",2019,0,0,77,77
"80443",2019,0,70,0,70
"80443",2020,0,0,63,63
"80445",2017,0,0,94,94
"80446",2019,0,70,0,70
"80446",2020,0,0,63,63
"80449",2019,0,70,77,147
"80450",2019,0,70,0,70
"80450",2020,0,0,63,63
"80452",2019,0,70,77,147
"80453",2019,0,70,77,147
"80456",2019,0,70,0,70
"80456",2020,0,0,63,63
"80458",2019,0,0,77,77
"80460",2019,0,70,0,70
"80460",2020,0,0,63,63
"80461",2019,0,0,77,77
"80462",2019,0,0,38,38
"80463",2019,0,0,77,77
"80465",2019,0,0,77,77
"80467",2019,0,70,77,147
"80469",2019,0,70,77,147
"80470",2017,0,0,94,94
"80473",2019,0,0,77,77
"80474",2019,0,0,77,77
"80475",2019,0,0,77,77
"80477",2019,0,0,38,38
"80478",2019,0,70,77,147
"80479",2019,0,70,0,70
"80479",2020,0,0,63,63
"80480",2019,0,70,0,70
"80480",2020,0,0,63,63
"80481",2019,0,0,77,77
"80484",2019,0,70,0,70
"80484",2020,0,0,63,63
"80485",2019,0,70,77,147
"80487",2019,0,0,77,77
"80489",2019,0,70,77,147
"80490",2019,0,0,77,77
"80491",2017,0,0,94,94
"80493",2017,0,0,94,94
"80494",2019,0,70,77,147
"80495",2017,0,0,94,94
"80496",2019,0,0,38,38
"80497",2019,0,0,38,38
"80498",2017,0,0,94,94
"80499",2019,0,70,77,147
"80500",2019,0,70,0,70
"80500",2020,0,0,63,63
"80501",2019,0,0,38,38
"80503",2017,0,0,94,94
"80504",2019,0,70,77,147
"80505",2019,0,0,77,77
"80507",2019,0,0,77,77
"80508",2019,0,0,77,77
"80509",2019,0,0,77,77
"80511",2019,0,70,77,147
"80513",2019,0,0,77,77
"80514",2017,0,0,94,94
"80515",2019,0,70,0,70
"80515",2020,0,0,63,63
"80516",2019,0,0,77,77
"80517",2019,0,70,77,147
"80518",2019,0,70,0,70
"80518",2020,0,0,63,63
"80519",2019,0,0,77,77
"80520",2019,0,0,77,77
"80521",2019,0,0,77,77
"80522",2019,0,70,0,70
"80522",2020,0,0,63,63
"80523",2019,0,0,77,77
"80524",2019,0,0,77,77
"80525",2019,0,70,0,70
"80525",2020,0,0,63,63
"80526",2017,0,0,94,94
"80527",2019,0,70,0,70
"80527",2020,0,0,63,63
"80530",2019,0,0,77,77
"80531",2019,0,70,0,70
"80531",2020,0,0,63,63
"80533",2019,0,70,0,70
"80533",2020,0,0,63,63
"80536",2019,0,0,77,77
"80537",2017,0,0,94,94
"80538",2019,0,0,77,77
"80541",2019,0,70,77,147
"80542",2019,0,0,77,77
"80544",2017,0,0,94,94
"80545",2019,0,70,77,147
"80552",2019,0,0,77,77
"80554",2019,0,70,0,70
"80554",2020,0,0,63,63
"80555",2019,0,0,77,77
"80557",2019,0,0,77,77
"80560",2019,0,0,77,77
"80561",2019,0,70,77,147
"80563",2017,0,0,94,94
"80566",2017,0,0,94,94
"80568",2019,0,0,77,77
"80569",2019,0,0,77,77
"80570",2019,0,70,77,147
"80571",2019,0,70,77,147
"80572",2019,0,0,77,77
"80573",2019,0,70,0,70
"80573",2020,0,0,63,63
"80575",2019,0,70,0,70
"80575",2020,0,0,63,63
"80576",2019,0,0,77,77
"80579",2019,0,0,77,77
"80580",2017,0,0,94,94
"80584",2017,0,0,94,94
"80585",2019,0,0,77,77
"80586",2019,0,70,0,70
"80586",2020,0,0,63,63
"80587",2019,0,70,0,70
"80587",2020,0,0,63,63
"80589",2017,0,0,94,94
"80590",2019,0,0,38,38
"80591",2019,0,70,0,70
"80591",2020,0,0,63,63
"80592",2019,0,70,0,70
"80592",2020,0,0,63,63
"80593",2019,0,0,77,77
"80595",2019,0,70,77,147
"80596",2017,0,0,94,94
"80597",2019,0,70,0,70
"80597",2020,0,0,63,63
"80598",2019,0,0,38,38
"80599",2019,0,0,38,38
"80600",2019,0,0,38,38
"80601",2019,0,0,77,77
"80602",2017,0,0,94,94
"80604",2019,0,70,0,70
"80604",2020,0,0,63,63
"80605",2019,0,0,77,77
"80606",2019,0,70,0,70
"80606",2020,0,0,63,63
"80611",2019,0,70,77,147
"80613",2019,0,70,0,70
"80613",2020,0,0,63,63
"80614",2017,0,0,94,94
"80616",2019,0,0,77,77
"80617",2019,0,0,77,77
"80620",2019,0,0,77,77
"80621",2019,0,0,77,77
"80623",2019,0,70,77,147
"80625",2019,0,70,77,147
"80628",2019,0,70,77,147
"80629",2019,0,0,77,77
"80631",2017,0,0,94,94
"80633",2019,0,0,38,38
"80634",2019,0,0,77,77
"80637",2019,0,0,38,38
"80638",2019,0,0,77,77
"80642",2017,0,0,94,94
"80644",2019,0,0,77,77
"80645",2017,0,0,94,94
"80646",2019,0,0,77,77
"80647",2019,0,0,77,77
"80649",2019,0,0,38,38
"80651",2019,0,70,0,70
"80651",2020,0,0,63,63
"80652",2019,0,70,77,147
"80657",2019,0,70,77,147
"80658",2019,0,0,77,77
"80659",2017,0,0,94,94
"80662",2019,0,70,0,70
"80662",2020,0,0,63,63
"80663",2019,0,70,0,70
"80663",2020,0,0,63,63
"80664",2019,0,0,77,77
"80665",2019,0,0,38,38
"80666",2017,0,0,94,94
"80667",2019,0,70,77,147
"80668",2019,0,70,77,147
"80669",2019,0,0,77,77
"80671",2017,0,0,94,94
"80676",2019,0,0,77,77
"80677",2019,0,0,77,77
"80678",2019,0,70,77,147
"80679",2019,0,0,77,77
"80680",2019,0,0,77,77
"80681",2019,0,70,77,147
"80682",2019,0,0,77,77
"80683",2019,0,0,77,77
"80684",2019,0,0,77,77
"80685",2019,0,70,77,147
"80687",2019,0,70,77,147
"80688",2019,0,0,38,38
"80690",2019,0,70,77,147
"80691",2019,0,0,38,38
"80692",2019,0,0,38,38
"80693",2019,0,0,77,77
"80694",2019,0,0,77,77
"80695",2019,0,0,77,77
"80696",2019,0,70,77,147
"80697",2017,0,0,94,94
"80698",2019,0,70,0,70
"80698",2020,0,0,63,63
"80699",2019,0,70,0,70
"80699",2020,0,0,63,63
"80701",2019,0,0,77,77
"80702",2019,0,70,77,147
"80703",2019,0,70,0,70
"80703",2020,0,0,63,63
"80705",2017,0,0,94,94
"80707",2019,0,70,0,70
"80707",2020,0,0,63,63
"80708",2019,0,70,77,147
"80709",2019,0,70,0,70
"80709",2020,0,0,63,63
"80710",2019,0,70,0,70
"80710",2020,0,0,63,63
"80713",2019,0,0,38,38
"80714",2019,0,70,0,70
"80714",2020,0,0,63,63
"80717",2019,0,70,77,147
"80726",2019,0,0,77,77
"80729",2019,0,70,77,147
"80732",2019,0,70,0,70
"80732",2020,0,0,63,63
"80737",2019,0,0,77,77
"80740",2019,0,70,77,147
"80741",2019,0,0,77,77
"80743",2019,0,0,77,77
"80746",2017,0,0,94,94
"80747",2019,0,0,77,77
"80748",2019,0,0,77,77
"80749",2017,0,0,94,94
"80750",2019,0,0,77,77
"80751",2019,0,70,77,147
"80752",2019,0,70,77,147
"80754",2019,0,70,0,70
"80754",2020,0,0,63,63
"80756",2017,0,0,94,94
"80758",2019,0,70,77,147
"80759",2019,0,70,77,147
"80760",2019,0,70,0,70
"80760",2020,0,0,63,63
"80762",2019,0,0,77,77
"80763",2019,0,0,38,38
"80765",2019,0,70,0,70
"80765",2020,0,0,63,63
"80766",2017,0,0,94,94
"80767",2019,0,70,0,70
"80767",2020,0,0,63,63
"80769",2019,0,0,77,77
"80770",2019,0,70,0,70
"80770",2020,0,0,63,63
"80771",2019,0,0,77,77
"80774",2019,0,0,77,77
"80776",2017,0,0,94,94
"80777",2017,0,0,94,94
"80781",2019,0,0,77,77
"80784",2019,0,0,77,77
"80785",2019,0,0,77,77
"80787",2019,0,0,38,38
"80789",2019,0,0,77,77
"80790",2019,0,70,77,147
"80792",2017,0,0,94,94
"80794",2019,0,0,77,77
"80796",2019,0,70,0,70
"80796",2020,0,0,63,63
"80797",2019,0,70,77,147
"80799",2019,0,0,77,77
"80800",2019,0,70,0,70
"80800",2020,0,0,63,63
"80801",2019,0,0,77,77
"80802",2019,0,0,77,77
"80803",2019,0,70,77,147
"80805",2019,0,70,77,147
"80806",2019,0,0,38,38
"80807",2019,0,0,77,77
"80808",2019,0,0,38,38
"80809",2019,0,70,0,70
"80809",2020,0,0,63,63
"80810",2017,0,0,94,94
"80811",2019,0,0,77,77
"80812",2019,0,0,77,77
"80813",2019,0,70,0,70
"80813",2020,0,0,63,63
"80814",2019,0,70,77,147
"80815",2019,0,0,38,38
"80822",2019,0,70,77,147
"80823",2019,0,0,77,77
"80824",2019,0,0,77,77
"80827",2019,0,70,0,70
"80827",2020,0,0,63,63
"80829",2019,0,0,77,77
"80832",2019,0,0,38,38
"80833",2019,0,0,38,38
"80834",2019,0,70,0,70
"80834",2020,0,0,63,63
"81003",2014,0,123,57,180
"81003",2015,0,0,2,2
"81003",2018,0,0,7,7
"81003",2020,0,0,42,42
"81010",2014,0,123,57,180
"81010",2015,0,0,2,2
"81010",2018,0,0,7,7
"81010",2020,0,0,42,42
"81016",2020,0,0,23,23
"81024",2020,0,0,23,23
"81030",2015,0,0,33,33
"81040",2014,0,32,94,126
"81040",2015,0,0,6,6
"81040",2020,0,0,42,42
"81046",2014,0,64,64,128
"81046",2018,0,0,13,13
"81054",2020,0,0,23,23
"81064",2020,0,0,23,23
"81065",2014,0,32,94,126
"81065",2015,0,0,6,6
"81065",2020,0,0,42,42
"81075",2014,0,32,94,126
"81075",2015,0,0,6,6
"81075",2020,0,0,42,42
"81077",2020,0,0,69,69
"81079",2014,0,123,57,180
"81079",2015,0,0,2,2
"81079",2018,0,0,7,7
"81079",2020,0,0,42,42
"81084",2020,0,0,23,23
"81085",2020,0,0,69,69
"81088",2014,0,123,57,180
"81088",2015,0,0,2,2
"81088",2018,0,0,7,7
"81088",2020,0,0,42,42
"81096",2014,0,123,57,180
"81096",2015,0,0,2,2
"81096",2018,0,0,7,7
"81096",2020,0,0,42,42
"81097",2014,0,123,57,180
"81097",2015,0,0,2,2
"81097",2018,0,0,7,7
"81097",2020,0,0,42,42
"81099",2020,0,0,23,23
"81105",2014,0,64,64,128
"81105",2018,0,0,13,13
"81106",2020,0,0,23,23
"81109",2014,0,32,94,126
"81109",2015,0,0,6,6
"81109",2020,0,0,42,42
"81117",2014,0,64,64,128
"81117",2018,0,0,13,13
"81118",2014,0,32,94,126
"81118",2015,0,0,6,6
"81118",2020,0,0,42,42
"81119",2014,0,123,57,180
"81119",2018,0,0,7,7
"81120",2020,0,0,23,23
"81124",2020,0,0,69,69
"81132",2015,0,0,33,33
"81133",2014,0,123,57,180
"81133",2018,0,0,7,7
"81136",2020,0,0,23,23
"81138",2014,0,64,64,128
"81138",2018,0,0,13,13
"81139",2014,0,32,94,126
"81139",2015,0,0,6,6
"81139",2020,0,0,42,42
"81145",2020,0,0,23,23
"81147",2014,0,123,57,180
"81147",2018,0,0,7,7
"81151",2015,0,0,33,33
"81160",2020,0,0,23,23
"81167",2020,0,0,69,69
"81174",2014,0,64,64,128
"81174",2018,0,0,13,13
"81175",2020,0,0,23,23
"81177",2014,0,32,94,126
"81177",2015,0,0,6,6
"81177",2020,0,0,42,42
"81178",2020,0,0,23,23
"81181",2014,0,32,94,126
"81181",2015,0,0,6,6
"81181",2020,0,0,42,42
"81182",2014,0,32,94,126
"81182",2015,0,0,6,6
"81182",2020,0,0,42,42
"81187",2014,0,32,94,126
"81187",2015,0,0,6,6
"81187",2020,0,0,42,42
"81190",2014,0,123,57,180
"81190",2015,0,0,2,2
"81190",2018,0,0,7,7
"81190",2020,0,0,42,42
"81195",2020,0,0,23,23
"81198",2014,0,64,64,128
"81198",2018,0,0,13,13
"81203",2014,0,123,57,180
"81203",2015,0,0,2,2
"81203",2018,0,0,7,7
"81203",2020,0,0,42,42
"81207",2014,0,32,94,126
"81207",2015,0,0,6,6
"81207",2020,0,0,42,42
"81211",2014,0,64,64,128
"81211",2018,0,0,13,13
"81212",2015,0,0,33,33
"81216",2014,0,32,94,126
"81216",2015,0,0,6,6
"81216",2020,0,0,42,42
"81217",2020,0,0,23,23
"81218",2014,0,123,57,180
"81218",2015,0,0,2,2
"81218",2018,0,0,7,7
"81218",2020,0,0,42,42
"81219",2014,0,32,50,82
"81219",2015,0,0,6,6
"81220",2020,0,0,23,23
"81222",2014,0,123,57,180
"81222",2015,0,0,2,2
"81222",2018,0,0,7,7
"81222",2020,0,0,42,42
"81227",2014,0,32,94,126
"81227",2015,0,0,6,6
"81227",2020,0,0,42,42
"81233",2014,0,123,57,180
"81233",2015,0,0,2,2
"81233",2018,0,0,7,7
"81233",2020,0,0,42,42
"81235",2020,0,0,23,23
"81251",2015,0,0,33,33
"81252",2014,0,32,94,126
"81252",2015,0,0,6,6
"81252",2020,0,0,42,42
"81256",2014,0,32,94,126
"81256",2015,0,0,6,6
"81256",2020,0,0,42,42
"81266",2015,0,0,33,33
"81272",2020,0,0,23,23
"81273",2020,0,0,23,23
"81276",2020,0,0,23,23
"81279",2020,0,0,23,23
"81287",2014,0,123,57,180
"81287",2018,0,0,7,7
"81289",2020,0,0,23,23
"81293",2020,0,0,23,23
"81295",2014,0,123,57,180
"81295",2015,0,0,2,2
"81295",2018,0,0,7,7
"81295",2020,0,0,42,42
"81299",2015,0,0,33,33
"81311",2014,0,32,94,126
"81311",2015,0,0,6,6
"81311",2020,0,0,42,42
"81312",2020,0,0,23,23
"81315",2014,0,32,94,126
"81315",2015,0,0,6,6
"81315",2020,0,0,42,42
"81317",2014,0,123,57,180
"81317",2015,0,0,2,2
"81317",2018,0,0,7,7
"81317",2020,0,0,42,42
"81325",2020,0,0,23,23
"83001",2017,0,123,50,173
"83001",2019,0,0,54,54
"83001",2020,0,0,77,77
"83002",2017,0,123,0,123
"83002",2020,0,0,77,77
"83003",2017,0,123,0,123
"83003",2020,0,0,77,77
"83004",2017,0,123,0,123
"83004",2020,0,0,77,77
"83005",2016,0,0,85,85
"83005",2017,0,123,0,123
"83005",2020,0,0,77,77
"83006",2017,0,123,0,123
"83006",2019,0,0,46,46
"83007",2017,0,123,0,123
"83007",2020,0,0,77,77
"83008",2017,0,123,50,173
"83008",2019,0,0,54,54
"83008",2020,0,0,77,77
"83009",2017,0,123,0,123
"83009",2019,0,0,111,111
"83009",2020,0,0,77,77
"83010",2017,0,123,0,123
"83010",2020,0,0,77,77
"83011",2017,0,123,0,123
"83011",2020,0,0,77,77
"83012",2017,0,123,0,123
"83012",2020,0,0,77,77
"83013",2016,0,0,85,85
"83013",2017,0,123,0,123
"83013",2020,0,0,77,77
"83014",2016,0,0,85,85
"83014",2017,0,123,0,123
"83014",2020,0,0,77,77
"83015",2016,0,0,85,85
"83015",2017,0,123,0,123
"83015",2020,0,0,77,77
"83016",2017,0,123,0,123
"83016",2019,0,0,111,111
"83016",2020,0,0,77,77
"83017",2017,0,123,0,123
"83017",2019,0,0,111,111
"83017",2020,0,0,77,77
"83018",2017,0,123,0,123
"83018",2019,0,0,54,54
"83018",2020,0,0,77,77
"83019",2017,0,123,0,123
"83019",2019,0,111,111,222
"83019",2020,0,77,77,154
"83020",2016,0,0,85,85
"83020",2017,0,123,0,123
"83020",2020,0,0,77,77
"83021",2017,0,123,0,123
"83021",2020,0,0,77,77
"83022",2016,0,0,85,85
"83022",2017,0,123,0,123
"83022",2020,0,0,77,77
"83023",2017,0,123,0,123
"83023",2020,0,0,77,77
"83025",2017,0,123,0,123
"83025",2020,0,0,77,77
"83026",2017,0,123,0,123
"83026",2020,0,0,77,77
"83027",2017,0,123,0,123
"83027",2019,0,0,111,111
"83027",2020,0,0,77,77
"83028",2017,0,123,0,123
"83028",2020,0,0,77,77
"83029",2017,0,123,50,173
"83029",2019,0,0,54,54
"83029",2020,0,0,77,77
"83030",2017,0,123,0,123
"83030",2020,0,0,77,77
"83031",2017,0,123,0,123
"83031",2020,0,0,77,77
"83032",2017,0,123,0,123
"83032",2020,0,0,77,77
"83033",2017,0,123,0,123
"83033",2019,0,0,54,54
"83033",2020,0,0,77,77
"83034",2017,0,123,0,123
"83034",2019,0,0,111,111
"83034",2020,0,0,77,77
"83035",2017,0,123,0,123
"83035",2019,0,0,111,111
"83035",2020,0,0,77,77
"83036",2017,0,123,0,123
"83036",2019,0,0,111,111
"83036",2020,0,0,77,77
"83037",2017,0,123,0,123
"83037",2020,0,0,77,77
"83038",2017,0,123,0,123
"83038",2020,0,0,77,77
"83039",2017,0,123,0,123
"83039",2020,0,0,77,77
"83040",2016,0,0,85,85
"83040",2017,0,123,0,123
"83040",2020,0,0,77,77
"83041",2017,0,123,0,123
"83041",2020,0,0,77,77
"83042",2017,0,123,0,123
"83042",2019,0,111,111,222
"83042",2020,0,77,77,154
"83043",2017,0,123,0,123
"83043",2019,0,0,54,54
"83043",2020,0,0,77,77
"83044",2017,0,123,0,123
"83044",2020,0,0,77,77
"83045",2017,0,123,0,123
"83045",2020,0,0,77,77
"83046",2017,0,123,0,123
"83046",2020,0,0,77,77
"83047",2017,0,123,0,123
"83047",2019,0,0,111,111
"83047",2020,0,0,77,77
"83048",2017,0,123,0,123
"83048",2019,0,0,111,111
"83048",2020,0,0,77,77
"83049",2017,0,123,0,123
"83049",2019,0,0,54,54
"83049",2020,0,0,77,77
"83050",2017,0,123,0,123
"83050",2020,0,0,77,77
"83051",2017,0,123,0,123
"83051",2020,0,0,77,77
"83052",2017,0,123,0,123
"83052",2019,0,0,54,54
"83052",2020,0,0,77,77
"83053",2017,0,123,0,123
"83053",2019,0,0,111,111
"83053",2020,0,0,77,77
"83054",2017,0,123,0,123
"83054",2019,0,0,111,111
"83054",2020,0,0,77,77
"83055",2017,0,123,50,173
"83055",2019,0,0,54,54
"83055",2020,0,0,77,77
"83056",2017,0,123,0,123
"83056",2020,0,0,77,77
"83057",2017,0,123,0,123
"83057",2019,0,0,54,54
"83057",2020,0,0,77,77
"83058",2017,0,123,0,123
"83058",2020,0,0,77,77
"83059",2017,0,123,0,123
"83059",2020,0,0,77,77
"83060",2017,0,123,0,123
"83060",2020,0,0,77,77
"83061",2017,0,123,50,173
"83061",2019,0,111,54,165
"83061",2020,0,77,77,154
"83062",2017,0,123,0,123
"83062",2019,0,0,111,111
"83062",2020,0,0,77,77
"83063",2017,0,123,0,123
"83063",2019,0,0,54,54
"83063",2020,0,0,77,77
"83064",2017,0,123,0,123
"83064",2020,0,0,77,77
"83065",2017,0,123,0,123
"83065",2019,0,111,111,222
"83065",2020,0,77,77,154
"83066",2017,0,123,0,123
"83066",2019,0,0,54,54
"83067",2017,0,123,0,123
"83067",2019,0,0,54,54
"83067",2020,0,0,77,77
"83068",2017,0,123,0,123
"83068",2019,0,111,54,165
"83068",2020,0,77,77,154
"83069",2017,0,123,0,123
"83069",2019,0,0,111,111
"83069",2020,0,0,77,77
"83070",2017,0,123,0,123
"83070",2019,0,111,111,222
"83070",2020,0,77,77,154
"83071",2017,0,123,0,123
"83071",2019,0,0,111,111
"83071",2020,0,0,77,77
"83072",2017,0,123,0,123
"83072",2020,0,0,77,77
"83073",2017,0,123,0,123
"83073",2020,0,0,77,77
"83074",2016,0,0,85,85
"83074",2017,0,123,0,123
"83074",2020,0,0,77,77
"83075",2017,0,123,0,123
"83075",2019,0,0,54,54
"83075",2020,0,0,77,77
"83076",2017,0,123,0,123
"83076",2019,0,0,54,54
"83076",2020,0,0,77,77
"83077",2017,0,123,0,123
"83077",2019,0,0,54,54
"83077",2020,0,0,77,77
"83078",2017,0,123,0,123
"83078",2020,0,0,77,77
"83079",2017,0,123,0,123
"83079",2019,0,111,111,222
"83079",2020,0,77,77,154
"83080",2017,0,123,50,173
"83080",2019,0,0,54,54
"83080",2020,0,0,77,77
"83081",2017,0,123,50,173
"83081",2019,0,0,54,54
"83081",2020,0,0,77,77
"83082",2017,0,123,0,123
"83082",2020,0,0,77,77
"83083",2017,0,123,0,123
"83083",2020,0,0,77,77
"83084",2017,0,123,0,123
"83084",2020,0,0,77,77
"83085",2017,0,123,0,123
"83085",2020,0,0,77,77
"83086",2017,0,123,0,123
"83086",2019,0,111,54,165
"83086",2020,0,77,77,154
"83087",2017,0,123,0,123
"83087",2019,0,0,46,46
"83087",2020,0,0,10,10
"83088",2017,0,123,0,123
"83088",2019,0,0,54,54
"83088",2020,0,0,77,77
"83089",2017,0,123,0,123
"83089",2019,0,0,46,46
"83089",2020,0,0,10,10
"83090",2017,0,123,0,123
"83090",2019,0,0,111,111
"83090",2020,0,0,77,77
"83091",2017,0,123,0,123
"83091",2019,0,0,111,111
"83091",2020,0,0,77,77
"83092",2017,0,123,0,123
"83092",2019,0,0,54,54
"83092",2020,0,0,77,77
"83093",2017,0,123,0,123
"83093",2019,0,0,54,54
"83093",2020,0,0,77,77
"83094",2017,0,123,0,123
"83094",2019,0,0,54,54
"83094",2020,0,0,77,77
"83095",2017,0,123,0,123
"83095",2020,0,0,77,77
"83096",2017,0,123,0,123
"83096",2020,0,0,10,10
"83097",2017,0,123,0,123
"83097",2019,0,0,46,46
"83098",2017,0,123,0,123
"83098",2019,0,0,111,111
"83098",2020,0,0,77,77
"83099",2017,0,123,0,123
"83099",2019,0,111,0,111
"83099",2020,0,77,77,154
"83100",2017,0,123,0,123
"83100",2019,0,0,54,54
"83100",2020,0,0,77,77
"83101",2017,0,123,0,123
"83101",2019,0,0,111,111
"83101",2020,0,0,77,77
"83102",2017,0,123,0,123
"83102",2020,0,0,77,77
"83103",2017,0,123,0,123
"83103",2019,0,0,111,111
"83103",2020,0,0,77,77
"83104",2017,0,123,0,123
"83104",2019,0,0,46,46
"83105",2017,0,123,0,123
"83105",2019,0,0,111,111
"83105",2020,0,0,77,77
"83106",2017,0,123,0,123
"83106",2019,0,0,54,54
"83106",2020,0,0,77,77
"83107",2017,0,123,0,123
"83107",2019,0,111,54,165
"83107",2020,0,77,77,154
"83108",2017,0,123,0,123
"83108",2019,0,0,54,54
"83108",2020,0,0,77,77
"83109",2017,0,123,50,173
"83109",2019,0,0,54,54
"83109",2020,0,0,77,77
"83110",2017,0,123,0,123
"83110",2020,0,0,77,77
"83111",2017,0,123,0,123
"83111",2019,0,0,54,54
"83111",2020,0,0,77,77
"83112",2017,0,123,0,123
"83112",2019,0,0,111,111
"83112",2020,0,0,77,77
"83113",2017,0,123,0,123
"83113",2019,0,0,54,54
"83113",2020,0,0,77,77
"83114",2017,0,123,0,123
"83114",2020,0,0,77,77
"83115",2017,0,123,0,123
"83115",2019,0,0,54,54
"83115",2020,0,0,77,77
"83116",2017,0,123,0,123
"83116",2020,0,0,10,10
"83117",2017,0,123,50,173
"83117",2019,0,0,54,54
"83117",2020,0,0,77,77
"83118",2017,0,123,0,123
"83118",2020,0,0,77,77
"83119",2017,0,123,0,123
"83119",2019,0,0,111,111
"83119",2020,0,0,77,77
"83120",2017,0,123,0,123
"83120",2019,0,0,54,54
"83120",2020,0,0,77,77
"83121",2017,0,123,0,123
"83121",2020,0,0,77,77
"83122",2016,0,0,85,85
"83122",2017,0,123,0,123
"83122",2020,0,0,77,77
"83123",2017,0,123,0,123
"83123",2019,0,0,111,111
"83123",2020,0,0,77,77
"83124",2017,0,123,50,173
"83124",2019,0,0,54,54
"83124",2020,0,0,77,77
"83125",2017,0,123,0,123
"83125",2020,0,0,77,77
"83126",2017,0,123,0,123
"83126",2019,0,0,111,111
"83126",2020,0,0,77,77
"83127",2017,0,123,0,123
"83127",2019,0,0,54,54
"83127",2020,0,0,77,77
"83128",2017,0,123,0,123
"83128",2020,0,0,77,77
"83129",2017,0,123,0,123
"83129",2019,0,0,111,111
"83129",2020,0,0,77,77
"83130",2017,0,123,0,123
"83130",2019,0,0,111,111
"83130",2020,0,0,77,77
"83131",2017,0,123,0,123
"83131",2019,0,0,111,111
"83131",2020,0,0,77,77
"83132",2017,0,123,0,123
"83132",2019,0,0,111,111
"83132",2020,0,0,77,77
"83133",2017,0,123,50,173
"83133",2019,0,0,54,54
"83133",2020,0,0,77,77
"83134",2017,0,123,0,123
"83134",2020,0,0,77,77
"83135",2017,0,123,0,123
"83135",2020,0,0,77,77
"83136",2017,0,123,0,123
"83136",2020,0,0,77,77
"83137",2017,0,123,0,123
"83137",2019,0,0,111,111
"83137",2020,0,0,77,77
"83138",2017,0,123,50,173
"83138",2019,0,0,54,54
"83138",2020,0,0,77,77
"83139",2017,0,123,0,123
"83139",2020,0,0,77,77
"83140",2017,0,123,0,123
"83140",2020,0,0,77,77
"83141",2017,0,123,0,123
"83141",2020,0,0,77,77
"83142",2017,0,123,0,123
"83142",2020,0,0,77,77
"83143",2017,0,123,0,123
"83143",2020,0,0,77,77
"83144",2017,0,123,0,123
"83144",2019,0,0,111,111
"83144",2020,0,0,77,77
"83145",2017,0,123,0,123
"83145",2020,0,0,77,77
"83146",2017,0,123,0,123
"83146",2019,0,0,54,54
"83146",2020,0,0,77,77
"83147",2017,0,123,0,123
"83147",2020,0,0,77,77
"83148",2017,0,123,0,123
"83148",2019,0,0,54,54
"83148",2020,0,0,77,77
"83149",2017,0,123,0,123
"83149",2020,0,0,77,77
"83150",2016,0,0,5,5
"83150",2017,0,123,0,123
"83150",2019,0,0,67,67
"83150",2020,0,0,77,77
"83151",2017,0,123,0,123
"83151",2020,0,0,77,77
"83152",2017,0,123,0,123
"83152",2019,0,0,111,111
"83152",2020,0,0,77,77
"83153",2017,0,123,0,123
"83153",2019,0,0,111,111
"83153",2020,0,0,77,77
"83154",2017,0,123,0,123
"83154",2020,0,0,77,77
"84001",2014,0,0,55,55
"84001",2015,0,0,35,35
"84001",2016,0,0,18,18
"84001",2017,0,107,24,131
"84001",2019,0,14,123,137
"84001",2020,0,0,42,42
"84002",2014,0,0,55,55
"84002",2017,0,107,24,131
"84002",2019,0,14,14,28
"84002",2020,0,0,42,42
"84003",2014,0,0,55,55
"84003",2017,0,107,24,131
"84003",2019,0,14,14,28
"84004",2014,0,0,55,55
"84004",2016,0,0,18,18
"84004",2017,0,107,24,131
"84004",2019,0,14,24,38
"84005",2014,0,0,55,55
"84005",2017,0,107,24,131
"84005",2019,0,14,14,28
"84006",2014,0,0,55,55
"84006",2017,0,107,24,131
"84006",2019,0,14,14,28
"84007",2014,0,0,55,55
"84007",2016,0,0,18,18
"84007",2017,0,107,107,214
"84007",2019,0,14,83,97
"84007",2020,0,0,42,42
"84008",2014,0,0,55,55
"84008",2016,0,0,18,18
"84008",2017,0,107,24,131
"84008",2019,0,14,24,38
"84009",2014,0,0,55,55
"84009",2017,0,107,24,131
"84009",2019,0,14,14,28
"84009",2020,0,0,42,42
"84010",2014,0,0,55,55
"84010",2017,0,107,24,131
"84010",2019,0,14,14,28
"84010",2020,0,0,42,42
"84011",2014,0,0,55,55
"84011",2017,0,107,24,131
"84011",2019,0,14,14,28
"84012",2014,0,0,55,55
"84012",2016,0,0,18,18
"84012",2017,0,107,24,131
"84012",2019,0,14,24,38
"84013",2014,0,0,55,55
"84013",2017,0,107,24,131
"84013",2019,0,14,14,28
"84014",2014,0,0,55,55
"84014",2017,0,107,24,131
"84014",2019,0,14,14,28
"84014",2020,0,0,42,42
"84015",2014,0,0,55,55
"84015",2016,0,0,18,18
"84015",2017,0,107,24,131
"84015",2019,0,14,24,38
"84016",2014,0,0,55,55
"84016",2016,0,0,18,18
"84016",2017,0,107,24,131
"84016",2019,0,14,24,38
"84017",2014,0,0,55,55
"84017",2016,0,0,18,18
"84017",2017,0,107,24,131
"84017",2019,0,14,24,38
"84018",2014,0,0,55,55
"84018",2017,0,107,24,131
"84018",2019,0,14,14,28
"84019",2014,0,0,55,55
"84019",2016,0,0,18,18
"84019",2017,0,107,24,131
"84019",2019,0,14,14,28
"84020",2014,0,0,55,55
"84020",2017,0,107,24,131
"84020",2019,0,14,14,28
"84021",2014,0,0,55,55
"84021",2017,0,107,24,131
"84021",2019,0,14,14,28
"84022",2014,0,0,55,55
"84022",2016,0,0,18,18
"84022",2017,0,107,24,131
"84022",2019,0,14,24,38
"84023",2014,0,0,55,55
"84023",2017,0,107,24,131
"84023",2019,0,14,14,28
"84024",2014,0,0,55,55
"84024",2017,0,107,24,131
"84024",2019,0,14,14,28
"84025",2014,0,0,55,55
"84025",2017,0,107,24,131
"84025",2019,0,14,14,28
"84026",2014,0,0,55,55
"84026",2017,0,107,24,131
"84026",2019,0,14,14,28
"84026",2020,0,0,42,42
"84027",2014,0,0,55,55
"84027",2016,0,0,18,18
"84027",2017,0,107,24,131
"84027",2019,0,14,24,38
"84028",2014,0,0,55,55
"84028",2016,0,0,18,18
"84028",2017,0,107,24,131
"84028",2019,0,14,24,38
"84029",2014,0,0,55,55
"84029",2016,0,0,18,18
"84029",2017,0,107,24,131
"84029",2019,0,14,24,38
"84030",2014,0,0,55,55
"84030",2016,0,0,18,18
"84030",2017,0,107,24,131
"84030",2019,0,14,24,38
"84031",2014,0,0,55,55
"84031",2016,0,0,18,18
"84031",2017,0,107,24,131
"84031",2019,0,14,24,38
"84032",2014,0,0,55,55
"84032",2017,0,107,24,131
"84032",2019,0,14,14,28
"84033",2014,0,0,55,55
"84033",2017,0,107,24,131
"84033",2019,0,14,14,28
"84034",2014,0,0,55,55
"84034",2016,0,0,18,18
"84034",2017,0,107,24,131
"84034",2019,0,14,123,137
"84034",2020,0,0,42,42
"84035",2014,0,0,55,55
"84035",2017,0,107,24,131
"84035",2019,0,14,14,28
"84036",2014,0,0,55,55
"84036",2016,0,0,18,18
"84036",2017,0,107,24,131
"84036",2019,0,14,83,97
"84036",2020,0,0,42,42
"84037",2014,0,0,55,55
"84037",2016,0,0,18,18
"84037",2017,0,107,24,131
"84037",2019,0,14,24,38
"84038",2014,0,0,55,55
"84038",2017,0,107,24,131
"84038",2019,0,14,14,28
"84039",2014,0,0,55,55
"84039",2016,0,0,18,18
"84039",2017,0,107,24,131
"84039",2019,0,14,24,38
"84040",2014,0,0,55,55
"84040",2016,0,0,18,18
"84040",2017,0,107,24,131
"84040",2019,0,14,24,38
"84041",2014,0,0,55,55
"84041",2016,0,0,18,18
"84041",2017,0,107,24,131
"84041",2019,0,14,24,38
"84042",2014,0,0,55,55
"84042",2017,0,107,24,131
"84042",2019,0,14,14,28
"84042",2020,0,0,42,42
"84043",2014,0,0,55,55
"84043",2015,0,0,35,35
"84043",2016,0,0,18,18
"84043",2017,0,107,24,131
"84043",2019,0,14,123,137
"84043",2020,0,0,42,42
"84044",2014,0,0,55,55
"84044",2016,0,0,18,18
"84044",2017,0,107,24,131
"84044",2019,0,14,24,38
"84045",2014,0,0,55,55
"84045",2016,0,0,18,18
"84045",2017,0,107,24,131
"84045",2019,0,14,24,38
"84046",2014,0,0,55,55
"84046",2017,0,107,24,131
"84046",2019,0,14,14,28
"84047",2014,0,0,55,55
"84047",2017,0,107,24,131
"84047",2019,0,14,14,28
"84048",2014,0,0,55,55
"84048",2017,0,107,24,131
"84048",2019,0,14,14,28
"84049",2014,0,0,55,55
"84049",2016,0,0,18,18
"84049",2017,0,107,24,131
"84049",2019,0,14,24,38
"84050",2014,0,0,55,55
"84050",2017,0,107,24,131
"84050",2019,0,14,14,28
"84051",2014,0,0,55,55
"84051",2017,0,107,24,131
"84051",2019,0,14,14,28
"84052",2014,0,0,55,55
"84052",2017,0,107,24,131
"84052",2019,0,14,14,28
"84052",2020,0,0,42,42
"84053",2014,0,0,55,55
"84053",2016,0,0,18,18
"84053",2017,0,107,24,131
"84053",2019,0,14,14,28
"84054",2014,0,0,55,55
"84054",2017,0,107,24,131
"84054",2019,0,14,14,28
"84055",2014,0,0,55,55
"84055",2015,0,0,35,35
"84055",2016,0,0,18,18
"84055",2017,0,107,24,131
"84055",2019,0,14,123,137
"84055",2020,0,0,42,42
"84056",2014,0,0,55,55
"84056",2016,0,0,18,18
"84056",2017,0,107,24,131
"84056",2019,0,14,24,38
"84057",2014,0,0,55,55
"84057",2017,0,107,24,131
"84057",2019,0,14,14,28
"84058",2014,0,0,55,55
"84058",2017,0,107,24,131
"84058",2019,0,14,14,28
"84059",2014,0,0,55,55
"84059",2016,0,0,18,18
"84059",2017,0,107,24,131
"84059",2019,0,14,24,38
"84060",2014,0,0,55,55
"84060",2017,0,107,24,131
"84060",2019,0,14,14,28
"84061",2014,0,0,55,55
"84061",2016,0,0,18,18
"84061",2017,0,107,24,131
"84061",2019,0,14,14,28
"84062",2014,0,0,55,55
"84062",2017,0,107,24,131
"84062",2019,0,14,14,28
"84063",2014,0,0,55,55
"84063",2015,0,0,35,35
"84063",2016,0,0,79,79
"84063",2017,0,107,132,239
"84063",2019,0,14,83,97
"84063",2020,0,0,42,42
"84064",2014,0,0,55,55
"84064",2015,0,0,35,35
"84064",2016,0,0,79,79
"84064",2017,0,107,132,239
"84064",2019,0,14,83,97
"84064",2020,0,0,42,42
"84065",2014,0,0,55,55
"84065",2017,0,107,24,131
"84065",2019,0,14,14,28
"84065",2020,0,0,42,42
"84066",2014,0,0,55,55
"84066",2017,0,107,24,131
"84066",2019,0,14,14,28
"84067",2014,0,0,55,55
"84067",2016,0,0,18,18
"84067",2017,0,107,24,131
"84067",2019,0,14,24,38
"84068",2014,0,0,55,55
"84068",2017,0,107,24,131
"84068",2019,0,14,14,28
"84068",2020,0,0,42,42
"84069",2014,0,0,55,55
"84069",2016,0,0,18,18
"84069",2017,0,107,24,131
"84069",2019,0,14,24,38
"84070",2014,0,0,55,55
"84070",2017,0,107,24,131
"84070",2019,0,14,14,28
"84071",2014,0,0,55,55
"84071",2017,0,107,24,131
"84071",2019,0,14,14,28
"84072",2014,0,0,55,55
"84072",2017,0,107,24,131
"84072",2019,0,14,14,28
"84073",2014,0,0,55,55
"84073",2017,0,107,24,131
"84073",2019,0,14,14,28
"84074",2014,0,0,55,55
"84074",2017,0,107,24,131
"84074",2019,0,14,14,28
"84074",2020,0,0,42,42
"84075",2014,0,0,55,55
"84075",2017,0,107,24,131
"84075",2019,0,14,14,28
"84076",2014,0,0,55,55
"84076",2017,0,107,24,131
"84076",2019,0,14,14,28
"84076",2020,0,0,42,42
"84077",2014,0,0,55,55
"84077",2016,0,0,18,18
"84077",2017,0,107,24,131
"84077",2019,0,14,24,38
"84078",2014,0,0,55,55
"84078",2016,0,0,18,18
"84078",2017,0,107,24,131
"84078",2019,0,14,14,28
"84079",2014,0,0,55,55
"84079",2017,0,107,24,131
"84079",2019,0,14,14,28
"84080",2014,0,0,55,55
"84080",2016,0,0,18,18
"84080",2017,0,107,24,131
"84080",2019,0,14,24,38
"84081",2014,0,0,55,55
"84081",2016,0,0,18,18
"84081",2017,0,107,24,131
"84081",2019,0,14,83,97
"84081",2020,0,0,42,42
"84082",2014,0,0,55,55
"84082",2016,0,0,18,18
"84082",2017,0,107,24,131
"84082",2019,0,14,24,38
"84083",2014,0,0,55,55
"84083",2016,0,0,18,18
"84083",2017,0,107,24,131
"84083",2019,0,14,14,28
"84084",2014,0,0,55,55
"84084",2017,0,107,24,131
"84084",2019,0,14,14,28
"84085",2014,0,0,55,55
"84085",2017,0,107,24,131
"84085",2019,0,14,14,28
"84086",2014,0,0,55,55
"84086",2017,0,107,24,131
"84086",2019,0,14,14,28
"84087",2014,0,0,55,55
"84087",2016,0,0,18,18
"84087",2017,0,107,24,131
"84087",2019,0,14,24,38
"84088",2014,0,0,55,55
"84088",2017,0,107,24,131
"84088",2019,0,14,14,28
"84089",2014,0,0,55,55
"84089",2017,0,107,24,131
"84089",2019,0,14,14,28
"84089",2020,0,0,42,42
"84090",2014,0,0,55,55
"84090",2017,0,107,24,131
"84090",2019,0,14,14,28
"84091",2014,0,0,55,55
"84091",2016,0,0,18,18
"84091",2017,0,107,24,131
"84091",2019,0,14,24,38
"84092",2014,0,0,55,55
"84092",2016,0,0,18,18
"84092",2017,0,107,24,131
"84092",2019,0,14,24,38
"84093",2014,0,0,55,55
"84093",2017,0,107,24,131
"84093",2019,0,14,14,28
"84093",2020,0,0,42,42
"84094",2014,0,0,55,55
"84094",2016,0,0,18,18
"84094",2017,0,107,24,131
"84094",2019,0,14,24,38
"84095",2014,0,0,55,55
"84095",2017,0,107,24,131
"84095",2019,0,14,14,28
"84095",2020,0,0,42,42
"84096",2014,0,0,55,55
"84096",2016,0,0,18,18
"84096",2017,0,107,24,131
"84096",2019,0,14,24,38
"84097",2014,0,0,55,55
"84097",2016,0,0,18,18
"84097",2017,0,107,24,131
"84097",2019,0,14,14,28
"84098",2014,0,0,55,55
"84098",2016,0,0,18,18
"84098",2017,0,107,24,131
"84098",2019,0,14,24,38
"84099",2014,0,0,55,55
"84099",2017,0,107,24,131
"84099",2019,0,14,14,28
"84100",2014,0,0,55,55
"84100",2016,0,0,18,18
"84100",2017,0,107,24,131
"84100",2019,0,14,24,38
"84101",2014,0,0,55,55
"84101",2017,0,107,24,131
"84101",2019,0,14,14,28
"84102",2014,0,0,55,55
"84102",2017,0,107,24,131
"84102",2019,0,14,14,28
"84103",2014,0,0,55,55
"84103",2017,0,107,24,131
"84103",2019,0,14,14,28
"84104",2014,0,0,55,55
"84104",2016,0,0,18,18
"84104",2017,0,107,24,131
"84104",2019,0,14,24,38
"84105",2014,0,0,55,55
"84105",2017,0,107,24,131
"84105",2019,0,14,14,28
"84106",2014,0,0,55,55
"84106",2016,0,0,18,18
"84106",2017,0,107,24,131
"84106",2019,0,14,14,28
"84107",2014,0,0,55,55
"84107",2017,0,107,24,131
"84107",2019,0,14,14,28
"84108",2014,0,0,55,55
"84108",2017,0,107,24,131
"84108",2019,0,14,14,28
"84109",2014,0,0,55,55
"84109",2016,0,0,18,18
"84109",2017,0,107,24,131
"84109",2019,0,14,24,38
"84110",2014,0,0,55,55
"84110",2016,0,0,18,18
"84110",2017,0,107,24,131
"84110",2019,0,14,24,38
"84111",2014,0,0,55,55
"84111",2016,0,0,18,18
"84111",2017,0,107,24,131
"84111",2019,0,14,24,38
"84112",2014,0,0,55,55
"84112",2017,0,107,24,131
"84112",2019,0,14,14,28
"84113",2014,0,0,55,55
"84113",2017,0,107,24,131
"84113",2019,0,14,14,28
"84113",2020,0,0,42,42
"84114",2014,0,0,55,55
"84114",2017,0,107,24,131
"84114",2019,0,14,14,28
"84115",2014,0,0,55,55
"84115",2016,0,0,18,18
"84115",2017,0,107,24,131
"84115",2019,0,14,24,38
"84116",2014,0,0,55,55
"84116",2016,0,0,18,18
"84116",2017,0,107,24,131
"84116",2019,0,14,24,38
"84117",2014,0,0,55,55
"84117",2016,0,0,18,18
"84117",2017,0,107,24,131
"84117",2019,0,14,24,38
"84118",2014,0,0,55,55
"84118",2017,0,107,24,131
"84118",2019,0,14,14,28
"84119",2014,0,0,55,55
"84119",2015,0,0,35,35
"84119",2016,0,0,18,18
"84119",2017,0,107,24,131
"84119",2019,0,14,83,97
"84119",2020,0,0,42,42
"84120",2014,0,0,55,55
"84120",2017,0,107,24,131
"84120",2019,0,14,14,28
"84121",2014,0,0,55,55
"84121",2017,0,107,24,131
"84121",2019,0,14,14,28
"84121",2020,0,0,42,42
"84122",2014,0,0,55,55
"84122",2016,0,0,18,18
"84122",2017,0,107,24,131
"84122",2019,0,14,24,38
"84123",2014,0,0,55,55
"84123",2017,0,107,24,131
"84123",2019,0,14,14,28
"84124",2014,0,0,55,55
"84124",2017,0,107,24,131
"84124",2019,0,14,14,28
"84125",2014,0,0,55,55
"84125",2017,0,107,24,131
"84125",2019,0,14,14,28
"84126",2014,0,0,55,55
"84126",2016,0,0,18,18
"84126",2017,0,107,24,131
"84126",2019,0,14,24,38
"84127",2014,0,0,55,55
"84127",2016,0,0,18,18
"84127",2017,0,107,24,131
"84127",2019,0,14,24,38
"84128",2014,0,0,55,55
"84128",2017,0,107,24,131
"84128",2019,0,14,14,28
"84128",2020,0,0,42,42
"84129",2014,0,0,55,55
"84129",2016,0,0,18,18
"84129",2017,0,107,24,131
"84129",2019,0,14,24,38
"84130",2014,0,0,55,55
"84130",2016,0,0,18,18
"84130",2017,0,107,24,131
"84130",2019,0,14,24,38
"84131",2014,0,0,55,55
"84131",2017,0,107,24,131
"84131",2019,0,14,14,28
"84132",2014,0,0,55,55
"84132",2016,0,0,18,18
"84132",2017,0,107,24,131
"84132",2019,0,14,123,137
"84132",2020,0,0,42,42
"84133",2014,0,0,55,55
"84133",2017,0,107,24,131
"84133",2019,0,14,14,28
"84133",2020,0,0,42,42
"84134",2014,0,0,55,55
"84134",2016,0,0,18,18
"84134",2017,0,107,24,131
"84134",2019,0,14,24,38
"84135",2014,0,0,55,55
"84135",2016,0,0,18,18
"84135",2017,0,107,24,131
"84135",2019,0,14,24,38
"84136",2014,0,0,55,55
"84136",2016,0,0,18,18
"84136",2017,0,107,24,131
"84136",2019,0,14,24,38
"84137",2014,0,0,55,55
"84137",2016,0,0,18,18
"84137",2017,0,107,24,131
"84137",2019,0,14,24,38
"84138",2014,0,0,55,55
"84138",2016,0,0,18,18
"84138",2017,0,107,24,131
"84138",2019,0,14,14,28
"84139",2014,0,0,55,55
"84139",2017,0,107,24,131
"84139",2019,0,14,14,28
"84140",2014,0,0,55,55
"84140",2017,0,107,24,131
"84140",2019,0,14,14,28
"84140",2020,0,0,42,42
"84141",2014,0,0,55,55
"84141",2015,0,0,35,35
"84141",2016,0,0,18,18
"84141",2017,0,107,24,131
"84141",2019,0,14,83,97
"84141",2020,0,0,42,42
"84142",2014,0,0,55,55
"84142",2015,0,0,35,35
"84142",2016,0,0,18,18
"84142",2017,0,107,24,131
"84142",2019,0,14,123,137
"84142",2020,0,0,42,42
"84143",2014,0,0,55,55
"84143",2017,0,107,24,131
"84143",2019,0,14,14,28
"84144",2014,0,0,55,55
"84144",2017,0,107,24,131
"84144",2019,0,14,14,28
"84145",2014,0,0,55,55
"84145",2017,0,107,24,131
"84145",2019,0,14,14,28
"84146",2014,0,0,55,55
"84146",2016,0,0,18,18
"84146",2017,0,107,24,131
"84146",2019,0,14,24,38
"84147",2014,0,0,55,55
"84147",2017,0,107,24,131
"84147",2019,0,14,14,28
"84147",2020,0,0,42,42
"84148",2014,0,0,55,55
"84148",2017,0,107,24,131
"84148",2019,0,14,14,28
"84149",2014,0,0,55,55
"84149",2016,0,0,18,18
"84149",2017,0,107,24,131
"84149",2019,0,14,24,38
"84150",2014,0,0,55,55
"84150",2016,0,0,18,18
"84150",2017,0,107,24,131
"84150",2019,0,14,14,28
"84151",2014,0,0,55,55
"84151",2017,0,107,24,131
"84151",2019,0,14,14,28
"84151",2020,0,0,42,42
"85001",2015,0,34,0,34
"85001",2020,0,0,14,14
"85002",2020,0,0,32,32
"85003",2020,0,0,32,32
"85004",2015,0,34,0,34
"85004",2020,0,0,14,14
"85005",2020,0,0,14,14
"85006",2020,0,0,32,32
"85008",2020,0,0,32,32
"85009",2020,0,0,21,21
"85010",2015,0,34,0,34
"85010",2020,0,0,32,32
"85011",2020,0,0,15,15
"85012",2020,0,0,15,15
"85014",2020,0,0,14,14
"85015",2020,0,0,15,15
"85016",2020,0,0,32,32
"85018",2020,0,0,15,15
"85019",2020,0,0,15,15
"85020",2020,0,3,21,24
"85022",2015,0,34,0,34
"85022",2020,0,0,32,32
"85023",2020,0,0,14,14
"85024",2020,0,0,15,15
"85026",2015,0,34,0,34
"85026",2020,0,0,32,32
"85028",2020,0,3,21,24
"85029",2020,0,0,15,15
"85031",2020,0,0,14,14
"85033",2020,0,0,14,14
"85034",2020,0,0,14,14
"85035",2020,0,0,32,32
"85036",2015,0,34,0,34
"85036",2020,0,0,14,14
"85038",2020,0,0,15,15
"85040",2020,0,0,14,14
"85045",2020,0,0,32,32
"85046",2020,0,0,14,14
"85047",2020,0,0,15,15
"85050",2015,0,34,0,34
"85050",2020,0,0,14,14
"85051",2020,0,0,14,14
"85054",2020,0,0,32,32
"85055",2020,0,0,32,32
"85056",2020,0,0,14,14
"85058",2020,0,0,14,14
"85059",2020,0,0,14,14
"85061",2020,0,0,14,14
"85062",2020,0,0,15,15
"85064",2020,0,0,15,15
"85066",2020,0,0,14,14
"85067",2020,0,0,14,14
"85070",2020,0,0,32,32
"85071",2020,0,0,32,32
"85072",2020,0,0,15,15
"85073",2020,0,0,14,14
"85074",2020,0,0,14,14
"85076",2015,0,0,34,34
"85077",2015,0,34,0,34
"85077",2020,0,0,14,14
"85078",2020,0,3,21,24
"85080",2020,0,3,21,24
"85081",2020,0,0,15,15
"85082",2020,0,0,14,14
"85083",2020,0,0,15,15
"85084",2020,0,0,15,15
"85086",2020,0,0,15,15
"85087",2020,0,3,21,24
"85088",2020,0,0,32,32
"85089",2020,0,0,15,15
"85090",2020,0,0,14,14
"85092",2020,0,3,21,24
"85093",2020,0,0,14,14
"85094",2020,0,3,21,24
"85095",2020,0,0,15,15
"85096",2020,0,0,15,15
"85098",2020,0,0,32,32
"85099",2020,0,0,32,32
"85100",2020,0,0,32,32
"85101",2015,0,34,0,34
"85101",2020,0,0,14,14
"85102",2020,0,0,15,15
"85103",2015,0,34,0,34
"85103",2020,0,0,32,32
"85104",2015,0,34,0,34
"85104",2020,0,0,14,14
"85105",2020,0,0,21,21
"85106",2020,0,0,15,15
"85108",2020,0,0,15,15
"85109",2020,0,0,14,14
"85110",2020,0,0,14,14
"85111",2020,0,0,21,21
"85112",2020,0,0,32,32
"85114",2015,0,34,0,34
"85114",2020,0,0,32,32
"85115",2020,0,0,14,14
"85116",2015,0,34,0,34
"85116",2020,0,0,14,14
"85117",2015,0,34,0,34
"85117",2020,0,0,14,14
"85118",2020,0,0,32,32
"85120",2020,0,0,32,32
"85121",2020,0,0,21,21
"85123",2020,0,3,21,24
"85125",2020,0,0,21,21
"85126",2020,0,0,21,21
"85127",2015,0,34,0,34
"85127",2020,0,0,32,32
"85128",2020,0,0,14,14
"85129",2020,0,0,15,15
"85130",2020,0,0,32,32
"85131",2020,0,0,14,14
"85132",2020,0,3,21,24
"85133",2020,0,3,21,24
"85134",2015,0,0,34,34
"85135",2020,0,0,14,14
"85136",2020,0,0,21,21
"85137",2020,0,0,14,14
"85138",2020,0,0,32,32
"85139",2020,0,3,21,24
"85140",2020,0,0,14,14
"85141",2020,0,0,14,14
"85142",2020,0,0,15,15
"85143",2020,0,0,21,21
"85145",2020,0,0,14,14
"85147",2020,0,0,14,14
"85148",2020,0,0,21,21
"85151",2015,0,0,34,34
"85152",2020,0,0,32,32
"85153",2020,0,0,14,14
"85154",2020,0,0,14,14
"85155",2020,0,0,32,32
"85156",2015,0,34,0,34
"85156",2020,0,0,32,32
"85157",2020,0,0,14,14
"85158",2020,0,0,21,21
"85159",2020,0,0,21,21
"85160",2020,0,0,14,14
"85161",2020,0,0,32,32
"85162",2020,0,3,21,24
"85163",2020,0,0,15,15
"85164",2020,0,0,15,15
"85165",2020,0,0,14,14
"85167",2020,0,0,21,21
"85169",2020,0,0,32,32
"85171",2020,0,0,14,14
"85172",2020,0,0,15,15
"85174",2020,0,0,21,21
"85175",2020,0,0,14,14
"85176",2020,0,0,21,21
"85177",2020,0,0,21,21
"85178",2020,0,0,32,32
"85179",2015,0,34,0,34
"85179",2020,0,0,32,32
"85181",2020,0,0,14,14
"85182",2020,0,0,14,14
"85184",2020,0,0,21,21
"85187",2020,0,0,14,14
"85188",2020,0,0,14,14
"85189",2020,0,0,32,32
"85190",2020,0,0,15,15
"85191",2020,0,0,14,14
"85192",2020,0,0,14,14
"85193",2015,0,34,0,34
"85193",2020,0,0,14,14
"85194",2015,0,34,0,34
"85194",2020,0,0,32,32
"85197",2020,0,0,15,15
"85198",2015,0,0,34,34
"85199",2020,0,0,14,14
"85200",2015,0,34,0,34
"85200",2020,0,0,32,32
"85201",2015,0,34,0,34
"85201",2020,0,0,14,14
"85202",2020,0,0,14,14
"85204",2020,0,0,15,15
"85205",2020,0,0,14,14
"85206",2015,0,34,0,34
"85206",2020,0,0,14,14
"85207",2015,0,34,0,34
"85207",2020,0,0,14,14
"85208",2020,0,0,15,15
"85209",2020,0,0,14,14
"85210",2020,0,0,15,15
"85211",2020,0,0,32,32
"85212",2020,0,0,14,14
"85213",2015,0,34,0,34
"85213",2020,0,0,14,14
"85214",2015,0,34,0,34
"85214",2020,0,0,32,32
"85216",2020,0,0,14,14
"85218",2020,0,0,32,32
"85220",2020,0,0,14,14
"85221",2020,0,0,15,15
"85222",2020,0,0,32,32
"85223",2020,0,0,14,14
"85226",2020,0,0,15,15
"85227",2020,0,3,21,24
"85229",2020,0,0,21,21
"85231",2015,0,34,0,34
"85231",2020,0,0,32,32
"85232",2020,0,0,14,14
"85233",2020,0,0,14,14
"85234",2020,0,0,15,15
"85235",2020,0,0,14,14
"85236",2020,0,0,32,32
"85237",2020,0,0,14,14
"85238",2015,0,0,34,34
"85239",2020,0,0,32,32
"85240",2015,0,0,34,34
"85242",2020,0,0,14,14
"85243",2020,0,0,32,32
"85244",2020,0,3,21,24
"85245",2020,0,0,14,14
"85246",2020,0,0,15,15
"85247",2015,0,0,34,34
"85248",2020,0,0,14,14
"85250",2020,0,0,32,32
"85251",2020,0,0,21,21
"85252",2020,0,0,14,14
"85254",2015,0,0,34,34
"85255",2020,0,0,14,14
"85256",2020,0,3,21,24
"85259",2020,0,0,14,14
"85260",2020,0,0,15,15
"85261",2020,0,0,14,14
"85262",2020,0,0,15,15
"85264",2020,0,0,14,14
"85265",2020,0,3,21,24
"85266",2020,0,0,14,14
"85268",2020,0,0,32,32
"85269",2020,0,3,21,24
"85273",2020,0,0,15,15
"85274",2020,0,0,14,14
"85276",2020,0,0,14,14
"85277",2015,0,34,0,34
"85277",2020,0,0,32,32
"85278",2015,0,34,0,34
"85278",2020,0,0,32,32
"85280",2020,0,0,15,15
"85281",2020,0,0,21,21
"85282",2020,0,0,14,14
"85284",2020,0,0,15,15
"85285",2020,0,0,14,14
"85286",2020,0,0,21,21
"85287",2020,0,0,14,14
"85288",2015,0,34,0,34
"85288",2020,0,0,32,32
"85289",2020,0,0,14,14
"85290",2020,0,0,14,14
"85291",2020,0,0,14,14
"85292",2020,0,0,14,14
"85293",2015,0,0,34,34
"85294",2015,0,34,0,34
"85294",2020,0,0,14,14
"85296",2015,0,0,34,34
"85298",2020,0,0,32,32
"85300",2020,0,0,32,32
"85301",2020,0,0,14,14
"85303",2020,0,3,21,24
"85305",2020,0,0,21,21
"85306",2020,0,3,21,24
"86002",2019,0,62,69,131
"86002",2020,0,15,15,30
"86004",2017,0,0,7,7
"86005",2019,0,82,69,151
"86005",2020,0,15,15,30
"86006",2017,0,32,58,90
"86007",2017,0,73,73,146
"86008",2019,0,62,69,131
"86008",2020,0,15,15,30
"86012",2017,0,100,0,100
"86012",2018,0,143,147,290
"86012",2019,0,6,14,20
"86013",2019,0,82,69,151
"86013",2020,0,15,15,30
"86016",2019,0,62,8,70
"86017",2019,0,62,8,70
"86018",2019,0,48,62,110
"86018",2020,0,15,15,30
"86019",2019,0,55,55,110
"86022",2019,0,82,69,151
"86022",2020,0,15,15,30
"86023",2019,0,48,62,110
"86023",2020,0,15,15,30
"86024",2019,0,62,8,70
"86025",2017,0,0,26,26
"86026",2019,0,48,48,96
"86027",2019,0,62,8,70
"86029",2017,0,4,0,4
"86029",2018,0,84,67,151
"86035",2017,0,0,26,26
"86036",2019,0,48,62,110
"86036",2020,0,15,15,30
"86039",2017,0,4,0,4
"86039",2018,0,84,67,151
"86040",2017,0,0,26,26
"86044",2019,0,48,48,96
"86048",2019,0,62,55,117
"86049",2019,0,48,62,110
"86049",2020,0,15,15,30
"86050",2019,0,62,15,77
"86050",2020,0,15,15,30
"86051",2017,0,4,0,4
"86051",2018,0,84,67,151
"86053",2019,0,62,69,131
"86053",2020,0,15,15,30
"86054",2017,0,4,0,4
"86054",2018,0,119,67,186
"86055",2017,0,4,0,4
"86055",2018,0,119,67,186
"86059",2017,0,32,58,90
"86061",2017,0,4,0,4
"86061",2018,0,119,67,186
"86062",2019,0,62,8,70
"86063",2017,0,100,0,100
"86063",2018,0,143,147,290
"86063",2019,0,6,14,20
"86068",2017,0,4,0,4
"86068",2018,0,84,67,151
"86069",2019,0,82,69,151
"86069",2020,0,15,15,30
"86073",2019,0,62,15,77
"86073",2020,0,15,15,30
"86074",2019,0,62,8,70
"86075",2019,0,55,69,124
"86075",2020,0,15,15,30
"86076",2019,0,62,8,70
"86078",2017,0,100,0,100
"86078",2018,0,143,147,290
"86078",2019,0,6,14,20
"86079",2019,0,48,62,110
"86079",2020,0,15,15,30
"86081",2019,0,55,55,110
"86085",2019,0,55,69,124
"86085",2020,0,15,15,30
"86087",2019,0,62,69,131
"86087",2020,0,15,15,30
"86088",2019,0,62,0,62
"86089",2019,0,62,69,131
"86089",2020,0,15,15,30
"86090",2019,0,62,69,131
"86090",2020,0,15,15,30
"86093",2019,0,48,62,110
"86093",2020,0,15,15,30
"86095",2019,0,62,55,117
"86096",2019,0,55,69,124
"86096",2020,0,15,15,30
"86100",2019,0,62,0,62
"86102",2019,0,62,8,70
"86104",2017,0,100,0,100
"86104",2018,0,143,147,290
"86104",2019,0,6,14,20
"86106",2019,0,62,69,131
"86106",2020,0,15,15,30
"86108",2019,0,62,69,131
"86108",2020,0,15,15,30
"86109",2019,0,82,69,151
"86109",2020,0,15,15,30
"86110",2017,0,0,26,26
"86111",2017,0,73,73,146
"86115",2019,0,55,55,110
"86117",2017,0,0,26,26
"86118",2017,0,0,26,26
"86120",2017,0,0,26,26
"86121",2019,0,0,8,8
"86123",2019,0,62,8,70
"86126",2017,0,32,58,90
"86127",2019,0,48,48,96
"86134",2017,0,100,0,100
"86134",2018,0,143,147,290
"86134",2019,0,6,14,20
"86136",2017,0,100,0,100
"86136",2018,0,143,147,290
"86136",2019,0,6,14,20
"86137",2019,0,48,62,110
"86137",2020,0,15,15,30
"86142",2019,0,62,8,70
"86144",2019,0,82,69,151
"86144",2020,0,15,15,30
"86149",2019,0,82,69,151
"86149",2020,0,15,15,30
"86150",2019,0,62,69,131
"86150",2020,0,15,15,30
"86151",2019,0,48,62,110
"86151",2020,0,15,15,30
"86154",2019,0,62,69,131
"86154",2020,0,15,15,30
"86156",2019,0,48,48,96
"86158",2019,0,62,8,70
"86160",2019,0,55,69,124
"86160",2020,0,15,15,30
"86161",2019,0,62,69,131
"86161",2020,0,15,15,30
"86162",2019,0,48,48,96
"86165",2017,0,0,26,26
"86167",2019,0,48,62,110
"86167",2020,0,15,15,30
"86169",2019,0,62,69,131
"86169",2020,0,15,15,30
"86170",2017,0,32,58,90
"86173",2019,0,62,69,131
"86173",2020,0,15,15,30
"86175",2017,0,0,26,26
"86177",2019,0,62,8,70
"86181",2019,0,48,48,96
"86182",2019,0,48,48,96
"86187",2017,0,3,29,32
"86191",2017,0,32,58,90
"86192",2017,0,32,58,90
"86193",2017,0,0,7,7
"86194",2019,0,62,8,70
"86196",2019,0,82,69,151
"86196",2020,0,15,15,30
"86197",2019,0,48,48,96
"86201",2019,0,48,62,110
"86201",2020,0,15,15,30
"86204",2019,0,62,8,70
"86205",2019,0,62,69,131
"86205",2020,0,15,15,30
"86206",2019,0,62,69,131
"86206",2020,0,15,15,30
"86207",2017,0,0,7,7
"86210",2019,0,48,62,110
"86210",2020,0,15,15,30
"86211",2017,0,4,0,4
"86211",2018,0,84,67,151
"86217",2019,0,48,48,96
"86218",2019,0,82,69,151
"86218",2020,0,15,15,30
"86220",2017,0,100,0,100
"86220",2018,0,143,147,290
"86220",2019,0,6,14,20
"86221",2019,0,48,48,96
"86223",2017,0,0,26,26
"86224",2019,0,48,48,96
"86225",2019,0,62,69,131
"86225",2020,0,15,15,30
"86227",2019,0,62,69,131
"86227",2020,0,15,15,30
"86229",2019,0,62,69,131
"86229",2020,0,15,15,30
"86230",2017,0,0,26,26
"86236",2017,0,0,26,26
"86237",2017,0,100,0,100
"86237",2018,0,143,147,290
"86237",2019,0,6,14,20
"86246",2017,0,3,29,32
"86247",2017,0,100,0,100
"86247",2018,0,143,147,290
"86247",2019,0,6,14,20
"86249",2019,0,48,62,110
"86249",2020,0,15,15,30
"86250",2019,0,48,62,110
"86250",2020,0,15,15,30
"86252",2019,0,48,48,96
"86254",2017,0,32,58,90
"86255",2017,0,4,0,4
"86255",2018,0,119,67,186
"86257",2019,0,48,62,110
"86257",2020,0,15,15,30
"86258",2019,0,48,48,96
"86260",2019,0,48,48,96
"86262",2017,0,32,58,90
"86265",2019,0,48,48,96
"86266",2017,0,100,0,100
"86266",2018,0,143,147,290
"86266",2019,0,6,14,20
"86269",2019,0,82,69,151
"86269",2020,0,15,15,30
"86271",2019,0,55,55,110
"86272",2019,0,48,48,96
"86274",2019,0,62,69,131
"86274",2020,0,15,15,30
"86275",2019,0,48,48,96
"86279",2017,0,73,73,146
"86280",2017,0,73,73,146
"86281",2019,0,55,69,124
"86281",2020,0,15,15,30
"86286",2019,0,55,69,124
"86286",2020,0,15,15,30
"86287",2019,0,48,62,110
"86287",2020,0,15,15,30
"86288",2017,0,0,26,26
"86291",2017,0,0,26,26
"86292",2019,0,62,8,70
"86294",2019,0,62,8,70
"86295",2017,0,100,0,100
"86295",2018,0,143,147,290
"86295",2019,0,6,14,20
"86297",2019,0,62,8,70
"86299",2019,0,62,15,77
"86299",2020,0,15,15,30
"86300",2019,0,62,8,70
"87001",2015,0,10,0,10
"87001",2019,0,6,30,36
"87001",2020,0,44,44,88
"87002",2015,0,10,0,10
"87002",2019,0,6,30,36
"87002",2020,0,44,44,88
"87003",2015,0,10,0,10
"87003",2019,0,6,30,36
"87003",2020,0,44,44,88
"87004",2015,0,10,0,10
"87004",2019,0,6,30,36
"87004",2020,0,44,44,88
"87005",2015,0,10,0,10
"87005",2019,0,6,30,36
"87005",2020,0,44,44,88
"87006",2015,0,10,0,10
"87006",2019,0,6,30,36
"87006",2020,0,44,44,88
"87007",2015,0,10,0,10
"87007",2019,0,6,30,36
"87007",2020,0,44,44,88
"87008",2015,0,10,0,10
"87008",2019,0,6,30,36
"87008",2020,0,44,44,88
"87009",2015,0,10,0,10
"87009",2019,0,6,30,36
"87009",2020,0,44,44,88
"87011",2015,0,10,0,10
"87011",2019,0,6,30,36
"87011",2020,0,44,44,88
"87012",2015,0,10,0,10
"87012",2019,0,6,30,36
"87012",2020,0,44,44,88
"87013",2015,0,10,0,10
"87013",2019,0,6,30,36
"87013",2020,0,44,44,88
"87014",2015,0,10,0,10
"87014",2019,0,6,30,36
"87014",2020,0,44,44,88
"87015",2015,0,10,0,10
"87015",2019,0,6,30,36
"87015",2020,0,44,44,88
"87016",2015,0,10,0,10
"87016",2019,0,6,30,36
"87016",2020,0,44,44,88
"87017",2015,0,10,0,10
"87017",2019,0,6,30,36
"87017",2020,0,44,44,88
"87018",2015,0,10,0,10
"87018",2019,0,6,30,36
"87018",2020,0,44,44,88
"87019",2015,0,10,0,10
"87019",2019,0,6,30,36
"87019",2020,0,44,44,88
"87020",2015,0,10,0,10
"87020",2019,0,6,30,36
"87020",2020,0,44,44,88
"87021",2015,0,10,0,10
"87021",2019,0,6,30,36
"87021",2020,0,44,44,88
"87022",2015,0,10,0,10
"87022",2019,0,6,30,36
"87022",2020,0,44,44,88
"87023",2015,0,10,0,10
"87023",2019,0,6,30,36
"87023",2020,0,44,44,88
"87024",2015,0,10,0,10
"87024",2019,0,6,30,36
"87024",2020,0,44,44,88
"87025",2015,0,10,0,10
"87025",2019,0,6,30,36
"87025",2020,0,44,44,88
"87027",2015,0,10,0,10
"87027",2019,0,6,30,36
"87027",2020,0,44,44,88
"87028",2015,0,10,0,10
"87028",2019,0,6,30,36
"87028",2020,0,44,44,88
"87029",2015,0,10,0,10
"87029",2019,0,6,30,36
"87029",2020,0,44,44,88
"87030",2015,0,10,0,10
"87030",2019,0,6,30,36
"87030",2020,0,44,44,88
"87031",2015,0,10,0,10
"87031",2019,0,6,30,36
"87031",2020,0,44,44,88
"87032",2015,0,10,0,10
"87032",2019,0,6,30,36
"87032",2020,0,44,44,88
"87033",2015,0,10,0,10
"87033",2019,0,6,30,36
"87033",2020,0,44,44,88
"87034",2015,0,10,0,10
"87034",2019,0,6,30,36
"87034",2020,0,44,44,88
"87035",2015,0,10,0,10
"87035",2019,0,6,30,36
"87035",2020,0,44,44,88
"87036",2015,0,10,0,10
"87036",2019,0,6,30,36
"87036",2020,0,44,44,88
"87037",2015,0,10,0,10
"87037",2019,0,6,30,36
"87037",2020,0,44,44,88
"87038",2015,0,10,0,10
"87038",2019,0,6,30,36
"87038",2020,0,44,44,88
"87039",2015,0,10,0,10
"87039",2019,0,6,30,36
"87039",2020,0,44,44,88
"87040",2015,0,10,0,10
"87040",2019,0,6,30,36
"87040",2020,0,44,44,88
"87041",2015,0,10,0,10
"87041",2019,0,6,30,36
"87041",2020,0,44,44,88
"87042",2015,0,10,0,10
"87042",2019,0,6,30,36
"87042",2020,0,44,44,88
"87043",2015,0,10,0,10
"87043",2019,0,6,30,36
"87043",2020,0,44,44,88
"87044",2015,0,10,0,10
"87044",2019,0,6,30,36
"87044",2020,0,44,44,88
"87045",2015,0,10,0,10
"87045",2019,0,6,30,36
"87045",2020,0,44,44,88
"87046",2015,0,10,0,10
"87046",2019,0,6,30,36
"87046",2020,0,44,44,88
"87047",2015,0,10,0,10
"87047",2019,0,6,30,36
"87047",2020,0,44,44,88
"87048",2015,0,10,0,10
"87048",2019,0,6,30,36
"87048",2020,0,44,44,88
"87049",2015,0,10,0,10
"87049",2019,0,6,30,36
"87049",2020,0,44,44,88
"87050",2015,0,10,0,10
"87050",2019,0,6,30,36
"87050",2020,0,44,44,88
"87051",2015,0,10,0,10
"87051",2019,0,6,30,36
"87051",2020,0,44,44,88
"87052",2015,0,10,0,10
"87052",2019,0,6,30,36
"87052",2020,0,44,44,88
"87053",2015,0,10,0,10
"87053",2019,0,6,30,36
"87053",2020,0,44,44,88
"87054",2015,0,10,0,10
"87054",2019,0,6,30,36
"87054",2020,0,44,44,88
"87056",2015,0,10,0,10
"87056",2019,0,6,30,36
"87056",2020,0,44,44,88
"87057",2015,0,10,0,10
"87057",2019,0,6,30,36
"87057",2020,0,44,44,88
"87058",2015,0,10,0,10
"87058",2019,0,6,30,36
"87058",2020,0,44,44,88
"87059",2015,0,10,0,10
"87059",2019,0,6,30,36
"87059",2020,0,44,44,88
"87060",2015,0,10,0,10
"87060",2019,0,6,30,36
"87060",2020,0,44,44,88
"87061",2015,0,10,0,10
"87061",2019,0,6,30,36
"87061",2020,0,44,44,88
"87062",2015,0,10,0,10
"87062",2019,0,6,30,36
"87062",2020,0,44,44,88
"87063",2015,0,10,0,10
"87063",2019,0,6,30,36
"87063",2020,0,44,44,88
"87064",2015,0,10,0,10
"87064",2019,0,6,30,36
"87064",2020,0,44,44,88
"87065",2015,0,10,0,10
"87065",2019,0,6,30,36
"87065",2020,0,44,44,88
"87066",2015,0,10,0,10
"87066",2019,0,6,30,36
"87066",2020,0,44,44,88
"87067",2015,0,10,0,10
"87067",2019,0,6,30,36
"87067",2020,0,44,44,88
"87068",2015,0,10,0,10
"87068",2019,0,6,30,36
"87068",2020,0,44,44,88
"87069",2015,0,10,0,10
"87069",2019,0,6,30,36
"87069",2020,0,44,44,88
"87070",2015,0,10,0,10
"87070",2019,0,6,30,36
"87070",2020,0,44,44,88
"87071",2015,0,10,0,10
"87071",2019,0,6,30,36
"87071",2020,0,44,44,88
"87072",2015,0,10,0,10
"87072",2019,0,6,30,36
"87072",2020,0,44,44,88
"87073",2015,0,10,0,10
"87073",2019,0,6,30,36
"87073",2020,0,44,44,88
"87074",2015,0,10,0,10
"87074",2019,0,6,30,36
"87074",2020,0,44,44,88
"87075",2015,0,10,0,10
"87075",2019,0,6,30,36
"87075",2020,0,44,44,88
"87076",2015,0,10,0,10
"87076",2019,0,6,30,36
"87076",2020,0,44,44,88
"87077",2015,0,10,0,10
"87077",2019,0,6,30,36
"87077",2020,0,44,44,88
"87078",2015,0,10,0,10
"87078",2019,0,6,30,36
"87078",2020,0,44,44,88
"87079",2015,0,10,0,10
"87079",2019,0,6,30,36
"87079",2020,0,44,44,88
"87080",2015,0,10,0,10
"87080",2019,0,6,30,36
"87080",2020,0,44,44,88
"87081",2015,0,10,0,10
"87081",2019,0,6,30,36
"87081",2020,0,44,44,88
"87082",2015,0,10,0,10
"87082",2019,0,6,30,36
"87082",2020,0,44,44,88
"87083",2015,0,10,0,10
"87083",2019,0,6,30,36
"87083",2020,0,44,44,88
"87084",2015,0,10,0,10
"87084",2019,0,6,30,36
"87084",2020,0,44,44,88
"87085",2015,0,10,0,10
"87085",2019,0,6,30,36
"87085",2020,0,44,44,88
"87086",2015,0,10,0,10
"87086",2019,0,6,30,36
"87086",2020,0,44,44,88
"87087",2015,0,10,0,10
"87087",2019,0,6,30,36
"87087",2020,0,44,44,88
"87088",2015,0,10,0,10
"87088",2019,0,6,30,36
"87088",2020,0,44,44,88
"87089",2015,0,10,0,10
"87089",2019,0,6,30,36
"87089",2020,0,44,44,88
"87090",2015,0,10,0,10
"87090",2019,0,6,30,36
"87090",2020,0,44,44,88
"87091",2015,0,10,0,10
"87091",2019,0,6,30,36
"87091",2020,0,44,44,88
"87092",2015,0,10,0,10
"87092",2019,0,6,30,36
"87092",2020,0,44,44,88
"87093",2015,0,10,0,10
"87093",2019,0,6,30,36
"87093",2020,0,44,44,88
"87094",2015,0,10,0,10
"87094",2019,0,6,30,36
"87094",2020,0,44,44,88
"87095",2015,0,10,0,10
"87095",2019,0,6,30,36
"87095",2020,0,44,44,88
"87096",2015,0,10,0,10
"87096",2019,0,6,30,36
"87096",2020,0,44,44,88
"87097",2015,0,10,0,10
"87097",2019,0,6,30,36
"87097",2020,0,44,44,88
"87099",2015,0,10,0,10
"87099",2019,0,6,30,36
"87099",2020,0,44,44,88
"87100",2015,0,10,0,10
"87100",2019,0,6,30,36
"87100",2020,0,44,44,88
"87101",2015,0,10,0,10
"87101",2019,0,6,30,36
"87101",2020,0,44,44,88
"87103",2015,0,10,0,10
"87103",2019,0,6,30,36
"87103",2020,0,44,44,88
"87104",2015,0,10,0,10
"87104",2019,0,6,30,36
"87104",2020,0,44,44,88
"87105",2015,0,10,0,10
"87105",2019,0,6,30,36
"87105",2020,0,44,44,88
"87106",2015,0,10,0,10
"87106",2019,0,6,30,36
"87106",2020,0,44,44,88
"87107",2015,0,10,0,10
"87107",2019,0,6,30,36
"87107",2020,0,44,44,88
"87108",2015,0,10,0,10
"87108",2019,0,6,30,36
"87108",2020,0,44,44,88
"87109",2015,0,10,0,10
"87109",2019,0,6,30,36
"87109",2020,0,44,44,88
"87110",2015,0,10,0,10
"87110",2019,0,6,30,36
"87110",2020,0,44,44,88
"87111",2015,0,10,0,10
"87111",2019,0,6,30,36
"87111",2020,0,44,44,88
"87112",2015,0,10,0,10
"87112",2019,0,6,30,36
"87112",2020,0,44,44,88
"87113",2015,0,10,0,10
"87113",2019,0,6,30,36
"87113",2020,0,44,44,88
"87114",2015,0,10,0,10
"87114",2019,0,6,30,36
"87114",2020,0,44,44,88
"87115",2015,0,10,0,10
"87115",2019,0,6,30,36
"87115",2020,0,44,44,88
"87116",2015,0,10,0,10
"87116",2019,0,6,30,36
"87116",2020,0,44,44,88
"87117",2015,0,10,0,10
"87117",2019,0,6,30,36
"87117",2020,0,44,44,88
"87118",2015,0,10,0,10
"87118",2019,0,6,30,36
"87118",2020,0,44,44,88
"87119",2015,0,10,0,10
"87119",2019,0,6,30,36
"87119",2020,0,44,44,88
"87120",2015,0,10,0,10
"87120",2019,0,6,30,36
"87120",2020,0,44,44,88
"87121",2015,0,10,0,10
"87121",2019,0,6,30,36
"87121",2020,0,44,44,88
"87122",2015,0,10,0,10
"87122",2019,0,6,30,36
"87122",2020,0,44,44,88
"87123",2015,0,10,0,10
"87123",2019,0,6,30,36
"87123",2020,0,44,44,88
"87124",2015,0,10,0,10
"87124",2019,0,6,30,36
"87124",2020,0,44,44,88
"87125",2015,0,10,0,10
"87125",2019,0,6,30,36
"87125",2020,0,44,44,88
"87126",2015,0,10,0,10
"87126",2019,0,6,30,36
"87126",2020,0,44,44,88
"87127",2015,0,10,0,10
"87127",2019,0,6,30,36
"87127",2020,0,44,44,88
"87128",2015,0,10,0,10
"87128",2019,0,6,30,36
"87128",2020,0,44,44,88
"87129",2015,0,10,0,10
"87129",2019,0,6,30,36
"87129",2020,0,44,44,88
"87130",2015,0,10,0,10
"87130",2019,0,6,30,36
"87130",2020,0,44,44,88
"87131",2015,0,10,0,10
"87131",2019,0,6,30,36
"87131",2020,0,44,44,88
"87132",2015,0,10,0,10
"87132",2019,0,6,30,36
"87132",2020,0,44,44,88
"87133",2015,0,10,0,10
"87133",2019,0,6,30,36
"87133",2020,0,44,44,88
"87134",2015,0,10,0,10
"87134",2019,0,6,30,36
"87134",2020,0,44,44,88
"87135",2015,0,10,0,10
"87135",2019,0,6,30,36
"87135",2020,0,44,44,88
"87137",2015,0,10,0,10
"87137",2019,0,6,30,36
"87137",2020,0,44,44,88
"87138",2015,0,10,0,10
"87138",2019,0,6,30,36
"87138",2020,0,44,44,88
"87139",2015,0,10,0,10
"87139",2019,0,6,30,36
"87139",2020,0,44,44,88
"87140",2015,0,10,0,10
"87140",2019,0,6,30,36
"87140",2020,0,44,44,88
"87141",2015,0,10,0,10
"87141",2019,0,6,30,36
"87141",2020,0,44,44,88
"87142",2015,0,10,0,10
"87142",2019,0,6,30,36
"87142",2020,0,44,44,88
"87143",2015,0,10,0,10
"87143",2019,0,6,30,36
"87143",2020,0,44,44,88
"87144",2015,0,10,0,10
"87144",2019,0,6,30,36
"87144",2020,0,44,44,88
"87145",2015,0,10,0,10
"87145",2019,0,6,30,36
"87145",2020,0,44,44,88
"87146",2015,0,10,0,10
"87146",2019,0,6,30,36
"87146",2020,0,44,44,88
"87147",2015,0,10,0,10
"87147",2019,0,6,30,36
"87147",2020,0,44,44,88
"87148",2015,0,10,0,10
"87148",2019,0,6,30,36
"87148",2020,0,44,44,88
"87149",2015,0,10,0,10
"87149",2019,0,6,30,36
"87149",2020,0,44,44,88
"87150",2015,0,10,0,10
"87150",2019,0,6,30,36
"87150",2020,0,44,44,88
"87151",2015,0,10,0,10
"87151",2019,0,6,30,36
"87151",2020,0,44,44,88
"87152",2015,0,10,0,10
"87152",2019,0,6,30,36
"87152",2020,0,44,44,88
"87153",2015,0,10,0,10
"87153",2019,0,6,30,36
"87153",2020,0,44,44,88
"87154",2015,0,10,0,10
"87154",2019,0,6,30,36
"87154",2020,0,44,44,88
"87155",2015,0,10,0,10
"87155",2019,0,6,30,36
"87155",2020,0,44,44,88
"87156",2015,0,10,0,10
"87156",2019,0,6,30,36
"87156",2020,0,44,44,88
"87157",2015,0,10,0,10
"87157",2019,0,6,30,36
"87157",2020,0,44,44,88
"87158",2015,0,10,0,10
"87158",2019,0,6,30,36
"87158",2020,0,44,44,88
"87159",2015,0,10,0,10
"87159",2019,0,6,30,36
"87159",2020,0,44,44,88
"87160",2015,0,10,0,10
"87160",2019,0,6,30,36
"87160",2020,0,44,44,88
"87161",2015,0,10,0,10
"87161",2019,0,6,30,36
"87161",2020,0,44,44,88
"87162",2015,0,10,0,10
"87162",2019,0,6,30,36
"87162",2020,0,44,44,88
"87163",2015,0,10,0,10
"87163",2019,0,6,30,36
"87163",2020,0,44,44,88
"87164",2015,0,10,0,10
"87164",2019,0,6,30,36
"87164",2020,0,44,44,88
"87165",2015,0,10,0,10
"87165",2019,0,6,30,36
"87165",2020,0,44,44,88
"87166",2015,0,10,0,10
"87166",2019,0,6,30,36
"87166",2020,0,44,44,88
"87167",2015,0,10,0,10
"87167",2019,0,6,30,36
"87167",2020,0,44,44,88
"87168",2015,0,10,0,10
"87168",2019,0,6,30,36
"87168",2020,0,44,44,88
"87169",2015,0,10,0,10
"87169",2019,0,6,30,36
"87169",2020,0,44,44,88
"87170",2015,0,10,0,10
"87170",2019,0,6,30,36
"87170",2020,0,44,44,88
"87172",2015,0,10,0,10
"87172",2019,0,6,30,36
"87172",2020,0,44,44,88
"87174",2015,0,10,0,10
"87174",2019,0,6,30,36
"87174",2020,0,44,44,88
"87176",2015,0,10,0,10
"87176",2019,0,6,30,36
"87176",2020,0,44,44,88
"87177",2015,0,10,0,10
"87177",2019,0,6,30,36
"87177",2020,0,44,44,88
"87178",2015,0,10,0,10
"87178",2019,0,6,30,36
"87178",2020,0,44,44,88
"87179",2015,0,10,0,10
"87179",2019,0,6,30,36
"87179",2020,0,44,44,88
"87180",2015,0,10,0,10
"87180",2019,0,6,30,36
"87180",2020,0,44,44,88
"87181",2015,0,10,0,10
"87181",2019,0,6,30,36
"87181",2020,0,44,44,88
"87182",2015,0,10,0,10
"87182",2019,0,6,30,36
"87182",2020,0,44,44,88
"87183",2015,0,10,0,10
"87183",2019,0,6,30,36
"87183",2020,0,44,44,88
"87185",2015,0,10,0,10
"87185",2019,0,6,30,36
"87185",2020,0,44,44,88
"87186",2015,0,10,0,10
"87186",2019,0,6,30,36
"87186",2020,0,44,44,88
"87187",2015,0,10,0,10
"87187",2019,0,6,30,36
"87187",2020,0,44,44,88
"87188",2015,0,10,0,10
"87188",2019,0,6,30,36
"87188",2020,0,44,44,88
"87189",2015,0,10,0,10
"87189",2019,0,6,30,36
"87189",2020,0,44,44,88
"87190",2015,0,10,0,10
"87190",2019,0,6,30,36
"87190",2020,0,44,44,88
"87191",2015,0,10,0,10
"87191",2019,0,6,30,36
"87191",2020,0,44,44,88
"87192",2015,0,10,0,10
"87192",2019,0,6,30,36
"87192",2020,0,44,44,88
"87193",2015,0,10,0,10
"87193",2019,0,6,30,36
"87193",2020,0,44,44,88
"87194",2015,0,10,0,10
"87194",2019,0,6,30,36
"87194",2020,0,44,44,88
"87195",2015,0,10,0,10
"87195",2019,0,6,30,36
"87195",2020,0,44,44,88
"87197",2015,0,10,0,10
"87197",2019,0,6,30,36
"87197",2020,0,44,44,88
"87198",2015,0,10,0,10
"87198",2019,0,6,30,36
"87198",2020,0,44,44,88
"87199",2015,0,10,0,10
"87199",2019,0,6,30,36
"87199",2020,0,44,44,88
"87200",2015,0,10,0,10
"87200",2019,0,6,30,36
"87200",2020,0,44,44,88
"87201",2015,0,10,0,10
"87201",2019,0,6,30,36
"87201",2020,0,44,44,88
"87202",2015,0,10,0,10
"87202",2019,0,6,30,36
"87202",2020,0,44,44,88
"87203",2015,0,10,0,10
"87203",2019,0,6,30,36
"87203",2020,0,44,44,88
"87204",2015,0,10,0,10
"87204",2019,0,6,30,36
"87204",2020,0,44,44,88
"87205",2015,0,10,0,10
"87205",2019,0,6,30,36
"87205",2020,0,44,44,88
"87206",2015,0,10,0,10
"87206",2019,0,6,30,36
"87206",2020,0,44,44,88
"88001",2017,0,0,21,21
"88001",2018,0,40,0,40
"88002",2017,0,0,21,21
"88002",2018,0,40,0,40
"88003",2017,0,0,21,21
"88003",2018,0,40,0,40
"88004",2017,0,0,21,21
"88004",2018,0,40,0,40
"88005",2017,0,0,21,21
"88005",2018,0,40,0,40
"88006",2017,0,0,21,21
"88006",2018,0,40,0,40
"88007",2017,0,0,21,21
"88007",2018,0,40,0,40
"88008",2017,0,0,21,21
"88008",2018,0,40,0,40
"88009",2017,0,0,21,21
"88009",2018,0,40,0,40
"88010",2017,0,0,21,21
"88010",2018,0,40,0,40
"88011",2017,0,0,21,21
"88011",2018,0,40,0,40
"88012",2017,0,0,21,21
"88012",2018,0,40,0,40
"88013",2017,0,0,21,21
"88013",2018,0,40,0,40
"88014",2017,0,0,21,21
"88014",2018,0,40,0,40
"88015",2017,0,0,21,21
"88015",2018,0,40,0,40
"88016",2017,0,0,21,21
"88016",2018,0,40,0,40
"88017",2017,0,0,21,21
"88017",2018,0,40,0,40
"88019",2017,0,0,21,21
"88019",2018,0,40,0,40
"88020",2017,0,0,21,21
"88020",2018,0,40,0,40
"88021",2017,0,0,21,21
"88021",2018,0,40,0,40
"88022",2017,0,0,21,21
"88022",2018,0,40,0,40
"88023",2017,0,0,21,21
"88023",2018,0,40,0,40
"88024",2017,0,0,21,21
"88024",2018,0,40,0,40
"88025",2017,0,0,21,21
"88025",2018,0,40,0,40
"88026",2017,0,0,21,21
"88026",2018,0,40,0,40
"88027",2017,0,0,21,21
"88027",2018,0,40,0,40
"88028",2017,0,0,21,21
"88028",2018,0,40,0,40
"88029",2017,0,0,21,21
"88029",2018,0,40,0,40
"88030",2017,0,0,21,21
"88030",2018,0,40,0,40
"88031",2017,0,0,21,21
"88031",2018,0,40,0,40
"88032",2017,0,0,21,21
"88032",2018,0,40,0,40
"88033",2017,0,0,21,21
"88033",2018,0,40,0,40
"88035",2017,0,0,21,21
"88035",2018,0,40,0,40
"88036",2017,0,0,21,21
"88036",2018,0,40,0,40
"88037",2017,0,0,21,21
"88037",2018,0,40,0,40
"88038",2017,0,0,21,21
"88038",2018,0,40,0,40
"88039",2017,0,0,21,21
"88039",2018,0,40,0,40
"88040",2017,0,0,21,21
"88040",2018,0,40,0,40
"88041",2017,0,0,21,21
"88041",2018,0,40,0,40
"88042",2017,0,0,21,21
"88042",2018,0,40,0,40
"88043",2017,0,0,21,21
"88043",2018,0,40,0,40
"88044",2017,0,0,21,21
"88044",2018,0,40,0,40
"88045",2017,0,0,21,21
"88045",2018,0,40,0,40
"88046",2017,0,0,21,21
"88046",2018,0,40,0,40
"88047",2017,0,0,21,21
"88047",2018,0,40,0,40
"88048",2017,0,0,21,21
"88048",2018,0,40,0,40
"88049",2017,0,0,21,21
"88049",2018,0,40,0,40
"88050",2017,0,0,21,21
"88050",2018,0,40,0,40
"88051",2017,0,0,21,21
"88051",2018,0,40,0,40
"88052",2017,0,0,21,21
"88052",2018,0,40,0,40
"88053",2017,0,0,21,21
"88053",2018,0,40,0,40
"88054",2017,0,0,21,21
"88054",2018,0,40,0,40
"88055",2017,0,0,21,21
"88055",2018,0,40,0,40
"88056",2017,0,0,21,21
"88056",2018,0,40,0,40
"88057",2017,0,0,21,21
"88057",2018,0,40,0,40
"88058",2017,0,0,21,21
"88058",2018,0,40,0,40
"88059",2017,0,0,21,21
"88059",2018,0,40,0,40
"88060",2017,0,0,21,21
"88060",2018,0,40,0,40
"88061",2017,0,0,21,21
"88061",2018,0,40,0,40
"88062",2017,0,0,21,21
"88062",2018,0,40,0,40
"88063",2017,0,0,21,21
"88063",2018,0,40,0,40
"88064",2017,0,0,21,21
"88064",2018,0,40,0,40
"88065",2017,0,0,21,21
"88065",2018,0,40,0,40
"88066",2017,0,0,21,21
"88066",2018,0,40,0,40
"88068",2017,0,0,21,21
"88068",2018,0,40,0,40
"88069",2017,0,0,21,21
"88069",2018,0,40,0,40
"88070",2017,0,0,21,21
"88070",2018,0,40,0,40
"88071",2017,0,0,21,21
"88071",2018,0,40,0,40
"88073",2017,0,0,21,21
"88073",2018,0,40,0,40
"88074",2017,0,0,21,21
"88074",2018,0,40,0,40
"88075",2017,0,0,21,21
"88075",2018,0,40,0,40
"88076",2017,0,0,21,21
"88076",2018,0,40,0,40
"88077",2017,0,0,21,21
"88077",2018,0,40,0,40
"88078",2017,0,0,21,21
"88078",2018,0,40,0,40
"88079",2017,0,0,21,21
"88079",2018,0,40,0,40
"88080",2017,0,0,21,21
"88080",2018,0,40,0,40
"88081",2017,0,0,21,21
"88081",2018,0,40,0,40
"88082",2017,0,0,21,21
"88082",2018,0,40,0,40
"88083",2017,0,0,21,21
"88083",2018,0,40,0,40
"88084",2017,0,0,21,21
"88084",2018,0,40,0,40
"88085",2017,0,0,21,21
"88085",2018,0,40,0,40
"88086",2017,0,0,21,21
"88086",2018,0,40,0,40
"88087",2017,0,0,21,21
"88087",2018,0,40,0,40
"88088",2017,0,0,21,21
"88088",2018,0,40,0,40
"88089",2017,0,0,21,21
"88089",2018,0,40,0,40
"88090",2017,0,0,21,21
"88090",2018,0,40,0,40
"88091",2017,0,0,21,21
"88091",2018,0,40,0,40
"88092",2017,0,0,21,21
"88092",2018,0,40,0,40
"88093",2017,0,0,21,21
"88093",2018,0,40,0,40
"88094",2017,0,0,21,21
"88094",2018,0,40,0,40
"88095",2017,0,0,21,21
"88095",2018,0,40,0,40
"88096",2017,0,0,21,21
"88096",2018,0,40,0,40
"88097",2017,0,0,21,21
"88097",2018,0,40,0,40
"88098",2017,0,0,21,21
"88098",2018,0,40,0,40
"88099",2017,0,0,21,21
"88099",2018,0,40,0,40
"88100",2017,0,0,21,21
"88100",2018,0,40,0,40
"88101",2017,0,0,21,21
"88101",2018,0,40,0,40
"88102",2017,0,0,21,21
"88102",2018,0,40,0,40
"88103",2017,0,0,21,21
"88103",2018,0,40,0,40
"88104",2017,0,0,21,21
"88104",2018,0,40,0,40
"88105",2017,0,0,21,21
"88105",2018,0,40,0,40
"88106",2017,0,0,21,21
"88106",2018,0,40,0,40
"88107",2017,0,0,21,21
"88107",2018,0,40,0,40
"88108",2017,0,0,21,21
"88108",2018,0,40,0,40
"88109",2017,0,0,21,21
"88109",2018,0,40,0,40
"88110",2017,0,0,21,21
"88110",2018,0,40,0,40
"88111",2017,0,0,21,21
"88111",2018,0,40,0,40
"88113",2017,0,0,21,21
"88113",2018,0,40,0,40
"88114",2017,0,0,21,21
"88114",2018,0,40,0,40
"88115",2017,0,0,21,21
"88115",2018,0,40,0,40
"88116",2017,0,0,21,21
"88116",2018,0,40,0,40
"88117",2017,0,0,21,21
"88117",2018,0,40,0,40
"88118",2017,0,0,21,21
"88118",2018,0,40,0,40
"88119",2017,0,0,21,21
"88119",2018,0,40,0,40
"88120",2017,0,0,21,21
"88120",2018,0,40,0,40
"88121",2017,0,0,21,21
"88121",2018,0,40,0,40
"88122",2017,0,0,21,21
"88122",2018,0,40,0,40
"88123",2017,0,0,21,21
"88123",2018,0,40,0,40
"88124",2017,0,0,21,21
"88124",2018,0,40,0,40
"88125",2017,0,0,21,21
"88125",2018,0,40,0,40
"88126",2017,0,0,21,21
"88126",2018,0,40,0,40
"88127",2017,0,0,21,21
"88127",2018,0,40,0,40
"88128",2017,0,0,21,21
"88128",2018,0,40,0,40
"88129",2017,0,0,21,21
"88129",2018,0,40,0,40
"88130",2017,0,0,21,21
"88130",2018,0,40,0,40
"88131",2017,0,0,21,21
"88131",2018,0,40,0,40
"88132",2017,0,0,21,21
"88132",2018,0,40,0,40
"88133",2017,0,0,21,21
"88133",2018,0,40,0,40
"88134",2017,0,0,21,21
"88134",2018,0,40,0,40
"88135",2017,0,0,21,21
"88135",2018,0,40,0,40
"88136",2017,0,0,21,21
"88136",2018,0,40,0,40
"88137",2017,0,0,21,21
"88137",2018,0,40,0,40
"88138",2017,0,0,21,21
"88138",2018,0,40,0,40
"88139",2017,0,0,21,21
"88139",2018,0,40,0,40
"88140",2017,0,0,21,21
"88140",2018,0,40,0,40
"88141",2017,0,0,21,21
"88141",2018,0,40,0,40
"88142",2017,0,0,21,21
"88142",2018,0,40,0,40
"88143",2017,0,0,21,21
"88143",2018,0,40,0,40
"88144",2017,0,0,21,21
"88144",2018,0,40,0,40
"88145",2017,0,0,21,21
"88145",2018,0,40,0,40
"88146",2017,0,0,21,21
"88146",2018,0,40,0,40
"88147",2017,0,0,21,21
"88147",2018,0,40,0,40
"88148",2017,0,0,21,21
"88148",2018,0,40,0,40
"88149",2017,0,0,21,21
"88149",2018,0,40,0,40
"88150",2017,0,0,21,21
"88150",2018,0,40,0,40
"88151",2017,0,0,21,21
"88151",2018,0,40,0,40
"88152",2017,0,0,21,21
"88152",2018,0,40,0,40
"88153",2017,0,0,21,21
"88153",2018,0,40,0,40
"88154",2017,0,0,21,21
"88154",2018,0,40,0,40
"88155",2017,0,0,21,21
"88155",2018,0,40,0,40
"88156",2017,0,0,21,21
"88156",2018,0,40,0,40
"88157",2017,0,0,21,21
"88157",2018,0,40,0,40
"88158",2017,0,0,21,21
"88158",2018,0,40,0,40
"88159",2017,0,0,21,21
"88159",2018,0,40,0,40
"88160",2017,0,0,21,21
"88160",2018,0,40,0,40
"88161",2017,0,0,21,21
"88161",2018,0,40,0,40
"88162",2017,0,0,21,21
"88162",2018,0,40,0,40
"88163",2017,0,0,21,21
"88163",2018,0,40,0,40
"88164",2017,0,0,21,21
"88164",2018,0,40,0,40
"88165",2017,0,0,21,21
"88165",2018,0,40,0,40
"88166",2017,0,0,21,21
"88166",2018,0,40,0,40
"88167",2017,0,0,21,21
"88167",2018,0,40,0,40
"88168",2017,0,0,21,21
"88168",2018,0,40,0,40
"88169",2017,0,0,21,21
"88169",2018,0,40,0,40
"88170",2017,0,0,21,21
"88170",2018,0,40,0,40
"88171",2017,0,0,21,21
"88171",2018,0,40,0,40
"88172",2017,0,0,21,21
"88172",2018,0,40,0,40
"88173",2017,0,0,21,21
"88173",2018,0,40,0,40
"88174",2017,0,0,21,21
"88174",2018,0,40,0,40
"88175",2017,0,0,21,21
"88175",2018,0,40,0,40
"88176",2017,0,0,21,21
"88176",2018,0,40,0,40
"88177",2017,0,0,21,21
"88177",2018,0,40,0,40
"88178",2017,0,0,21,21
"88178",2018,0,40,0,40
"88179",2017,0,0,21,21
"88179",2018,0,40,0,40
"88180",2017,0,0,21,21
"88180",2018,0,40,0,40
"88181",2017,0,0,21,21
"88181",2018,0,40,0,40
"88182",2017,0,0,21,21
"88182",2018,0,40,0,40
"88183",2017,0,0,21,21
"88183",2018,0,40,0,40
"88184",2017,0,0,21,21
"88184",2018,0,40,0,40
"88185",2017,0,0,21,21
"88185",2018,0,40,0,40
"88186",2017,0,0,21,21
"88186",2018,0,40,0,40
"88187",2017,0,0,21,21
"88187",2018,0,40,0,40
"88188",2017,0,0,21,21
"88188",2018,0,40,0,40
"88189",2017,0,0,21,21
"88189",2018,0,40,0,40
"88190",2017,0,0,21,21
"88190",2018,0,40,0,40
"88192",2017,0,0,21,21
"88192",2018,0,40,0,40
"88193",2017,0,0,21,21
"88193",2018,0,40,0,40
"88194",2017,0,0,21,21
"88194",2018,0,40,0,40
"88195",2017,0,0,21,21
"88195",2018,0,40,0,40
"88196",2017,0,0,21,21
"88196",2018,0,40,0,40
"88197",2017,0,0,21,21
"88197",2018,0,40,0,40
"88198",2017,0,0,21,21
"88198",2018,0,40,0,40
"88199",2017,0,0,21,21
"88199",2018,0,40,0,40
"88200",2017,0,0,21,21
"88200",2018,0,40,0,40
"88201",2017,0,0,21,21
"88201",2018,0,40,0,40
"88202",2017,0,0,21,21
"88202",2018,0,40,0,40
"88203",2017,0,0,21,21
"88203",2018,0,40,0,40
"88205",2017,0,0,21,21
"88205",2018,0,40,0,40
"88206",2017,0,0,21,21
"88206",2018,0,40,0,40
"88208",2017,0,0,21,21
"88208",2018,0,40,0,40
"88209",2017,0,0,21,21
"88209",2018,0,40,0,40
"88210",2017,0,0,21,21
"88210",2018,0,40,0,40
"88212",2017,0,0,21,21
"88212",2018,0,40,0,40
"88213",2017,0,0,21,21
"88213",2018,0,40,0,40
"88214",2017,0,0,21,21
"88214",2018,0,40,0,40
"88215",2017,0,0,21,21
"88215",2018,0,40,0,40
"88216",2017,0,0,21,21
"88216",2018,0,40,0,40
"88218",2017,0,0,21,21
"88218",2018,0,40,0,40
"88219",2017,0,0,21,21
"88219",2018,0,40,0,40
"88220",2017,0,0,21,21
"88220",2018,0,40,0,40
"88221",2017,0,0,21,21
"88221",2018,0,40,0,40
"88222",2017,0,0,21,21
"88222",2018,0,40,0,40
"88223",2017,0,0,21,21
"88223",2018,0,40,0,40
"88224",2017,0,0,21,21
"88224",2018,0,40,0,40
"88225",2017,0,0,21,21
"88225",2018,0,40,0,40
"88226",2017,0,0,21,21
"88226",2018,0,40,0,40
"88227",2017,0,0,21,21
"88227",2018,0,40,0,40
"88228",2017,0,0,21,21
"88228",2018,0,40,0,40
"88229",2017,0,0,21,21
"88229",2018,0,40,0,40
"88230",2017,0,0,21,21
"88230",2018,0,40,0,40
"88231",2017,0,0,21,21
"88231",2018,0,40,0,40
"88232",2017,0,0,21,21
"88232",2018,0,40,0,40
"88233",2017,0,0,21,21
"88233",2018,0,40,0,40
"88236",2017,0,0,21,21
"88236",2018,0,40,0,40
"88237",2017,0,0,21,21
"88237",2018,0,40,0,40
"88238",2017,0,0,21,21
"88238",2018,0,40,0,40
"88239",2017,0,0,21,21
"88239",2018,0,40,0,40
"88240",2017,0,0,21,21
"88240",2018,0,40,0,40
"88241",2017,0,0,21,21
"88241",2018,0,40,0,40
"88242",2017,0,0,21,21
"88242",2018,0,40,0,40
"88243",2017,0,0,21,21
"88243",2018,0,40,0,40
"88244",2017,0,0,21,21
"88244",2018,0,40,0,40
"88245",2017,0,0,21,21
"88245",2018,0,40,0,40
"88246",2017,0,0,21,21
"88246",2018,0,40,0,40
"88247",2017,0,0,21,21
"88247",2018,0,40,0,40
"88248",2017,0,0,21,21
"88248",2018,0,40,0,40
"88249",2017,0,0,21,21
"88249",2018,0,40,0,40
"88250",2017,0,0,21,21
"88250",2018,0,40,0,40
"88251",2017,0,0,21,21
"88251",2018,0,40,0,40
"88252",2017,0,0,21,21
"88252",2018,0,40,0,40
"88253",2017,0,0,21,21
"88253",2018,0,40,0,40
"88254",2017,0,0,21,21
"88254",2018,0,40,0,40
"88255",2017,0,0,21,21
"88255",2018,0,40,0,40
"88256",2017,0,0,21,21
"88256",2018,0,40,0,40
"88257",2017,0,0,21,21
"88257",2018,0,40,0,40
"88258",2017,0,0,21,21
"88258",2018,0,40,0,40
"88259",2017,0,0,21,21
"88259",2018,0,40,0,40
"88260",2017,0,0,21,21
"88260",2018,0,40,0,40
"88261",2017,0,0,21,21
"88261",2018,0,40,0,40
"88262",2017,0,0,21,21
"88262",2018,0,40,0,40
"88263",2017,0,0,21,21
"88263",2018,0,40,0,40
"88264",2017,0,0,21,21
"88264",2018,0,40,0,40
"88265",2017,0,0,21,21
"88265",2018,0,40,0,40
"88266",2017,0,0,21,21
"88266",2018,0,40,0,40
"88267",2017,0,0,21,21
"88267",2018,0,40,0,40
"88268",2017,0,0,21,21
"88268",2018,0,40,0,40
"88269",2017,0,0,21,21
"88269",2018,0,40,0,40
"88270",2017,0,0,21,21
"88270",2018,0,40,0,40
"88271",2017,0,0,21,21
"88271",2018,0,40,0,40
"88272",2017,0,0,21,21
"88272",2018,0,40,0,40
"88273",2017,0,0,21,21
"88273",2018,0,40,0,40
"88274",2017,0,0,21,21
"88274",2018,0,40,0,40
"88275",2017,0,0,21,21
"88275",2018,0,40,0,40
"88276",2017,0,0,21,21
"88276",2018,0,40,0,40
"88277",2017,0,0,21,21
"88277",2018,0,40,0,40
"88278",2017,0,0,21,21
"88278",2018,0,40,0,40
"88279",2017,0,0,21,21
"88279",2018,0,40,0,40
"88280",2017,0,0,21,21
"88280",2018,0,40,0,40
"88281",2017,0,0,21,21
"88281",2018,0,40,0,40
"88283",2017,0,0,21,21
"88283",2018,0,40,0,40
"88284",2017,0,0,21,21
"88284",2018,0,40,0,40
"88285",2017,0,0,21,21
"88285",2018,0,40,0,40
"88286",2017,0,0,21,21
"88286",2018,0,40,0,40
"88287",2017,0,0,21,21
"88287",2018,0,40,0,40
"88288",2017,0,0,21,21
"88288",2018,0,40,0,40
"88289",2017,0,0,21,21
"88289",2018,0,40,0,40
"88290",2017,0,0,21,21
"88290",2018,0,40,0,40
"88291",2017,0,0,21,21
"88291",2018,0,40,0,40
"88292",2017,0,0,21,21
"88292",2018,0,40,0,40
"88293",2017,0,0,21,21
"88293",2018,0,40,0,40
"88294",2017,0,0,21,21
"88294",2018,0,40,0,40
"88295",2017,0,0,21,21
"88295",2018,0,40,0,40
"88296",2017,0,0,21,21
"88296",2018,0,40,0,40
"88297",2017,0,0,21,21
"88297",2018,0,40,0,40
"88298",2017,0,0,21,21
"88298",2018,0,40,0,40
"88299",2017,0,0,21,21
"88299",2018,0,40,0,40
"88300",2017,0,0,21,21
"88300",2018,0,40,0,40
"88301",2017,0,0,21,21
"88301",2018,0,40,0,40
"88302",2017,0,0,21,21
"88302",2018,0,40,0,40
"88303",2017,0,0,21,21
"88303",2018,0,40,0,40
"88304",2017,0,0,21,21
"88304",2018,0,40,0,40
"88305",2017,0,0,21,21
"88305",2018,0,40,0,40
"88306",2017,0,0,21,21
"88306",2018,0,40,0,40
"88307",2017,0,0,21,21
"88307",2018,0,40,0,40
"88308",2017,0,0,21,21
"88308",2018,0,40,0,40
"88309",2017,0,0,21,21
"88309",2018,0,40,0,40
"88310",2017,0,0,21,21
"88310",2018,0,40,0,40
"88311",2017,0,0,21,21
"88311",2018,0,40,0,40
"88312",2017,0,0,21,21
"88312",2018,0,40,0,40
"88313",2017,0,0,21,21
"88313",2018,0,40,0,40
"88314",2017,0,0,21,21
"88314",2018,0,40,0,40
"88315",2017,0,0,21,21
"88315",2018,0,40,0,40
"88316",2017,0,0,21,21
"88316",2018,0,40,0,40
"88317",2017,0,0,21,21
"88317",2018,0,40,0,40
"88318",2017,0,0,21,21
"88318",2018,0,40,0,40
"88319",2017,0,0,21,21
"88319",2018,0,40,0,40
"88320",2017,0,0,21,21
"88320",2018,0,40,0,40
"88321",2017,0,0,21,21
"88321",2018,0,40,0,40
"88322",2017,0,0,21,21
"88322",2018,0,40,0,40
"88324",2017,0,0,21,21
"88324",2018,0,40,0,40
"88325",2017,0,0,21,21
"88325",2018,0,40,0,40
"88326",2017,0,0,21,21
"88326",2018,0,40,0,40
"88327",2017,0,0,21,21
"88327",2018,0,40,0,40
"88328",2017,0,0,21,21
"88328",2018,0,40,0,40
"88330",2017,0,0,21,21
"88330",2018,0,40,0,40
"88331",2017,0,0,21,21
"88331",2018,0,40,0,40
"88332",2017,0,0,21,21
"88332",2018,0,40,0,40
"88333",2017,0,0,21,21
"88333",2018,0,40,0,40
"88334",2017,0,0,21,21
"88334",2018,0,40,0,40
"88335",2017,0,0,21,21
"88335",2018,0,40,0,40
"88336",2017,0,0,21,21
"88336",2018,0,40,0,40
"88338",2017,0,0,21,21
"88338",2018,0,40,0,40
"88340",2017,0,0,21,21
"88340",2018,0,40,0,40
"88341",2017,0,0,21,21
"88341",2018,0,40,0,40
"88342",2017,0,0,21,21
"88342",2018,0,40,0,40
"88343",2017,0,0,21,21
"88343",2018,0,40,0,40
"88344",2017,0,0,21,21
"88344",2018,0,40,0,40
"88345",2017,0,0,21,21
"88345",2018,0,40,0,40
"88346",2017,0,0,21,21
"88346",2018,0,40,0,40
"88347",2017,0,0,21,21
"88347",2018,0,40,0,40
"88348",2017,0,0,21,21
"88348",2018,0,40,0,40
"88349",2017,0,0,21,21
"88349",2018,0,40,0,40
"88350",2017,0,0,21,21
"88350",2018,0,40,0,40
"88351",2017,0,0,21,21
"88351",2018,0,40,0,40
"88352",2017,0,0,21,21
"88352",2018,0,40,0,40
"88353",2017,0,0,21,21
"88353",2018,0,40,0,40
"88354",2017,0,0,21,21
"88354",2018,0,40,0,40
"88355",2017,0,0,21,21
"88355",2018,0,40,0,40
"88356",2017,0,0,21,21
"88356",2018,0,40,0,40
"88357",2017,0,0,21,21
"88357",2018,0,40,0,40
"88358",2017,0,0,21,21
"88358",2018,0,40,0,40
"88359",2017,0,0,21,21
"88359",2018,0,40,0,40
"88360",2017,0,0,21,21
"88360",2018,0,40,0,40
"88361",2017,0,0,21,21
"88361",2018,0,40,0,40
"88362",2017,0,0,21,21
"88362",2018,0,40,0,40
"88363",2017,0,0,21,21
"88363",2018,0,40,0,40
"88364",2017,0,0,21,21
"88364",2018,0,40,0,40
"88365",2017,0,0,21,21
"88365",2018,0,40,0,40
"88366",2017,0,0,21,21
"88366",2018,0,40,0,40
"88367",2017,0,0,21,21
"88367",2018,0,40,0,40
"88368",2017,0,0,21,21
"88368",2018,0,40,0,40
"88369",2017,0,0,21,21
"88369",2018,0,40,0,40
"88370",2017,0,0,21,21
"88370",2018,0,40,0,40
"88371",2017,0,0,21,21
"88371",2018,0,40,0,40
"88372",2017,0,0,21,21
"88372",2018,0,40,0,40
"88373",2017,0,0,21,21
"88373",2018,0,40,0,40
"88374",2017,0,0,21,21
"88374",2018,0,40,0,40
"88375",2017,0,0,21,21
"88375",2018,0,40,0,40
"88376",2017,0,0,21,21
"88376",2018,0,40,0,40
"88377",2017,0,0,21,21
"88377",2018,0,40,0,40
"88378",2017,0,0,21,21
"88378",2018,0,40,0,40
"88379",2017,0,0,21,21
"88379",2018,0,40,0,40
"88380",2017,0,0,21,21
"88380",2018,0,40,0,40
"88381",2017,0,0,21,21
"88381",2018,0,40,0,40
"88382",2017,0,0,21,21
"88382",2018,0,40,0,40
"88383",2017,0,0,21,21
"88383",2018,0,40,0,40
"88385",2017,0,0,21,21
"88385",2018,0,40,0,40
"88386",2017,0,0,21,21
"88386",2018,0,40,0,40
"88387",2017,0,0,21,21
"88387",2018,0,40,0,40
"88388",2017,0,0,21,21
"88388",2018,0,40,0,40
"88389",2017,0,0,21,21
"88389",2018,0,40,0,40
"88390",2017,0,0,21,21
"88390",2018,0,40,0,40
"88391",2017,0,0,21,21
"88391",2018,0,40,0,40
"88393",2017,0,0,21,21
"88393",2018,0,40,0,40
"88394",2017,0,0,21,21
"88394",2018,0,40,0,40
"88395",2017,0,0,21,21
"88395",2018,0,40,0,40
"88398",2017,0,0,21,21
"88398",2018,0,40,0,40
"88399",2017,0,0,21,21
"88399",2018,0,40,0,40
"88400",2017,0,0,21,21
"88400",2018,0,40,0,40
"88401",2017,0,0,21,21
"88401",2018,0,40,0,40
"88402",2017,0,0,21,21
"88402",2018,0,40,0,40
"88403",2017,0,0,21,21
"88403",2018,0,40,0,40
"88404",2017,0,0,21,21
"88404",2018,0,40,0,40
"88406",2017,0,0,21,21
"88406",2018,0,40,0,40
"88407",2017,0,0,21,21
"88407",2018,0,40,0,40
"88408",2017,0,0,21,21
"88408",2018,0,40,0,40
"88409",2017,0,0,21,21
"88409",2018,0,40,0,40
"88410",2017,0,0,21,21
"88410",2018,0,40,0,40
"88411",2017,0,0,21,21
"88411",2018,0,40,0,40
"88412",2017,0,0,21,21
"88412",2018,0,40,0,40
"88413",2017,0,0,21,21
"88413",2018,0,40,0,40
"88415",2017,0,0,21,21
"88415",2018,0,40,0,40
"88416",2017,0,0,21,21
"88416",2018,0,40,0,40
"88417",2017,0,0,21,21
"88417",2018,0,40,0,40
"88418",2017,0,0,21,21
"88418",2018,0,40,0,40
"88419",2017,0,0,21,21
"88419",2018,0,40,0,40
"88421",2017,0,0,21,21
"88421",2018,0,40,0,40
"88423",2017,0,0,21,21
"88423",2018,0,40,0,40
"88424",2017,0,0,21,21
"88424",2018,0,40,0,40
"88425",2017,0,0,21,21
"88425",2018,0,40,0,40
"88426",2017,0,0,21,21
"88426",2018,0,40,0,40
"88427",2017,0,0,21,21
"88427",2018,0,40,0,40
"88428",2017,0,0,21,21
"88428",2018,0,40,0,40
"88429",2017,0,0,21,21
"88429",2018,0,40,0,40
"88430",2017,0,0,21,21
"88430",2018,0,40,0,40
"88431",2017,0,0,21,21
"88431",2018,0,40,0,40
"88432",2017,0,0,21,21
"88432",2018,0,40,0,40
"88433",2017,0,0,21,21
"88433",2018,0,40,0,40
"88434",2017,0,0,21,21
"88434",2018,0,40,0,40
"88435",2017,0,0,21,21
"88435",2018,0,40,0,40
"88436",2017,0,0,21,21
"88436",2018,0,40,0,40
"88437",2017,0,0,21,21
"88437",2018,0,40,0,40
"88438",2017,0,0,21,21
"88438",2018,0,40,0,40
"88439",2017,0,0,21,21
"88439",2018,0,40,0,40
"88440",2017,0,0,21,21
"88440",2018,0,40,0,40
"88441",2017,0,0,21,21
"88441",2018,0,40,0,40
"88442",2017,0,0,21,21
"88442",2018,0,40,0,40
"88443",2017,0,0,21,21
"88443",2018,0,40,0,40
"88444",2017,0,0,21,21
"88444",2018,0,40,0,40
"88445",2017,0,0,21,21
"88445",2018,0,40,0,40
"88446",2017,0,0,21,21
"88446",2018,0,40,0,40
"88447",2017,0,0,21,21
"88447",2018,0,40,0,40
"88448",2017,0,0,21,21
"88448",2018,0,40,0,40
"88449",2017,0,0,21,21
"88449",2018,0,40,0,40
"88450",2017,0,0,21,21
"88450",2018,0,40,0,40
"88451",2017,0,0,21,21
"88451",2018,0,40,0,40
"88452",2017,0,0,21,21
"88452",2018,0,40,0,40
"88453",2017,0,0,21,21
"88453",2018,0,40,0,40
"88454",2017,0,0,21,21
"88454",2018,0,40,0,40
"88455",2017,0,0,21,21
"88455",2018,0,40,0,40
"88456",2017,0,0,21,21
"88456",2018,0,40,0,40
"88457",2017,0,0,21,21
"88457",2018,0,40,0,40
"88458",2017,0,0,21,21
"88458",2018,0,40,0,40
"88459",2017,0,0,21,21
"88459",2018,0,40,0,40
"88460",2017,0,0,21,21
"88460",2018,0,40,0,40
"88461",2017,0,0,21,21
"88461",2018,0,40,0,40
"88462",2017,0,0,21,21
"88462",2018,0,40,0,40
"88463",2017,0,0,21,21
"88463",2018,0,40,0,40
"88464",2017,0,0,21,21
"88464",2018,0,40,0,40
"88465",2017,0,0,21,21
"88465",2018,0,40,0,40
"88466",2017,0,0,21,21
"88466",2018,0,40,0,40
"88467",2017,0,0,21,21
"88467",2018,0,40,0,40
"88468",2017,0,0,21,21
"88468",2018,0,40,0,40
"88469",2017,0,0,21,21
"88469",2018,0,40,0,40
"88470",2017,0,0,21,21
"88470",2018,0,40,0,40
"88471",2017,0,0,21,21
"88471",2018,0,40,0,40
"88472",2017,0,0,21,21
"88472",2018,0,40,0,40
"88473",2017,0,0,21,21
"88473",2018,0,40,0,40
"88474",2017,0,0,21,21
"88474",2018,0,40,0,40
"88475",2017,0,0,21,21
"88475",2018,0,40,0,40
"88476",2017,0,0,21,21
"88476",2018,0,40,0,40
"88477",2017,0,0,21,21
"88477",2018,0,40,0,40
"88478",2017,0,0,21,21
"88478",2018,0,40,0,40
"88479",2017,0,0,21,21
"88479",2018,0,40,0,40
"88480",2017,0,0,21,21
"88480",2018,0,40,0,40
"88481",2017,0,0,21,21
"88481",2018,0,40,0,40
"88482",2017,0,0,21,21
"88482",2018,0,40,0,40
"88483",2017,0,0,21,21
"88483",2018,0,40,0,40
"88484",2017,0,0,21,21
"88484",2018,0,40,0,40
"88485",2017,0,0,21,21
"88485",2018,0,40,0,40
"88486",2017,0,0,21,21
"88486",2018,0,40,0,40
"88487",2017,0,0,21,21
"88487",2018,0,40,0,40
"88488",2017,0,0,21,21
"88488",2018,0,40,0,40
"88489",2017,0,0,21,21
"88489",2018,0,40,0,40
"88490",2017,0,0,21,21
"88490",2018,0,40,0,40
"88491",2017,0,0,21,21
"88491",2018,0,40,0,40
"88492",2017,0,0,21,21
"88492",2018,0,40,0,40
"88493",2017,0,0,21,21
"88493",2018,0,40,0,40
"88494",2017,0,0,21,21
"88494",2018,0,40,0,40
"88495",2017,0,0,21,21
"88495",2018,0,40,0,40
"88496",2017,0,0,21,21
"88496",2018,0,40,0,40
"88497",2017,0,0,21,21
"88497",2018,0,40,0,40
"88498",2017,0,0,21,21
"88498",2018,0,40,0,40
"88499",2017,0,0,21,21
"88499",2018,0,40,0,40
"88500",2017,0,0,21,21
"88500",2018,0,40,0,40
"88501",2017,0,0,21,21
"88501",2018,0,40,0,40
"88502",2017,0,0,21,21
"88502",2018,0,40,0,40
"88503",2017,0,0,21,21
"88503",2018,0,40,0,40
"88504",2017,0,0,21,21
"88504",2018,0,40,0,40
"88505",2017,0,0,21,21
"88505",2018,0,40,0,40
"88506",2017,0,0,21,21
"88506",2018,0,40,0,40
"88507",2017,0,0,21,21
"88507",2018,0,40,0,40
"88508",2017,0,0,21,21
"88508",2018,0,40,0,40
"88509",2017,0,0,21,21
"88509",2018,0,40,0,40
"88510",2017,0,0,21,21
"88510",2018,0,40,0,40
"88511",2017,0,0,21,21
"88511",2018,0,40,0,40
"88512",2017,0,0,21,21
"88512",2018,0,40,0,40
"88513",2017,0,0,21,21
"88513",2018,0,40,0,40
"88514",2017,0,0,21,21
"88514",2018,0,40,0,40
"88515",2017,0,0,21,21
"88515",2018,0,40,0,40
"88516",2017,0,0,21,21
"88516",2018,0,40,0,40
"88517",2017,0,0,21,21
"88517",2018,0,40,0,40
"88518",2017,0,0,21,21
"88518",2018,0,40,0,40
"88519",2017,0,0,21,21
"88519",2018,0,40,0,40
"88520",2017,0,0,21,21
"88520",2018,0,40,0,40
"88521",2017,0,0,21,21
"88521",2018,0,40,0,40
"88522",2017,0,0,21,21
"88522",2018,0,40,0,40
"88523",2017,0,0,21,21
"88523",2018,0,40,0,40
"88524",2017,0,0,21,21
"88524",2018,0,40,0,40
"88525",2017,0,0,21,21
"88525",2018,0,40,0,40
"88526",2017,0,0,21,21
"88526",2018,0,40,0,40
"88527",2017,0,0,21,21
"88527",2018,0,40,0,40
"88528",2017,0,0,21,21
"88528",2018,0,40,0,40
"88529",2017,0,0,21,21
"88529",2018,0,40,0,40
"88530",2017,0,0,21,21
"88530",2018,0,40,0,40
"88531",2017,0,0,21,21
"88531",2018,0,40,0,40
"88532",2017,0,0,21,21
"88532",2018,0,40,0,40
"89002",2014,0,0,147,147
"89002",2017,0,0,27,27
"89002",2019,0,0,15,15
"89002",2020,0,0,31,31
"89003",2014,0,0,147,147
"89003",2015,0,0,29,29
"89003",2016,0,0,105,105
"89003",2017,0,0,27,27
"89003",2019,0,0,15,15
"89003",2020,0,0,31,31
"89004",2014,0,0,147,147
"89004",2017,0,0,27,27
"89004",2018,0,0,27,27
"89004",2019,0,0,15,15
"89004",2020,0,0,31,31
"89005",2014,0,0,147,147
"89005",2017,0,0,27,27
"89005",2018,0,0,27,27
"89005",2019,0,0,15,15
"89005",2020,0,0,31,31
"89006",2014,0,0,147,147
"89006",2017,0,0,27,27
"89006",2018,0,0,27,27
"89006",2019,0,0,15,15
"89006",2020,0,0,31,31
"89007",2014,0,0,147,147
"89007",2017,0,0,102,102
"89007",2018,0,0,75,75
"89007",2019,0,0,30,30
"89007",2020,0,0,76,76
"89008",2014,0,0,147,147
"89008",2017,0,0,27,27
"89008",2019,0,0,15,15
"89008",2020,0,0,31,31
"89009",2014,0,0,147,147
"89009",2016,0,0,105,105
"89009",2017,0,0,27,27
"89009",2019,0,0,15,15
"89009",2020,0,0,31,31
"89010",2014,0,0,147,147
"89010",2017,0,0,27,27
"89010",2019,0,0,15,15
"89010",2020,0,0,31,31
"89011",2014,0,0,147,147
"89011",2016,0,0,105,105
"89011",2017,0,0,27,27
"89011",2019,0,0,15,15
"89011",2020,0,0,31,31
"89012",2014,0,0,147,147
"89012",2017,0,0,27,27
"89012",2019,0,0,15,15
"89012",2020,0,0,31,31
"89013",2014,0,0,147,147
"89013",2015,0,0,29,29
"89013",2016,0,0,105,105
"89013",2017,0,0,27,27
"89013",2019,0,0,15,15
"89013",2020,0,0,31,31
"89014",2014,0,0,147,147
"89014",2016,0,0,105,105
"89014",2017,0,0,27,27
"89014",2018,0,0,6,6
"89014",2019,0,0,15,15
"89014",2020,0,0,49,49
"89015",2014,0,0,147,147
"89015",2015,0,0,5,5
"89015",2017,0,0,27,27
"89015",2018,0,0,49,49
"89015",2019,0,0,15,15
"89015",2020,0,0,31,31
"89016",2014,0,0,147,147
"89016",2017,0,0,27,27
"89016",2018,0,0,27,27
"89016",2019,0,0,15,15
"89016",2020,0,0,31,31
"89017",2014,0,0,147,147
"89017",2017,0,0,27,27
"89017",2019,0,0,15,15
"89017",2020,0,0,31,31
"89018",2014,0,0,147,147
"89018",2015,0,0,29,29
"89018",2016,0,0,105,105
"89018",2017,0,0,27,27
"89018",2019,0,0,15,15
"89018",2020,0,0,31,31
"89019",2014,0,0,147,147
"89019",2015,0,0,12,12
"89019",2016,0,0,105,105
"89019",2017,0,0,27,27
"89019",2018,0,0,6,6
"89019",2019,0,0,15,15
"89019",2020,0,0,31,31
"89020",2014,0,0,147,147
"89020",2017,0,0,102,102
"89020",2018,0,0,75,75
"89020",2019,0,0,30,30
"89020",2020,0,0,76,76
"89021",2014,0,0,147,147
"89021",2016,0,0,105,105
"89021",2017,0,0,27,27
"89021",2019,0,0,15,15
"89021",2020,0,0,31,31
"89022",2014,0,0,147,147
"89022",2016,0,0,105,105
"89022",2017,0,0,27,27
"89022",2019,0,0,15,15
"89022",2020,0,0,31,31
"89023",2014,0,0,147,147
"89023",2017,0,0,102,102
"89023",2018,0,0,75,75
"89023",2019,0,0,30,30
"89023",2020,0,0,76,76
"89024",2014,0,0,147,147
"89024",2017,0,0,102,102
"89024",2018,0,0,75,75
"89024",2019,0,0,30,30
"89024",2020,0,0,76,76
"89025",2014,0,0,147,147
"89025",2016,0,0,105,105
"89025",2017,0,0,27,27
"89025",2019,0,0,15,15
"89025",2020,0,0,31,31
"89027",2014,0,0,147,147
"89027",2015,0,0,29,29
"89027",2017,0,0,27,27
"89027",2018,0,0,75,75
"89027",2019,0,0,15,15
"89027",2020,0,0,49,49
"89028",2014,0,0,147,147
"89028",2017,0,0,27,27
"89028",2018,0,0,27,27
"89028",2019,0,0,15,15
"89028",2020,0,0,31,31
"89029",2014,0,0,147,147
"89029",2016,0,0,105,105
"89029",2017,0,0,27,27
"89029",2019,0,0,15,15
"89029",2020,0,0,31,31
"89030",2014,0,0,147,147
"89030",2015,0,0,5,5
"89030",2017,0,0,27,27
"89030",2018,0,0,49,49
"89030",2019,0,0,15,15
"89030",2020,0,0,31,31
"89031",2014,0,0,147,147
"89031",2015,0,0,26,26
"89031",2016,0,0,105,105
"89031",2017,0,0,27,27
"89031",2018,0,0,6,6
"89031",2019,0,0,15,15
"89031",2020,0,0,49,49
"89032",2014,0,0,147,147
"89032",2016,0,0,105,105
"89032",2017,0,0,27,27
"89032",2019,0,0,15,15
"89032",2020,0,0,31,31
"89033",2014,0,0,147,147
"89033",2015,0,0,29,29
"89033",2016,0,0,105,105
"89033",2017,0,0,27,27
"89033",2019,0,0,15,15
"89033",2020,0,0,31,31
"89034",2014,0,0,147,147
"89034",2017,0,0,27,27
"89034",2019,0,0,15,15
"89034",2020,0,0,31,31
"89035",2014,0,0,147,147
"89035",2016,0,0,105,105
"89035",2017,0,0,27,27
"89035",2018,0,0,6,6
"89035",2019,0,0,15,15
"89035",2020,0,0,49,49
"89036",2014,0,0,147,147
"89036",2017,0,0,102,102
"89036",2018,0,0,119,119
"89036",2019,0,0,96,96
"89036",2020,0,0,76,76
"89037",2014,0,0,147,147
"89037",2015,0,0,29,29
"89037",2016,0,0,105,105
"89037",2017,0,0,27,27
"89037",2019,0,0,15,15
"89037",2020,0,0,31,31
"89038",2014,0,0,147,147
"89038",2016,0,0,105,105
"89038",2017,0,0,27,27
"89038",2018,0,0,6,6
"89038",2019,0,0,15,15
"89038",2020,0,0,31,31
"89039",2014,0,0,147,147
"89039",2017,0,0,27,27
"89039",2019,0,0,15,15
"89039",2020,0,0,31,31
"89040",2014,0,0,147,147
"89040",2015,0,0,5,5
"89040",2017,0,0,27,27
"89040",2018,0,0,49,49
"89040",2019,0,0,15,15
"89040",2020,0,0,31,31
"89041",2014,0,0,147,147
"89041",2015,0,0,26,26
"89041",2016,0,0,105,105
"89041",2017,0,0,27,27
"89041",2018,0,0,6,6
"89041",2019,0,0,29,29
"89041",2020,0,0,49,49
"89042",2014,0,0,147,147
"89042",2017,0,0,27,27
"89042",2019,0,0,15,15
"89042",2020,0,0,31,31
"89043",2014,0,0,147,147
"89043",2017,0,0,27,27
"89043",2019,0,0,15,15
"89043",2020,0,0,31,31
"89044",2014,0,0,147,147
"89044",2015,0,0,5,5
"89044",2017,0,0,27,27
"89044",2018,0,0,49,49
"89044",2019,0,0,15,15
"89044",2020,0,0,31,31
"89045",2014,0,0,147,147
"89045",2017,0,0,27,27
"89045",2019,0,0,15,15
"89045",2020,0,0,31,31
"89046",2014,0,0,147,147
"89046",2015,0,0,43,43
"89046",2017,0,0,102,102
"89046",2018,0,0,75,75
"89046",2019,0,0,29,29
"89046",2020,0,0,31,31
"89048",2014,0,0,147,147
"89048",2015,0,0,29,29
"89048",2017,0,0,27,27
"89048",2018,0,0,75,75
"89048",2019,0,0,15,15
"89048",2020,0,0,49,49
"89049",2014,0,0,147,147
"89049",2015,0,0,5,5
"89049",2017,0,0,27,27
"89049",2018,0,0,49,49
"89049",2019,0,0,15,15
"89049",2020,0,0,31,31
"89050",2014,0,0,147,147
"89050",2015,0,0,26,26
"89050",2016,0,0,105,105
"89050",2017,0,0,27,27
"89050",2018,0,0,6,6
"89050",2019,0,0,15,15
"89050",2020,0,0,49,49
"89051",2014,0,0,147,147
"89051",2015,0,0,29,29
"89051",2017,0,0,27,27
"89051",2018,0,0,75,75
"89051",2019,0,0,15,15
"89051",2020,0,0,49,49
"89053",2014,0,0,147,147
"89053",2015,0,0,29,29
"89053",2016,0,0,105,105
"89053",2017,0,0,27,27
"89053",2019,0,0,15,15
"89053",2020,0,0,31,31
"89054",2014,0,0,147,147
"89054",2017,0,0,102,102
"89054",2018,0,0,27,27
"89054",2019,0,0,44,44
"89054",2020,0,0,76,76
"89055",2014,0,0,147,147
"89055",2015,0,0,26,26
"89055",2016,0,0,105,105
"89055",2017,0,0,27,27
"89055",2018,0,0,6,6
"89055",2019,0,0,29,29
"89055",2020,0,0,49,49
"89056",2014,0,0,147,147
"89056",2015,0,0,26,26
"89056",2016,0,0,105,105
"89056",2017,0,0,27,27
"89056",2018,0,0,6,6
"89056",2019,0,0,29,29
"89056",2020,0,0,49,49
"89057",2014,0,0,147,147
"89057",2017,0,0,102,102
"89057",2018,0,0,75,75
"89057",2019,0,0,30,30
"89057",2020,0,0,76,76
"89058",2014,0,0,147,147
"89058",2016,0,0,105,105
"89058",2017,0,0,27,27
"89058",2019,0,0,15,15
"89058",2020,0,0,31,31
"89059",2014,0,0,147,147
"89059",2016,0,0,105,105
"89059",2017,0,0,27,27
"89059",2018,0,0,6,6
"89059",2019,0,0,15,15
"89059",2020,0,0,49,49
"89060",2014,0,0,147,147
"89060",2015,0,0,29,29
"89060",2016,0,0,105,105
"89060",2017,0,0,27,27
"89060",2019,0,0,15,15
"89060",2020,0,0,31,31
"89061",2014,0,0,147,147
"89061",2015,0,0,26,26
"89061",2016,0,0,105,105
"89061",2017,0,0,27,27
"89061",2018,0,0,6,6
"89061",2019,0,0,29,29
"89061",2020,0,0,49,49
"89062",2014,0,0,147,147
"89062",2016,0,0,105,105
"89062",2017,0,0,27,27
"89062",2018,0,0,6,6
"89062",2019,0,0,15,15
"89062",2020,0,0,31,31
"89063",2014,0,0,147,147
"89063",2015,0,0,29,29
"89063",2016,0,0,105,105
"89063",2017,0,0,27,27
"89063",2019,0,0,15,15
"89063",2020,0,0,31,31
"89064",2014,0,0,147,147
"89064",2017,0,0,27,27
"89064",2019,0,0,15,15
"89064",2020,0,0,31,31
"89065",2014,0,0,147,147
"89065",2015,0,0,29,29
"89065",2017,0,0,27,27
"89065",2018,0,0,75,75
"89065",2019,0,0,15,15
"89065",2020,0,0,49,49
"89066",2014,0,0,147,147
"89066",2015,0,0,29,29
"89066",2017,0,0,27,27
"89066",2018,0,0,75,75
"89066",2019,0,0,15,15
"89066",2020,0,0,49,49
"89067",2014,0,0,147,147
"89067",2015,0,0,29,29
"89067",2016,0,0,105,105
"89067",2017,0,0,27,27
"89067",2019,0,0,15,15
"89067",2020,0,0,31,31
"89068",2014,0,0,147,147
"89068",2017,0,0,27,27
"89068",2019,0,0,15,15
"89068",2020,0,0,31,31
"89069",2014,0,0,147,147
"89069",2016,0,0,105,105
"89069",2017,0,0,27,27
"89069",2018,0,0,6,6
"89069",2019,0,0,15,15
"89069",2020,0,0,49,49
"89071",2014,0,0,147,147
"89071",2017,0,0,102,102
"89071",2018,0,0,75,75
"89071",2019,0,0,30,30
"89071",2020,0,0,76,76
"89072",2014,0,0,147,147
"89072",2015,0,0,43,43
"89072",2017,0,0,102,102
"89072",2018,0,0,75,75
"89072",2019,0,0,29,29
"89072",2020,0,0,31,31
"89073",2014,0,0,147,147
"89073",2015,0,0,43,43
"89073",2017,0,0,102,102
"89073",2018,0,0,75,75
"89073",2019,0,0,29,29
"89073",2020,0,0,31,31
"89074",2014,0,0,147,147
"89074",2017,0,0,102,102
"89074",2018,0,0,27,27
"89074",2019,0,0,44,44
"89074",2020,0,0,76,76
"89075",2014,0,0,147,147
"89075",2015,0,0,29,29
"89075",2016,0,0,105,105
"89075",2017,0,0,27,27
"89075",2019,0,0,15,15
"89075",2020,0,0,31,31
"89076",2014,0,0,147,147
"89076",2016,0,0,105,105
"89076",2017,0,0,27,27
"89076",2018,0,0,6,6
"89076",2019,0,0,15,15
"89076",2020,0,0,49,49
"89077",2014,0,0,147,147
"89077",2017,0,0,102,102
"89077",2018,0,0,75,75
"89077",2019,0,0,30,30
"89077",2020,0,0,76,76
"89079",2014,0,0,147,147
"89079",2015,0,0,29,29
"89079",2016,0,0,105,105
"89079",2017,0,0,27,27
"89079",2019,0,0,15,15
"89079",2020,0,0,31,31
"89080",2014,0,0,147,147
"89080",2017,0,0,102,102
"89080",2018,0,0,27,27
"89080",2019,0,0,44,44
"89080",2020,0,0,76,76
"89081",2014,0,0,147,147
"89081",2017,0,0,27,27
"89081",2019,0,0,15,15
"89081",2020,0,0,31,31
"89083",2014,0,0,147,147
"89083",2015,0,0,29,29
"89083",2016,0,0,105,105
"89083",2017,0,0,27,27
"89083",2019,0,0,15,15
"89083",2020,0,0,31,31
"89084",2014,0,0,147,147
"89084",2017,0,0,102,102
"89084",2018,0,0,75,75
"89084",2019,0,0,30,30
"89084",2020,0,0,76,76
"89085",2014,0,0,147,147
"89085",2016,0,0,105,105
"89085",2017,0,0,27,27
"89085",2019,0,0,15,15
"89085",2020,0,0,31,31
"89086",2014,0,0,147,147
"89086",2015,0,0,29,29
"89086",2016,0,0,105,105
"89086",2017,0,0,27,27
"89086",2019,0,0,15,15
"89086",2020,0,0,31,31
"89087",2014,0,0,147,147
"89087",2017,0,0,27,27
"89087",2018,0,0,27,27
"89087",2019,0,0,15,15
"89087",2020,0,0,31,31
"89088",2014,0,0,147,147
"89088",2015,0,0,29,29
"89088",2016,0,0,105,105
"89088",2017,0,0,27,27
"89088",2019,0,0,15,15
"89088",2020,0,0,31,31
"89089",2014,0,0,147,147
"89089",2015,0,0,5,5
"89089",2017,0,0,27,27
"89089",2018,0,0,49,49
"89089",2019,0,0,15,15
"89089",2020,0,0,31,31
"89091",2014,0,0,147,147
"89091",2017,0,0,102,102
"89091",2018,0,0,75,75
"89091",2019,0,0,30,30
"89091",2020,0,0,76,76
"89092",2014,0,0,147,147
"89092",2017,0,0,27,27
"89092",2019,0,0,15,15
"89092",2020,0,0,31,31
"89093",2014,0,0,147,147
"89093",2017,0,0,102,102
"89093",2018,0,0,27,27
"89093",2019,0,0,44,44
"89093",2020,0,0,76,76
"89094",2014,0,0,147,147
"89094",2017,0,0,102,102
"89094",2018,0,0,27,27
"89094",2019,0,0,44,44
"89094",2020,0,0,76,76
"89095",2014,0,0,147,147
"89095",2017,0,0,27,27
"89095",2019,0,0,15,15
"89095",2020,0,0,31,31
"89096",2014,0,0,147,147
"89096",2015,0,0,26,26
"89096",2016,0,0,105,105
"89096",2017,0,0,27,27
"89096",2018,0,0,6,6
"89096",2019,0,0,15,15
"89096",2020,0,0,49,49
"89098",2014,0,0,147,147
"89098",2017,0,0,27,27
"89098",2018,0,0,27,27
"89098",2019,0,0,15,15
"89098",2020,0,0,31,31
"89099",2014,0,0,147,147
"89099",2015,0,0,26,26
"89099",2016,0,0,105,105
"89099",2017,0,0,27,27
"89099",2018,0,0,6,6
"89099",2019,0,0,15,15
"89099",2020,0,0,49,49
"89100",2014,0,0,147,147
"89100",2017,0,0,102,102
"89100",2018,0,0,119,119
"89100",2019,0,0,96,96
"89100",2020,0,0,76,76
"89101",2014,0,0,147,147
"89101",2015,0,0,26,26
"89101",2016,0,0,105,105
"89101",2017,0,0,27,27
"89101",2018,0,0,6,6
"89101",2019,0,0,29,29
"89101",2020,0,0,49,49
"89102",2014,0,0,147,147
"89102",2017,0,0,102,102
"89102",2018,0,0,75,75
"89102",2019,0,0,30,30
"89102",2020,0,0,76,76
"89104",2014,0,0,147,147
"89104",2017,0,0,27,27
"89104",2019,0,0,15,15
"89104",2020,0,0,31,31
"89105",2014,0,0,147,147
"89105",2015,0,0,29,29
"89105",2016,0,0,105,105
"89105",2017,0,0,27,27
"89105",2019,0,0,15,15
"89105",2020,0,0,31,31
"89108",2014,0,0,147,147
"89108",2017,0,0,102,102
"89108",2018,0,0,75,75
"89108",2019,0,0,30,30
"89108",2020,0,0,76,76
"89111",2014,0,0,147,147
"89111",2015,0,0,29,29
"89111",2017,0,0,27,27
"89111",2018,0,0,75,75
"89111",2019,0,0,15,15
"89111",2020,0,0,49,49
"89112",2014,0,0,147,147
"89112",2017,0,0,27,27
"89112",2019,0,0,15,15
"89112",2020,0,0,31,31
"89113",2014,0,0,147,147
"89113",2017,0,0,102,102
"89113",2018,0,0,27,27
"89113",2019,0,0,44,44
"89113",2020,0,0,76,76
"89115",2014,0,0,147,147
"89115",2017,0,0,102,102
"89115",2018,0,0,27,27
"89115",2019,0,0,44,44
"89115",2020,0,0,76,76
"89116",2014,0,0,147,147
"89116",2017,0,0,102,102
"89116",2018,0,0,27,27
"89116",2019,0,0,44,44
"89116",2020,0,0,76,76
"89117",2014,0,0,147,147
"89117",2015,0,0,43,43
"89117",2017,0,0,102,102
"89117",2018,0,0,75,75
"89117",2019,0,0,15,15
"89117",2020,0,0,31,31
"89118",2014,0,0,147,147
"89118",2017,0,0,102,102
"89118",2018,0,0,75,75
"89118",2019,0,0,30,30
"89118",2020,0,0,76,76
"89119",2014,0,0,147,147
"89119",2017,0,0,102,102
"89119",2018,0,0,75,75
"89119",2019,0,0,30,30
"89119",2020,0,0,76,76
"89120",2014,0,0,147,147
"89120",2015,0,0,29,29
"89120",2017,0,0,27,27
"89120",2018,0,0,75,75
"89120",2019,0,0,15,15
"89120",2020,0,0,49,49
"89122",2014,0,0,147,147
"89122",2015,0,0,29,29
"89122",2017,0,0,27,27
"89122",2018,0,0,75,75
"89122",2019,0,0,15,15
"89122",2020,0,0,49,49
"89123",2014,0,0,147,147
"89123",2017,0,0,27,27
"89123",2019,0,0,15,15
"89123",2020,0,0,31,31
"89124",2014,0,0,147,147
"89124",2017,0,0,102,102
"89124",2018,0,0,27,27
"89124",2019,0,0,44,44
"89124",2020,0,0,76,76
"89125",2014,0,0,147,147
"89125",2017,0,0,102,102
"89125",2018,0,0,75,75
"89125",2019,0,0,30,30
"89125",2020,0,0,76,76
"89126",2014,0,0,147,147
"89126",2017,0,0,102,102
"89126",2018,0,0,119,119
"89126",2019,0,0,96,96
"89126",2020,0,0,76,76
"89127",2014,0,0,147,147
"89127",2017,0,0,102,102
"89127",2018,0,0,27,27
"89127",2019,0,0,44,44
"89127",2020,0,0,76,76
"89128",2014,0,0,147,147
"89128",2017,0,0,27,27
"89128",2019,0,0,15,15
"89128",2020,0,0,31,31
"89129",2014,0,0,147,147
"89129",2017,0,0,102,102
"89129",2018,0,0,75,75
"89129",2019,0,0,30,30
"89129",2020,0,0,76,76
"89130",2014,0,0,147,147
"89130",2017,0,0,27,27
"89130",2019,0,0,15,15
"89130",2020,0,0,31,31
"89131",2014,0,0,147,147
"89131",2017,0,0,27,27
"89131",2018,0,0,27,27
"89131",2019,0,0,15,15
"89131",2020,0,0,31,31
"89132",2014,0,0,147,147
"89132",2017,0,0,27,27
"89132",2018,0,0,27,27
"89132",2019,0,0,15,15
"89132",2020,0,0,31,31
"89133",2014,0,0,147,147
"89133",2015,0,0,29,29
"89133",2016,0,0,105,105
"89133",2017,0,0,27,27
"89133",2019,0,0,15,15
"89133",2020,0,0,31,31
"89134",2014,0,0,147,147
"89134",2016,0,0,105,105
"89134",2017,0,0,27,27
"89134",2019,0,0,15,15
"89134",2020,0,0,31,31
"89136",2014,0,0,147,147
"89136",2017,0,0,102,102
"89136",2018,0,0,27,27
"89136",2019,0,0,44,44
"89136",2020,0,0,76,76
"89137",2014,0,0,147,147
"89137",2017,0,0,27,27
"89137",2018,0,0,27,27
"89137",2019,0,0,15,15
"89137",2020,0,0,31,31
"89139",2014,0,0,147,147
"89139",2015,0,0,29,29
"89139",2016,0,0,105,105
"89139",2017,0,0,27,27
"89139",2019,0,0,15,15
"89139",2020,0,0,31,31
"89141",2014,0,0,147,147
"89141",2017,0,0,27,27
"89141",2019,0,0,15,15
"89141",2020,0,0,31,31
"89142",2014,0,0,147,147
"89142",2015,0,0,29,29
"89142",2017,0,0,27,27
"89142",2018,0,0,27,27
"89142",2019,0,0,15,15
"89142",2020,0,0,49,49
"89143",2014,0,0,147,147
"89143",2017,0,0,102,102
"89143",2018,0,0,119,119
"89143",2019,0,0,96,96
"89143",2020,0,0,76,76
"89144",2014,0,0,147,147
"89144",2017,0,0,102,102
"89144",2018,0,0,119,119
"89144",2019,0,0,96,96
"89144",2020,0,0,76,76
"89145",2014,0,0,147,147
"89145",2016,0,0,105,105
"89145",2017,0,0,27,27
"89145",2019,0,0,15,15
"89145",2020,0,0,31,31
"89146",2014,0,0,147,147
"89146",2016,0,0,105,105
"89146",2017,0,0,27,27
"89146",2019,0,0,15,15
"89146",2020,0,0,31,31
"89147",2014,0,0,147,147
"89147",2015,0,0,43,43
"89147",2017,0,0,102,102
"89147",2018,0,0,75,75
"89147",2019,0,0,29,29
"89147",2020,0,0,31,31
"89148",2014,0,0,147,147
"89148",2017,0,0,102,102
"89148",2018,0,0,75,75
"89148",2019,0,0,30,30
"89148",2020,0,0,76,76
"89149",2014,0,0,147,147
"89149",2016,0,0,105,105
"89149",2017,0,0,27,27
"89149",2019,0,0,15,15
"89149",2020,0,0,31,31
"89150",2014,0,0,147,147
"89150",2015,0,0,29,29
"89150",2016,0,0,105,105
"89150",2017,0,0,27,27
"89150",2019,0,0,15,15
"89150",2020,0,0,31,31
"89151",2014,0,0,147,147
"89151",2017,0,0,102,102
"89151",2018,0,0,27,27
"89151",2019,0,0,44,44
"89151",2020,0,0,76,76
"89152",2014,0,0,147,147
"89152",2015,0,0,29,29
"89152",2016,0,0,105,105
"89152",2017,0,0,27,27
"89152",2019,0,0,15,15
"89152",2020,0,0,31,31
"89153",2014,0,0,147,147
"89153",2017,0,0,27,27
"89153",2018,0,0,27,27
"89153",2019,0,0,15,15
"89153",2020,0,0,31,31
"89154",2014,0,0,147,147
"89154",2017,0,0,102,102
"89154",2018,0,0,75,75
"89154",2019,0,0,30,30
"89154",2020,0,0,76,76
"89155",2014,0,0,147,147
"89155",2017,0,0,102,102
"89155",2018,0,0,75,75
"89155",2019,0,0,30,30
"89155",2020,0,0,76,76
"89156",2014,0,0,147,147
"89156",2015,0,0,26,26
"89156",2016,0,0,105,105
"89156",2017,0,0,27,27
"89156",2018,0,0,6,6
"89156",2019,0,0,29,29
"89156",2020,0,0,49,49
"89158",2014,0,0,147,147
"89158",2015,0,0,43,43
"89158",2017,0,0,102,102
"89158",2018,0,0,75,75
"89158",2019,0,0,15,15
"89158",2020,0,0,31,31
"89159",2014,0,0,147,147
"89159",2016,0,0,105,105
"89159",2017,0,0,27,27
"89159",2019,0,0,15,15
"89159",2020,0,0,31,31
"89160",2014,0,0,147,147
"89160",2015,0,0,29,29
"89160",2017,0,0,27,27
"89160",2018,0,0,27,27
"89160",2019,0,0,15,15
"89160",2020,0,0,49,49
"89161",2014,0,0,147,147
"89161",2017,0,0,27,27
"89161",2019,0,0,15,15
"89161",2020,0,0,31,31
"89162",2014,0,0,147,147
"89162",2017,0,0,102,102
"89162",2018,0,0,119,119
"89162",2019,0,0,96,96
"89162",2020,0,0,76,76
"89163",2014,0,0,147,147
"89163",2015,0,0,29,29
"89163",2016,0,0,105,105
"89163",2017,0,0,27,27
"89163",2019,0,0,15,15
"89163",2020,0,0,31,31
"89164",2014,0,0,147,147
"89164",2017,0,0,102,102
"89164",2018,0,0,75,75
"89164",2019,0,0,30,30
"89164",2020,0,0,76,76
"89165",2014,0,0,147,147
"89165",2015,0,0,29,29
"89165",2017,0,0,27,27
"89165",2018,0,0,75,75
"89165",2019,0,0,15,15
"89165",2020,0,0,49,49
"89167",2014,0,0,147,147
"89167",2015,0,0,29,29
"89167",2016,0,0,105,105
"89167",2017,0,0,27,27
"89167",2019,0,0,15,15
"89167",2020,0,0,31,31
"89168",2014,0,0,147,147
"89168",2017,0,0,27,27
"89168",2019,0,0,15,15
"89168",2020,0,0,31,31
"89169",2014,0,0,147,147
"89169",2016,0,0,105,105
"89169",2017,0,0,27,27
"89169",2018,0,0,6,6
"89169",2019,0,0,15,15
"89169",2020,0,0,31,31
"89170",2014,0,0,147,147
"89170",2015,0,0,5,5
"89170",2017,0,0,27,27
"89170",2018,0,0,49,49
"89170",2019,0,0,15,15
"89170",2020,0,0,31,31
"89171",2014,0,0,147,147
"89171",2015,0,0,29,29
"89171",2017,0,0,27,27
"89171",2018,0,0,75,75
"89171",2019,0,0,15,15
"89171",2020,0,0,49,49
"89172",2014,0,0,147,147
"89172",2015,0,0,29,29
"89172",2017,0,0,27,27
"89172",2018,0,0,75,75
"89172",2019,0,0,15,15
"89172",2020,0,0,49,49
"89173",2014,0,0,147,147
"89173",2015,0,0,43,43
"89173",2017,0,0,102,102
"89173",2018,0,0,75,75
"89173",2019,0,0,29,29
"89173",2020,0,0,31,31
"89175",2014,0,0,147,147
"89175",2017,0,0,27,27
"89175",2019,0,0,15,15
"89175",2020,0,0,31,31
"89176",2014,0,0,147,147
"89176",2015,0,0,5,5
"89176",2017,0,0,27,27
"89176",2018,0,0,49,49
"89176",2019,0,0,15,15
"89176",2020,0,0,31,31
"89177",2014,0,0,147,147
"89177",2017,0,0,102,102
"89177",2018,0,0,75,75
"89177",2019,0,0,30,30
"89177",2020,0,0,76,76
"89179",2014,0,0,147,147
"89179",2015,0,0,43,43
"89179",2017,0,0,102,102
"89179",2018,0,0,75,75
"89179",2019,0,0,29,29
"89179",2020,0,0,31,31
"89180",2014,0,0,147,147
"89180",2017,0,0,102,102
"89180",2018,0,0,27,27
"89180",2019,0,0,44,44
"89180",2020,0,0,76,76
"89181",2014,0,0,147,147
"89181",2015,0,0,29,29
"89181",2017,0,0,27,27
"89181",2018,0,0,75,75
"89181",2019,0,0,15,15
"89181",2020,0,0,49,49
"89182",2014,0,0,147,147
"89182",2017,0,0,102,102
"89182",2018,0,0,75,75
"89182",2019,0,0,30,30
"89182",2020,0,0,76,76
"89183",2014,0,0,147,147
"89183",2017,0,0,27,27
"89183",2019,0,0,15,15
"89183",2020,0,0,31,31
"89184",2014,0,0,147,147
"89184",2017,0,0,27,27
"89184",2018,0,0,27,27
"89184",2019,0,0,15,15
"89184",2020,0,0,31,31
"89186",2014,0,0,147,147
"89186",2015,0,0,26,26
"89186",2016,0,0,105,105
"89186",2017,0,0,27,27
"89186",2018,0,0,6,6
"89186",2019,0,0,29,29
"89186",2020,0,0,49,49
"89187",2014,0,0,147,147
"89187",2017,0,0,27,27
"89187",2018,0,0,55,55
"89187",2019,0,0,15,15
"89187",2020,0,0,31,31
"89188",2014,0,0,147,147
"89188",2016,0,0,105,105
"89188",2017,0,0,27,27
"89188",2019,0,0,15,15
"89188",2020,0,0,31,31
"89189",2014,0,0,147,147
"89189",2017,0,0,102,102
"89189",2018,0,0,27,27
"89189",2019,0,0,44,44
"89189",2020,0,0,76,76
"89190",2014,0,0,147,147
"89190",2016,0,0,105,105
"89190",2017,0,0,27,27
"89190",2019,0,0,15,15
"89190",2020,0,0,31,31
"89191",2014,0,0,147,147
"89191",2017,0,0,27,27
"89191",2018,0,0,27,27
"89191",2019,0,0,15,15
"89191",2020,0,0,31,31
"89194",2014,0,0,147,147
"89194",2017,0,0,27,27
"89194",2019,0,0,15,15
"89194",2020,0,0,31,31
"89195",2014,0,0,147,147
"89195",2015,0,0,29,29
"89195",2017,0,0,27,27
"89195",2018,0,0,27,27
"89195",2019,0,0,15,15
"89195",2020,0,0,49,49
"89196",2014,0,0,147,147
"89196",2015,0,0,29,29
"89196",2016,0,0,105,105
"89196",2017,0,0,27,27
"89196",2019,0,0,15,15
"89196",2020,0,0,31,31
"89197",2014,0,0,147,147
"89197",2016,0,0,105,105
"89197",2017,0,0,27,27
"89197",2019,0,0,15,15
"89197",2020,0,0,31,31
"89198",2014,0,0,147,147
"89198",2017,0,0,102,102
"89198",2018,0,0,75,75
"89198",2019,0,0,30,30
"89198",2020,0,0,76,76
"89199",2014,0,0,147,147
"89199",2017,0,0,102,102
"89199",2018,0,0,75,75
"89199",2019,0,0,30,30
"89199",2020,0,0,76,76
"89200",2014,0,0,147,147
"89200",2015,0,0,26,26
"89200",2016,0,0,105,105
"89200",2017,0,0,27,27
"89200",2018,0,0,6,6
"89200",2019,0,0,29,29
"89200",2020,0,0,49,49
"89201",2014,0,0,147,147
"89201",2016,0,0,105,105
"89201",2017,0,0,27,27
"89201",2019,0,0,15,15
"89201",2020,0,0,31,31
"89202",2014,0,0,147,147
"89202",2017,0,0,102,102
"89202",2018,0,0,75,75
"89202",2019,0,0,30,30
"89202",2020,0,0,76,76
"89203",2014,0,0,147,147
"89203",2016,0,0,105,105
"89203",2017,0,0,27,27
"89203",2019,0,0,15,15
"89203",2020,0,0,31,31
"89204",2014,0,0,147,147
"89204",2017,0,0,27,27
"89204",2019,0,0,15,15
"89204",2020,0,0,31,31
"89205",2014,0,0,147,147
"89205",2016,0,0,105,105
"89205",2017,0,0,27,27
"89205",2019,0,0,15,15
"89205",2020,0,0,31,31
"89206",2014,0,0,147,147
"89206",2015,0,0,29,29
"89206",2016,0,0,105,105
"89206",2017,0,0,27,27
"89206",2019,0,0,15,15
"89206",2020,0,0,31,31
"89207",2014,0,0,147,147
"89207",2017,0,0,27,27
"89207",2019,0,0,15,15
"89207",2020,0,0,31,31
"89208",2014,0,0,147,147
"89208",2017,0,0,27,27
"89208",2019,0,0,15,15
"89208",2020,0,0,31,31
"89209",2014,0,0,147,147
"89209",2017,0,0,102,102
"89209",2018,0,0,119,119
"89209",2019,0,0,96,96
"89209",2020,0,0,76,76
"89210",2014,0,0,147,147
"89210",2017,0,0,27,27
"89210",2018,0,0,27,27
"89210",2019,0,0,15,15
"89210",2020,0,0,31,31
"89211",2014,0,0,147,147
"89211",2017,0,0,27,27
"89211",2018,0,0,27,27
"89211",2019,0,0,15,15
"89211",2020,0,0,31,31
"89212",2014,0,0,147,147
"89212",2017,0,0,102,102
"89212",2018,0,0,75,75
"89212",2019,0,0,30,30
"89212",2020,0,0,76,76
"89214",2014,0,0,147,147
"89214",2015,0,0,29,29
"89214",2017,0,0,27,27
"89214",2018,0,0,75,75
"89214",2019,0,0,15,15
"89214",2020,0,0,49,49
"89215",2014,0,0,147,147
"89215",2015,0,0,43,43
"89215",2017,0,0,102,102
"89215",2018,0,0,75,75
"89215",2019,0,0,15,15
"89215",2020,0,0,31,31
"89216",2014,0,0,147,147
"89216",2015,0,0,43,43
"89216",2017,0,0,102,102
"89216",2018,0,0,75,75
"89216",2019,0,0,15,15
"89216",2020,0,0,31,31
"89217",2014,0,0,147,147
"89217",2015,0,0,43,43
"89217",2017,0,0,102,102
"89217",2018,0,0,75,75
"89217",2019,0,0,29,29
"89217",2020,0,0,31,31
"89218",2014,0,0,147,147
"89218",2016,0,0,105,105
"89218",2017,0,0,27,27
"89218",2019,0,0,15,15
"89218",2020,0,0,31,31
"89219",2014,0,0,147,147
"89219",2015,0,0,26,26
"89219",2016,0,0,105,105
"89219",2017,0,0,27,27
"89219",2018,0,0,6,6
"89219",2019,0,0,29,29
"89219",2020,0,0,49,49
"89220",2014,0,0,147,147
"89220",2015,0,0,43,43
"89220",2017,0,0,102,102
"89220",2018,0,0,75,75
"89220",2019,0,0,29,29
"89220",2020,0,0,31,31
"89221",2014,0,0,147,147
"89221",2015,0,0,43,43
"89221",2017,0,0,102,102
"89221",2018,0,0,75,75
"89221",2019,0,0,15,15
"89221",2020,0,0,31,31
"89222",2014,0,0,147,147
"89222",2015,0,0,43,43
"89222",2017,0,0,102,102
"89222",2018,0,0,75,75
"89222",2019,0,0,29,29
"89222",2020,0,0,31,31
"89223",2014,0,0,147,147
"89223",2017,0,0,27,27
"89223",2018,0,0,27,27
"89223",2019,0,0,15,15
"89223",2020,0,0,31,31
"89224",2014,0,0,147,147
"89224",2017,0,0,27,27
"89224",2019,0,0,15,15
"89224",2020,0,0,31,31
"89225",2014,0,0,147,147
"89225",2017,0,0,102,102
"89225",2018,0,0,75,75
"89225",2019,0,0,30,30
"89225",2020,0,0,76,76
"89226",2014,0,0,147,147
"89226",2017,0,0,27,27
"89226",2019,0,0,15,15
"89226",2020,0,0,31,31
"89227",2014,0,0,147,147
"89227",2016,0,0,105,105
"89227",2017,0,0,27,27
"89227",2019,0,0,15,15
"89227",2020,0,0,31,31
"89228",2014,0,0,147,147
"89228",2015,0,0,29,29
"89228",2016,0,0,105,105
"89228",2017,0,0,27,27
"89228",2019,0,0,15,15
"89228",2020,0,0,31,31
"89229",2014,0,0,147,147
"89229",2017,0,0,102,102
"89229",2018,0,0,27,27
"89229",2019,0,0,44,44
"89229",2020,0,0,76,76
"89230",2014,0,0,147,147
"89230",2017,0,0,102,102
"89230",2018,0,0,27,27
"89230",2019,0,0,44,44
"89230",2020,0,0,76,76
"89232",2014,0,0,147,147
"89232",2016,0,0,105,105
"89232",2017,0,0,27,27
"89232",2019,0,0,15,15
"89232",2020,0,0,31,31
"89233",2014,0,0,147,147
"89233",2015,0,0,5,5
"89233",2017,0,0,27,27
"89233",2018,0,0,49,49
"89233",2019,0,0,15,15
"89233",2020,0,0,31,31
"89234",2014,0,0,147,147
"89234",2017,0,0,102,102
"89234",2018,0,0,75,75
"89234",2019,0,0,30,30
"89234",2020,0,0,76,76
"89235",2014,0,0,147,147
"89235",2016,0,0,105,105
"89235",2017,0,0,27,27
"89235",2019,0,0,15,15
"89235",2020,0,0,31,31
"89236",2014,0,0,147,147
"89236",2015,0,0,29,29
"89236",2017,0,0,27,27
"89236",2018,0,0,75,75
"89236",2019,0,0,15,15
"89236",2020,0,0,49,49
"89237",2014,0,0,147,147
"89237",2017,0,0,102,102
"89237",2018,0,0,75,75
"89237",2019,0,0,30,30
"89237",2020,0,0,76,76
"89238",2014,0,0,147,147
"89238",2017,0,0,102,102
"89238",2018,0,0,75,75
"89238",2019,0,0,30,30
"89238",2020,0,0,76,76
"89239",2014,0,0,147,147
"89239",2015,0,0,29,29
"89239",2017,0,0,27,27
"89239",2018,0,0,75,75
"89239",2019,0,0,15,15
"89239",2020,0,0,49,49
"89240",2014,0,0,147,147
"89240",2015,0,0,29,29
"89240",2017,0,0,27,27
"89240",2018,0,0,75,75
"89240",2019,0,0,15,15
"89240",2020,0,0,49,49
"89242",2014,0,0,147,147
"89242",2017,0,0,27,27
"89242",2019,0,0,15,15
"89242",2020,0,0,31,31
"89244",2014,0,0,147,147
"89244",2017,0,0,27,27
"89244",2019,0,0,15,15
"89244",2020,0,0,31,31
"89245",2014,0,0,147,147
"89245",2015,0,0,29,29
"89245",2017,0,0,27,27
"89245",2018,0,0,27,27
"89245",2019,0,0,15,15
"89245",2020,0,0,49,49
"89246",2014,0,0,147,147
"89246",2017,0,0,27,27
"89246",2019,0,0,15,15
"89246",2020,0,0,31,31
"89247",2014,0,0,147,147
"89247",2016,0,0,105,105
"89247",2017,0,0,27,27
"89247",2018,0,0,6,6
"89247",2019,0,0,15,15
"89247",2020,0,0,31,31
"89248",2014,0,0,147,147
"89248",2016,0,0,105,105
"89248",2017,0,0,27,27
"89248",2019,0,0,15,15
"89248",2020,0,0,31,31
"89249",2014,0,0,147,147
"89249",2015,0,0,26,26
"89249",2016,0,0,105,105
"89249",2017,0,0,27,27
"89249",2018,0,0,6,6
"89249",2019,0,0,29,29
"89249",2020,0,0,49,49
"89250",2014,0,0,147,147
"89250",2016,0,0,105,105
"89250",2017,0,0,27,27
"89250",2019,0,0,15,15
"89250",2020,0,0,31,31
"89251",2014,0,0,147,147
"89251",2015,0,0,29,29
"89251",2016,0,0,105,105
"89251",2017,0,0,27,27
"89251",2019,0,0,15,15
"89251",2020,0,0,31,31
"89252",2014,0,0,147,147
"89252",2015,0,0,43,43
"89252",2017,0,0,102,102
"89252",2018,0,0,75,75
"89252",2019,0,0,15,15
"89252",2020,0,0,31,31
"89253",2014,0,0,147,147
"89253",2017,0,0,102,102
"89253",2018,0,0,75,75
"89253",2019,0,0,30,30
"89253",2020,0,0,76,76
"89254",2014,0,0,147,147
"89254",2015,0,0,43,43
"89254",2017,0,0,102,102
"89254",2018,0,0,75,75
"89254",2019,0,0,29,29
"89254",2020,0,0,31,31
"89255",2014,0,0,147,147
"89255",2017,0,0,102,102
"89255",2018,0,0,27,27
"89255",2019,0,0,44,44
"89255",2020,0,0,76,76
"89256",2014,0,0,147,147
"89256",2017,0,0,102,102
"89256",2018,0,0,75,75
"89256",2019,0,0,30,30
"89256",2020,0,0,76,76
"89257",2014,0,0,147,147
"89257",2016,0,0,105,105
"89257",2017,0,0,27,27
"89257",2019,0,0,15,15
"89257",2020,0,0,31,31
"89259",2014,0,0,147,147
"89259",2017,0,0,27,27
"89259",2019,0,0,15,15
"89259",2020,0,0,31,31
"89261",2014,0,0,147,147
"89261",2015,0,0,29,29
"89261",2017,0,0,27,27
"89261",2018,0,0,75,75
"89261",2019,0,0,15,15
"89261",2020,0,0,49,49
"89262",2014,0,0,147,147
"89262",2016,0,0,105,105
"89262",2017,0,0,27,27
"89262",2018,0,0,6,6
"89262",2019,0,0,15,15
"89262",2020,0,0,31,31
"89263",2014,0,0,147,147
"89263",2017,0,0,102,102
"89263",2018,0,0,75,75
"89263",2019,0,0,30,30
"89263",2020,0,0,76,76
"89264",2014,0,0,147,147
"89264",2017,0,0,102,102
"89264",2018,0,0,119,119
"89264",2019,0,0,96,96
"89264",2020,0,0,76,76
"89265",2014,0,0,147,147
"89265",2017,0,0,27,27
"89265",2019,0,0,15,15
"89265",2020,0,0,31,31
"89266",2014,0,0,147,147
"89266",2015,0,0,5,5
"89266",2017,0,0,27,27
"89266",2018,0,0,49,49
"89266",2019,0,0,15,15
"89266",2020,0,0,31,31
"89267",2014,0,0,147,147
"89267",2017,0,0,27,27
"89267",2019,0,0,15,15
"89267",2020,0,0,31,31
"89268",2014,0,0,147,147
"89268",2015,0,0,26,26
"89268",2016,0,0,105,105
"89268",2017,0,0,27,27
"89268",2018,0,0,6,6
"89268",2019,0,0,29,29
"89268",2020,0,0,49,49
"89270",2014,0,0,147,147
"89270",2017,0,0,102,102
"89270",2018,0,0,75,75
"89270",2019,0,0,30,30
"89270",2020,0,0,76,76
"89271",2014,0,0,147,147
"89271",2017,0,0,27,27
"89271",2019,0,0,15,15
"89271",2020,0,0,31,31
"89272",2014,0,0,147,147
"89272",2015,0,0,43,43
"89272",2017,0,0,102,102
"89272",2018,0,0,75,75
"89272",2019,0,0,29,29
"89272",2020,0,0,31,31
"89273",2014,0,0,147,147
"89273",2015,0,0,43,43
"89273",2017,0,0,102,102
"89273",2018,0,0,75,75
"89273",2019,0,0,29,29
"89273",2020,0,0,31,31
"89274",2014,0,0,147,147
"89274",2017,0,0,102,102
"89274",2018,0,0,27,27
"89274",2019,0,0,44,44
"89274",2020,0,0,76,76
"89276",2014,0,0,147,147
"89276",2015,0,0,26,26
"89276",2016,0,0,105,105
"89276",2017,0,0,27,27
"89276",2018,0,0,6,6
"89276",2019,0,0,29,29
"89276",2020,0,0,49,49
"89277",2014,0,0,147,147
"89277",2017,0,0,27,27
"89277",2019,0,0,15,15
"89277",2020,0,0,31,31
"89278",2014,0,0,147,147
"89278",2015,0,0,29,29
"89278",2017,0,0,27,27
"89278",2018,0,0,75,75
"89278",2019,0,0,15,15
"89278",2020,0,0,49,49
"89279",2014,0,0,147,147
"89279",2017,0,0,27,27
"89279",2019,0,0,15,15
"89279",2020,0,0,31,31
"89280",2014,0,0,147,147
"89280",2017,0,0,27,27
"89280",2018,0,0,27,27
"89280",2019,0,0,15,15
"89280",2020,0,0,31,31
"89281",2014,0,0,147,147
"89281",2015,0,0,29,29
"89281",2016,0,0,105,105
"89281",2017,0,0,27,27
"89281",2019,0,0,15,15
"89281",2020,0,0,31,31
"89282",2014,0,0,147,147
"89282",2015,0,0,26,26
"89282",2016,0,0,105,105
"89282",2017,0,0,27,27
"89282",2018,0,0,6,6
"89282",2019,0,0,29,29
"89282",2020,0,0,49,49
"89283",2014,0,0,147,147
"89283",2015,0,0,43,43
"89283",2017,0,0,102,102
"89283",2018,0,0,75,75
"89283",2019,0,0,15,15
"89283",2020,0,0,31,31
"89284",2014,0,0,147,147
"89284",2017,0,0,27,27
"89284",2019,0,0,15,15
"89284",2020,0,0,31,31
"89285",2014,0,0,147,147
"89285",2017,0,0,102,102
"89285",2018,0,0,27,27
"89285",2019,0,0,44,44
"89285",2020,0,0,76,76
"89286",2014,0,0,147,147
"89286",2015,0,0,29,29
"89286",2016,0,0,105,105
"89286",2017,0,0,27,27
"89286",2019,0,0,15,15
"89286",2020,0,0,31,31
"89287",2014,0,0,147,147
"89287",2015,0,0,29,29
"89287",2017,0,0,27,27
"89287",2018,0,0,27,27
"89287",2019,0,0,15,15
"89287",2020,0,0,49,49
"89288",2014,0,0,147,147
"89288",2015,0,0,26,26
"89288",2016,0,0,105,105
"89288",2017,0,0,27,27
"89288",2018,0,0,6,6
"89288",2019,0,0,29,29
"89288",2020,0,0,49,49
"89289",2014,0,0,147,147
"89289",2015,0,0,29,29
"89289",2016,0,0,105,105
"89289",2017,0,0,27,27
"89289",2019,0,0,15,15
"89289",2020,0,0,31,31
"89290",2014,0,0,147,147
"89290",2017,0,0,27,27
"89290",2019,0,0,15,15
"89290",2020,0,0,31,31
"89291",2014,0,0,147,147
"89291",2015,0,0,29,29
"89291",2017,0,0,27,27
"89291",2018,0,0,27,27
"89291",2019,0,0,15,15
"89291",2020,0,0,49,49
"89292",2014,0,0,147,147
"89292",2015,0,0,26,26
"89292",2016,0,0,105,105
"89292",2017,0,0,27,27
"89292",2018,0,0,6,6
"89292",2019,0,0,29,29
"89292",2020,0,0,49,49
"89295",2014,0,0,147,147
"89295",2017,0,0,102,102
"89295",2018,0,0,75,75
"89295",2019,0,0,30,30
"89295",2020,0,0,76,76
"89296",2014,0,0,147,147
"89296",2017,0,0,27,27
"89296",2018,0,0,27,27
"89296",2019,0,0,15,15
"89296",2020,0,0,31,31
"89297",2014,0,0,147,147
"89297",2015,0,0,5,5
"89297",2017,0,0,27,27
"89297",2018,0,0,49,49
"89297",2019,0,0,15,15
"89297",2020,0,0,31,31
"89298",2014,0,0,147,147
"89298",2015,0,0,29,29
"89298",2016,0,0,105,105
"89298",2017,0,0,27,27
"89298",2019,0,0,15,15
"89298",2020,0,0,31,31
"89299",2014,0,0,147,147
"89299",2017,0,0,27,27
"89299",2018,0,0,27,27
"89299",2019,0,0,15,15
"89299",2020,0,0,31,31
"89300",2014,0,0,147,147
"89300",2017,0,0,27,27
"89300",2019,0,0,15,15
"89300",2020,0,0,31,31
"89302",2014,0,0,147,147
"89302",2017,0,0,102,102
"89302",2018,0,0,27,27
"89302",2019,0,0,44,44
"89302",2020,0,0,76,76
"89303",2014,0,0,147,147
"89303",2017,0,0,27,27
"89303",2019,0,0,15,15
"89303",2020,0,0,31,31
"89304",2014,0,0,147,147
"89304",2015,0,0,29,29
"89304",2016,0,0,105,105
"89304",2017,0,0,27,27
"89304",2019,0,0,15,15
"89304",2020,0,0,31,31
"89306",2014,0,0,147,147
"89306",2016,0,0,105,105
"89306",2017,0,0,27,27
"89306",2019,0,0,15,15
"89306",2020,0,0,31,31
"89307",2014,0,0,147,147
"89307",2016,0,0,105,105
"89307",2017,0,0,27,27
"89307",2019,0,0,15,15
"89307",2020,0,0,31,31
"89308",2014,0,0,147,147
"89308",2015,0,0,29,29
"89308",2017,0,0,27,27
"89308",2018,0,0,75,75
"89308",2019,0,0,15,15
"89308",2020,0,0,49,49
"89309",2014,0,0,147,147
"89309",2017,0,0,102,102
"89309",2018,0,0,27,27
"89309",2019,0,0,44,44
"89309",2020,0,0,76,76
"89310",2014,0,0,147,147
"89310",2015,0,0,29,29
"89310",2017,0,0,27,27
"89310",2018,0,0,75,75
"89310",2019,0,0,15,15
"89310",2020,0,0,49,49
"89311",2014,0,0,147,147
"89311",2015,0,0,29,29
"89311",2016,0,0,105,105
"89311",2017,0,0,27,27
"89311",2019,0,0,15,15
"89311",2020,0,0,31,31
"89312",2014,0,0,147,147
"89312",2015,0,0,5,5
"89312",2017,0,0,27,27
"89312",2018,0,0,49,49
"89312",2019,0,0,15,15
"89312",2020,0,0,31,31
"89313",2014,0,0,147,147
"89313",2015,0,0,29,29
"89313",2016,0,0,105,105
"89313",2017,0,0,27,27
"89313",2019,0,0,15,15
"89313",2020,0,0,31,31
"89314",2014,0,0,147,147
"89314",2015,0,0,5,5
"89314",2017,0,0,27,27
"89314",2018,0,0,49,49
"89314",2019,0,0,15,15
"89314",2020,0,0,31,31
"89315",2014,0,0,147,147
"89315",2017,0,0,27,27
"89315",2019,0,0,15,15
"89315",2020,0,0,31,31
"89316",2014,0,0,147,147
"89316",2017,0,0,27,27
"89316",2019,0,0,15,15
"89316",2020,0,0,31,31
"89318",2014,0,0,147,147
"89318",2016,0,0,105,105
"89318",2017,0,0,27,27
"89318",2019,0,0,15,15
"89318",2020,0,0,31,31
"89319",2014,0,0,147,147
"89319",2017,0,0,102,102
"89319",2018,0,0,75,75
"89319",2019,0,0,30,30
"89319",2020,0,0,76,76
"89320",2014,0,0,147,147
"89320",2015,0,0,12,12
"89320",2016,0,0,105,105
"89320",2017,0,0,27,27
"89320",2018,0,0,6,6
"89320",2019,0,0,15,15
"89320",2020,0,0,31,31
"89321",2014,0,0,147,147
"89321",2017,0,0,27,27
"89321",2018,0,0,27,27
"89321",2019,0,0,15,15
"89321",2020,0,0,31,31
"89323",2014,0,0,147,147
"89323",2017,0,0,27,27
"89323",2018,0,0,27,27
"89323",2019,0,0,15,15
"89323",2020,0,0,31,31
"89324",2014,0,0,147,147
"89324",2015,0,0,43,43
"89324",2017,0,0,102,102
"89324",2018,0,0,75,75
"89324",2019,0,0,29,29
"89324",2020,0,0,31,31
"89325",2014,0,0,147,147
"89325",2015,0,0,43,43
"89325",2017,0,0,102,102
"89325",2018,0,0,75,75
"89325",2019,0,0,29,29
"89325",2020,0,0,31,31
"89326",2014,0,0,147,147
"89326",2015,0,0,29,29
"89326",2017,0,0,27,27
"89326",2018,0,0,27,27
"89326",2019,0,0,15,15
"89326",2020,0,0,49,49
"89327",2014,0,0,147,147
"89327",2015,0,0,29,29
"89327",2016,0,0,105,105
"89327",2017,0,0,27,27
"89327",2019,0,0,15,15
"89327",2020,0,0,31,31
"89328",2014,0,0,147,147
"89328",2016,0,0,105,105
"89328",2017,0,0,27,27
"89328",2019,0,0,15,15
"89328",2020,0,0,31,31
"89329",2014,0,0,147,147
"89329",2016,0,0,105,105
"89329",2017,0,0,27,27
"89329",2018,0,0,6,6
"89329",2019,0,0,15,15
"89329",2020,0,0,31,31
"89331",2014,0,0,147,147
"89331",2015,0,0,43,43
"89331",2017,0,0,27,27
"89331",2018,0,0,75,75
"89331",2019,0,0,29,29
"89331",2020,0,0,31,31
"89332",2014,0,0,147,147
"89332",2017,0,0,102,102
"89332",2018,0,0,27,27
"89332",2019,0,0,44,44
"89332",2020,0,0,76,76
"89333",2014,0,0,147,147
"89333",2016,0,0,105,105
"89333",2017,0,0,27,27
"89333",2019,0,0,15,15
"89333",2020,0,0,31,31
"89334",2014,0,0,147,147
"89334",2015,0,0,29,29
"89334",2016,0,0,105,105
"89334",2017,0,0,27,27
"89334",2019,0,0,15,15
"89334",2020,0,0,31,31
"89335",2014,0,0,147,147
"89335",2015,0,0,29,29
"89335",2016,0,0,105,105
"89335",2017,0,0,27,27
"89335",2019,0,0,15,15
"89335",2020,0,0,31,31
"89336",2014,0,0,147,147
"89336",2016,0,0,105,105
"89336",2017,0,0,27,27
"89336",2019,0,0,15,15
"89336",2020,0,0,31,31
"89337",2014,0,0,147,147
"89337",2017,0,0,102,102
"89337",2018,0,0,75,75
"89337",2019,0,0,30,30
"89337",2020,0,0,76,76
"89338",2014,0,0,147,147
"89338",2017,0,0,102,102
"89338",2018,0,0,119,119
"89338",2019,0,0,96,96
"89338",2020,0,0,76,76
"89339",2014,0,0,147,147
"89339",2017,0,0,27,27
"89339",2019,0,0,15,15
"89339",2020,0,0,31,31
"89341",2014,0,0,147,147
"89341",2017,0,0,27,27
"89341",2019,0,0,15,15
"89341",2020,0,0,31,31
"89342",2014,0,0,147,147
"89342",2017,0,0,102,102
"89342",2018,0,0,27,27
"89342",2019,0,0,44,44
"89342",2020,0,0,76,76
"89344",2014,0,0,147,147
"89344",2015,0,0,43,43
"89344",2017,0,0,102,102
"89344",2018,0,0,75,75
"89344",2019,0,0,29,29
"89344",2020,0,0,31,31
"89345",2014,0,0,147,147
"89345",2015,0,0,26,26
"89345",2016,0,0,105,105
"89345",2017,0,0,27,27
"89345",2018,0,0,6,6
"89345",2019,0,0,29,29
"89345",2020,0,0,49,49
"89346",2014,0,0,147,147
"89346",2017,0,0,102,102
"89346",2018,0,0,75,75
"89346",2019,0,0,30,30
"89346",2020,0,0,76,76
"89347",2014,0,0,147,147
"89347",2016,0,0,105,105
"89347",2017,0,0,27,27
"89347",2019,0,0,15,15
"89347",2020,0,0,31,31
"89348",2014,0,0,147,147
"89348",2015,0,0,29,29
"89348",2016,0,0,105,105
"89348",2017,0,0,27,27
"89348",2019,0,0,15,15
"89348",2020,0,0,31,31
"89349",2014,0,0,147,147
"89349",2016,0,0,105,105
"89349",2017,0,0,27,27
"89349",2019,0,0,15,15
"89349",2020,0,0,31,31
"89350",2014,0,0,147,147
"89350",2015,0,0,29,29
"89350",2016,0,0,105,105
"89350",2017,0,0,27,27
"89350",2019,0,0,15,15
"89350",2020,0,0,31,31
"89351",2014,0,0,147,147
"89351",2016,0,0,105,105
"89351",2017,0,0,27,27
"89351",2019,0,0,15,15
"89351",2020,0,0,31,31
"89352",2014,0,0,147,147
"89352",2015,0,0,43,43
"89352",2017,0,0,102,102
"89352",2018,0,0,75,75
"89352",2019,0,0,29,29
"89352",2020,0,0,31,31
"89353",2014,0,0,147,147
"89353",2015,0,0,29,29
"89353",2016,0,0,105,105
"89353",2017,0,0,27,27
"89353",2019,0,0,15,15
"89353",2020,0,0,31,31
"89354",2014,0,0,147,147
"89354",2017,0,0,102,102
"89354",2018,0,0,27,27
"89354",2019,0,0,44,44
"89354",2020,0,0,76,76
"89355",2014,0,0,147,147
"89355",2017,0,0,27,27
"89355",2018,0,0,27,27
"89355",2019,0,0,15,15
"89355",2020,0,0,31,31
"89359",2014,0,0,147,147
"89359",2015,0,0,29,29
"89359",2017,0,0,27,27
"89359",2018,0,0,75,75
"89359",2019,0,0,15,15
"89359",2020,0,0,49,49
"89360",2014,0,0,147,147
"89360",2015,0,0,29,29
"89360",2016,0,0,105,105
"89360",2017,0,0,27,27
"89360",2019,0,0,15,15
"89360",2020,0,0,31,31
"89361",2014,0,0,147,147
"89361",2015,0,0,29,29
"89361",2016,0,0,105,105
"89361",2017,0,0,27,27
"89361",2019,0,0,15,15
"89361",2020,0,0,31,31
"89362",2014,0,0,147,147
"89362",2015,0,0,5,5
"89362",2017,0,0,27,27
"89362",2018,0,0,49,49
"89362",2019,0,0,15,15
"89362",2020,0,0,31,31
"89363",2014,0,0,147,147
"89363",2015,0,0,5,5
"89363",2017,0,0,27,27
"89363",2018,0,0,49,49
"89363",2019,0,0,15,15
"89363",2020,0,0,31,31
"89364",2014,0,0,147,147
"89364",2016,0,0,105,105
"89364",2017,0,0,27,27
"89364",2019,0,0,15,15
"89364",2020,0,0,31,31
"89365",2014,0,0,147,147
"89365",2015,0,0,43,43
"89365",2017,0,0,102,102
"89365",2018,0,0,75,75
"89365",2019,0,0,29,29
"89365",2020,0,0,31,31
"89367",2014,0,0,147,147
"89367",2015,0,0,43,43
"89367",2017,0,0,102,102
"89367",2018,0,0,75,75
"89367",2019,0,0,15,15
"89367",2020,0,0,31,31
"89368",2014,0,0,147,147
"89368",2015,0,0,43,43
"89368",2017,0,0,102,102
"89368",2018,0,0,75,75
"89368",2019,0,0,29,29
"89368",2020,0,0,31,31
"89369",2014,0,0,147,147
"89369",2017,0,0,102,102
"89369",2018,0,0,27,27
"89369",2019,0,0,44,44
"89369",2020,0,0,76,76
"89370",2014,0,0,147,147
"89370",2017,0,0,102,102
"89370",2018,0,0,119,119
"89370",2019,0,0,96,96
"89370",2020,0,0,76,76
"89371",2014,0,0,147,147
"89371",2017,0,0,27,27
"89371",2019,0,0,15,15
"89371",2020,0,0,31,31
"89373",2014,0,0,147,147
"89373",2015,0,0,29,29
"89373",2017,0,0,27,27
"89373",2018,0,0,75,75
"89373",2019,0,0,15,15
"89373",2020,0,0,49,49
"89374",2014,0,0,147,147
"89374",2017,0,0,27,27
"89374",2019,0,0,15,15
"89374",2020,0,0,31,31
"89375",2014,0,0,147,147
"89375",2017,0,0,27,27
"89375",2019,0,0,15,15
"89375",2020,0,0,31,31
"89376",2014,0,0,147,147
"89376",2017,0,0,27,27
"89376",2019,0,0,15,15
"89376",2020,0,0,31,31
"89377",2014,0,0,147,147
"89377",2017,0,0,27,27
"89377",2019,0,0,15,15
"89377",2020,0,0,31,31
"89378",2014,0,0,147,147
"89378",2016,0,0,105,105
"89378",2017,0,0,27,27
"89378",2019,0,0,15,15
"89378",2020,0,0,31,31
"89379",2014,0,0,147,147
"89379",2017,0,0,27,27
"89379",2019,0,0,15,15
"89379",2020,0,0,31,31
"89380",2014,0,0,147,147
"89380",2017,0,0,102,102
"89380",2018,0,0,119,119
"89380",2019,0,0,96,96
"89380",2020,0,0,76,76
"89382",2014,0,0,147,147
"89382",2015,0,0,26,26
"89382",2016,0,0,105,105
"89382",2017,0,0,27,27
"89382",2018,0,0,6,6
"89382",2019,0,0,15,15
"89382",2020,0,0,49,49
"89383",2014,0,0,147,147
"89383",2015,0,0,43,43
"89383",2017,0,0,102,102
"89383",2018,0,0,75,75
"89383",2019,0,0,15,15
"89383",2020,0,0,31,31
"89384",2014,0,0,147,147
"89384",2015,0,0,29,29
"89384",2016,0,0,105,105
"89384",2017,0,0,27,27
"89384",2019,0,0,15,15
"89384",2020,0,0,31,31
"89385",2014,0,0,147,147
"89385",2017,0,0,27,27
"89385",2018,0,0,55,55
"89385",2019,0,0,15,15
"89385",2020,0,0,31,31
"89386",2014,0,0,147,147
"89386",2017,0,0,27,27
"89386",2018,0,0,27,27
"89386",2019,0,0,15,15
"89386",2020,0,0,31,31
"89387",2014,0,0,147,147
"89387",2015,0,0,29,29
"89387",2017,0,0,27,27
"89387",2018,0,0,27,27
"89387",2019,0,0,15,15
"89387",2020,0,0,49,49
"89388",2014,0,0,147,147
"89388",2015,0,0,29,29
"89388",2016,0,0,105,105
"89388",2017,0,0,27,27
"89388",2019,0,0,15,15
"89388",2020,0,0,31,31
"89390",2014,0,0,147,147
"89390",2017,0,0,102,102
"89390",2018,0,0,27,27
"89390",2019,0,0,44,44
"89390",2020,0,0,76,76
"89391",2014,0,0,147,147
"89391",2017,0,0,102,102
"89391",2018,0,0,27,27
"89391",2019,0,0,44,44
"89391",2020,0,0,76,76
"89392",2014,0,0,147,147
"89392",2016,0,0,105,105
"89392",2017,0,0,27,27
"89392",2019,0,0,15,15
"89392",2020,0,0,31,31
"89393",2014,0,0,147,147
"89393",2017,0,0,27,27
"89393",2018,0,0,27,27
"89393",2019,0,0,15,15
"89393",2020,0,0,31,31
"89394",2014,0,0,147,147
"89394",2017,0,0,102,102
"89394",2018,0,0,75,75
"89394",2019,0,0,30,30
"89394",2020,0,0,76,76
"89395",2014,0,0,147,147
"89395",2015,0,0,29,29
"89395",2017,0,0,27,27
"89395",2018,0,0,75,75
"89395",2019,0,0,15,15
"89395",2020,0,0,49,49
"89397",2014,0,0,147,147
"89397",2015,0,0,29,29
"89397",2016,0,0,105,105
"89397",2017,0,0,27,27
"89397",2019,0,0,15,15
"89397",2020,0,0,31,31
"89398",2014,0,0,147,147
"89398",2016,0,0,105,105
"89398",2017,0,0,27,27
"89398",2018,0,0,6,6
"89398",2019,0,0,15,15
"89398",2020,0,0,49,49
"89399",2014,0,0,147,147
"89399",2017,0,0,102,102
"89399",2018,0,0,119,119
"89399",2019,0,0,96,96
"89399",2020,0,0,76,76
"89400",2014,0,0,147,147
"89400",2017,0,0,102,102
"89400",2018,0,0,75,75
"89400",2019,0,0,30,30
"89400",2020,0,0,76,76
"89402",2014,0,0,147,147
"89402",2015,0,0,26,26
"89402",2016,0,0,105,105
"89402",2017,0,0,27,27
"89402",2018,0,0,6,6
"89402",2019,0,0,29,29
"89402",2020,0,0,49,49
"89403",2014,0,0,147,147
"89403",2017,0,0,27,27
"89403",2018,0,0,27,27
"89403",2019,0,0,15,15
"89403",2020,0,0,31,31
"89404",2014,0,0,147,147
"89404",2017,0,0,102,102
"89404",2018,0,0,27,27
"89404",2019,0,0,44,44
"89404",2020,0,0,76,76
"89405",2014,0,0,147,147
"89405",2015,0,0,43,43
"89405",2017,0,0,102,102
"89405",2018,0,0,75,75
"89405",2019,0,0,15,15
"89405",2020,0,0,31,31
"89406",2014,0,0,147,147
"89406",2017,0,0,27,27
"89406",2019,0,0,15,15
"89406",2020,0,0,31,31
"89407",2014,0,0,147,147
"89407",2017,0,0,27,27
"89407",2018,0,0,27,27
"89407",2019,0,0,15,15
"89407",2020,0,0,31,31
"89408",2014,0,0,147,147
"89408",2015,0,0,43,43
"89408",2017,0,0,102,102
"89408",2018,0,0,75,75
"89408",2019,0,0,29,29
"89408",2020,0,0,31,31
"89409",2014,0,0,147,147
"89409",2016,0,0,105,105
"89409",2017,0,0,27,27
"89409",2019,0,0,15,15
"89409",2020,0,0,31,31
"89410",2014,0,0,147,147
"89410",2016,0,0,105,105
"89410",2017,0,0,27,27
"89410",2019,0,0,15,15
"89410",2020,0,0,31,31
"89411",2014,0,0,147,147
"89411",2015,0,0,29,29
"89411",2017,0,0,27,27
"89411",2018,0,0,75,75
"89411",2019,0,0,15,15
"89411",2020,0,0,49,49
"89412",2014,0,0,147,147
"89412",2017,0,0,27,27
"89412",2019,0,0,15,15
"89412",2020,0,0,31,31
"89413",2014,0,0,147,147
"89413",2016,0,0,105,105
"89413",2017,0,0,27,27
"89413",2018,0,0,6,6
"89413",2019,0,0,15,15
"89413",2020,0,0,31,31
"89414",2014,0,0,147,147
"89414",2017,0,0,102,102
"89414",2018,0,0,27,27
"89414",2019,0,0,44,44
"89414",2020,0,0,76,76
"89415",2014,0,0,147,147
"89415",2017,0,0,27,27
"89415",2019,0,0,15,15
"89415",2020,0,0,31,31
"89416",2014,0,0,147,147
"89416",2015,0,0,43,43
"89416",2017,0,0,102,102
"89416",2018,0,0,75,75
"89416",2019,0,0,15,15
"89416",2020,0,0,31,31
"89417",2014,0,0,147,147
"89417",2017,0,0,27,27
"89417",2018,0,0,27,27
"89417",2019,0,0,15,15
"89417",2020,0,0,31,31
"89418",2014,0,0,147,147
"89418",2017,0,0,27,27
"89418",2018,0,0,27,27
"89418",2019,0,0,15,15
"89418",2020,0,0,31,31
"89419",2014,0,0,147,147
"89419",2015,0,0,29,29
"89419",2016,0,0,105,105
"89419",2017,0,0,27,27
"89419",2019,0,0,15,15
"89419",2020,0,0,31,31
"89420",2014,0,0,147,147
"89420",2015,0,0,43,43
"89420",2017,0,0,102,102
"89420",2018,0,0,75,75
"89420",2019,0,0,15,15
"89420",2020,0,0,31,31
"89422",2014,0,0,147,147
"89422",2016,0,0,105,105
"89422",2017,0,0,27,27
"89422",2018,0,0,6,6
"89422",2019,0,0,15,15
"89422",2020,0,0,31,31
"89423",2014,0,0,147,147
"89423",2017,0,0,27,27
"89423",2018,0,0,27,27
"89423",2019,0,0,15,15
"89423",2020,0,0,31,31
"89424",2014,0,0,147,147
"89424",2017,0,0,102,102
"89424",2018,0,0,75,75
"89424",2019,0,0,30,30
"89424",2020,0,0,76,76
"89425",2014,0,0,147,147
"89425",2016,0,0,105,105
"89425",2017,0,0,27,27
"89425",2018,0,0,6,6
"89425",2019,0,0,15,15
"89425",2020,0,0,49,49
"89426",2014,0,0,147,147
"89426",2017,0,0,102,102
"89426",2018,0,0,75,75
"89426",2019,0,0,30,30
"89426",2020,0,0,76,76
"89427",2014,0,0,147,147
"89427",2017,0,0,102,102
"89427",2018,0,0,75,75
"89427",2019,0,0,30,30
"89427",2020,0,0,76,76
"89428",2014,0,0,147,147
"89428",2017,0,0,102,102
"89428",2018,0,0,119,119
"89428",2019,0,0,96,96
"89428",2020,0,0,76,76
"89430",2014,0,0,147,147
"89430",2016,0,0,105,105
"89430",2017,0,0,27,27
"89430",2019,0,0,15,15
"89430",2020,0,0,31,31
"89431",2014,0,0,147,147
"89431",2017,0,0,27,27
"89431",2019,0,0,15,15
"89431",2020,0,0,31,31
"89432",2014,0,0,147,147
"89432",2015,0,0,29,29
"89432",2017,0,0,27,27
"89432",2018,0,0,75,75
"89432",2019,0,0,15,15
"89432",2020,0,0,49,49
"89433",2014,0,0,147,147
"89433",2016,0,0,105,105
"89433",2017,0,0,27,27
"89433",2019,0,0,15,15
"89433",2020,0,0,31,31
"89434",2014,0,0,147,147
"89434",2015,0,0,29,29
"89434",2017,0,0,27,27
"89434",2018,0,0,75,75
"89434",2019,0,0,15,15
"89434",2020,0,0,49,49
"89436",2014,0,0,147,147
"89436",2016,0,0,105,105
"89436",2017,0,0,27,27
"89436",2018,0,0,6,6
"89436",2019,0,0,15,15
"89436",2020,0,0,49,49
"89437",2014,0,0,147,147
"89437",2017,0,0,27,27
"89437",2019,0,0,15,15
"89437",2020,0,0,31,31
"89438",2014,0,0,147,147
"89438",2017,0,0,27,27
"89438",2019,0,0,15,15
"89438",2020,0,0,31,31
"89439",2014,0,0,147,147
"89439",2016,0,0,105,105
"89439",2017,0,0,27,27
"89439",2019,0,0,15,15
"89439",2020,0,0,31,31
"89440",2014,0,0,147,147
"89440",2015,0,0,29,29
"89440",2016,0,0,105,105
"89440",2017,0,0,27,27
"89440",2019,0,0,15,15
"89440",2020,0,0,31,31
"89441",2014,0,0,147,147
"89441",2017,0,0,27,27
"89441",2019,0,0,15,15
"89441",2020,0,0,31,31
"89442",2014,0,0,147,147
"89442",2017,0,0,102,102
"89442",2018,0,0,27,27
"89442",2019,0,0,44,44
"89442",2020,0,0,76,76
"89443",2014,0,0,147,147
"89443",2015,0,0,29,29
"89443",2017,0,0,27,27
"89443",2018,0,0,27,27
"89443",2019,0,0,15,15
"89443",2020,0,0,49,49
"89445",2014,0,0,147,147
"89445",2017,0,0,27,27
"89445",2019,0,0,15,15
"89445",2020,0,0,31,31
"89446",2014,0,0,147,147
"89446",2015,0,0,5,5
"89446",2017,0,0,27,27
"89446",2018,0,0,49,49
"89446",2019,0,0,15,15
"89446",2020,0,0,31,31
"89447",2014,0,0,147,147
"89447",2017,0,0,27,27
"89447",2018,0,0,27,27
"89447",2019,0,0,15,15
"89447",2020,0,0,31,31
"89449",2014,0,0,147,147
"89449",2017,0,0,102,102
"89449",2018,0,0,27,27
"89449",2019,0,0,44,44
"89449",2020,0,0,76,76
"89450",2014,0,0,147,147
"89450",2017,0,0,102,102
"89450",2018,0,0,27,27
"89450",2019,0,0,44,44
"89450",2020,0,0,76,76
"89451",2014,0,0,147,147
"89451",2015,0,0,29,29
"89451",2017,0,0,27,27
"89451",2018,0,0,75,75
"89451",2019,0,0,15,15
"89451",2020,0,0,49,49
"89452",2014,0,0,147,147
"89452",2015,0,0,29,29
"89452",2016,0,0,105,105
"89452",2017,0,0,27,27
"89452",2019,0,0,15,15
"89452",2020,0,0,31,31
"89453",2014,0,0,147,147
"89453",2017,0,0,102,102
"89453",2018,0,0,75,75
"89453",2019,0,0,30,30
"89453",2020,0,0,76,76
"89456",2014,0,0,147,147
"89456",2017,0,0,102,102
"89456",2018,0,0,27,27
"89456",2019,0,0,44,44
"89456",2020,0,0,76,76
"89458",2014,0,0,147,147
"89458",2017,0,0,102,102
"89458",2018,0,0,27,27
"89458",2019,0,0,44,44
"89458",2020,0,0,76,76
"89459",2014,0,0,147,147
"89459",2017,0,0,102,102
"89459",2018,0,0,27,27
"89459",2019,0,0,44,44
"89459",2020,0,0,76,76
"89460",2014,0,0,147,147
"89460",2017,0,0,102,102
"89460",2018,0,0,27,27
"89460",2019,0,0,44,44
"89460",2020,0,0,76,76
"89461",2014,0,0,147,147
"89461",2015,0,0,29,29
"89461",2017,0,0,27,27
"89461",2018,0,0,75,75
"89461",2019,0,0,15,15
"89461",2020,0,0,49,49
"89462",2014,0,0,147,147
"89462",2015,0,0,43,43
"89462",2017,0,0,102,102
"89462",2018,0,0,75,75
"89462",2019,0,0,29,29
"89462",2020,0,0,31,31
"89463",2014,0,0,147,147
"89463",2017,0,0,27,27
"89463",2019,0,0,15,15
"89463",2020,0,0,31,31
"89464",2014,0,0,147,147
"89464",2015,0,0,29,29
"89464",2016,0,0,105,105
"89464",2017,0,0,27,27
"89464",2019,0,0,15,15
"89464",2020,0,0,31,31
"89465",2014,0,0,147,147
"89465",2017,0,0,102,102
"89465",2018,0,0,27,27
"89465",2019,0,0,44,44
"89465",2020,0,0,76,76
"89466",2014,0,0,147,147
"89466",2017,0,0,102,102
"89466",2018,0,0,27,27
"89466",2019,0,0,44,44
"89466",2020,0,0,76,76
"89467",2014,0,0,147,147
"89467",2017,0,0,102,102
"89467",2018,0,0,27,27
"89467",2019,0,0,44,44
"89467",2020,0,0,76,76
"89468",2014,0,0,147,147
"89468",2015,0,0,29,29
"89468",2016,0,0,105,105
"89468",2017,0,0,27,27
"89468",2019,0,0,15,15
"89468",2020,0,0,31,31
"89469",2014,0,0,147,147
"89469",2017,0,0,102,102
"89469",2018,0,0,27,27
"89469",2019,0,0,44,44
"89469",2020,0,0,76,76
"89470",2014,0,0,147,147
"89470",2017,0,0,27,27
"89470",2019,0,0,15,15
"89470",2020,0,0,31,31
"89471",2014,0,0,147,147
"89471",2015,0,0,29,29
"89471",2017,0,0,27,27
"89471",2018,0,0,75,75
"89471",2019,0,0,15,15
"89471",2020,0,0,49,49
"89472",2014,0,0,147,147
"89472",2015,0,0,29,29
"89472",2016,0,0,105,105
"89472",2017,0,0,27,27
"89472",2019,0,0,15,15
"89472",2020,0,0,31,31
"89474",2014,0,0,147,147
"89474",2016,0,0,105,105
"89474",2017,0,0,27,27
"89474",2019,0,0,15,15
"89474",2020,0,0,31,31
"89475",2014,0,0,147,147
"89475",2016,0,0,105,105
"89475",2017,0,0,27,27
"89475",2018,0,0,6,6
"89475",2019,0,0,15,15
"89475",2020,0,0,31,31
"89477",2014,0,0,147,147
"89477",2017,0,0,27,27
"89477",2019,0,0,15,15
"89477",2020,0,0,31,31
"89478",2014,0,0,147,147
"89478",2017,0,0,102,102
"89478",2018,0,0,75,75
"89478",2019,0,0,30,30
"89478",2020,0,0,76,76
"89479",2014,0,0,147,147
"89479",2017,0,0,102,102
"89479",2018,0,0,75,75
"89479",2019,0,0,30,30
"89479",2020,0,0,76,76
"89480",2014,0,0,147,147
"89480",2017,0,0,102,102
"89480",2018,0,0,27,27
"89480",2019,0,0,44,44
"89480",2020,0,0,76,76
"89481",2014,0,0,147,147
"89481",2017,0,0,27,27
"89481",2019,0,0,15,15
"89481",2020,0,0,31,31
"89482",2014,0,0,147,147
"89482",2017,0,0,27,27
"89482",2019,0,0,15,15
"89482",2020,0,0,31,31
"89483",2014,0,0,147,147
"89483",2015,0,0,29,29
"89483",2017,0,0,27,27
"89483",2018,0,0,75,75
"89483",2019,0,0,15,15
"89483",2020,0,0,49,49
"89485",2014,0,0,147,147
"89485",2015,0,0,5,5
"89485",2017,0,0,27,27
"89485",2018,0,0,49,49
"89485",2019,0,0,15,15
"89485",2020,0,0,31,31
"89486",2014,0,0,147,147
"89486",2017,0,0,27,27
"89486",2019,0,0,15,15
"89486",2020,0,0,31,31
"91001",2019,0,0,72,72
"91001",2020,0,0,71,71
"91016",2019,0,0,72,72
"91016",2020,0,0,71,71
"91017",2020,0,0,12,12
"91021",2020,0,0,12,12
"91022",2019,0,0,72,72
"91022",2020,0,0,71,71
"91027",2020,0,0,12,12
"91035",2020,0,0,12,12
"91037",2019,0,0,72,72
"91037",2020,0,0,71,71
"91038",2019,0,0,72,72
"91038",2020,0,0,71,71
"91041",2020,0,0,12,12
"91044",2020,0,0,12,12
"91045",2019,0,0,72,72
"91045",2020,0,0,71,71
"91047",2019,0,0,72,72
"91047",2020,0,0,71,71
"91064",2020,0,0,51,51
"91067",2019,0,0,72,72
"91067",2020,0,0,71,71
"91069",2019,0,0,72,72
"91069",2020,0,0,71,71
"91075",2019,0,0,72,72
"91075",2020,0,0,71,71
"91079",2019,0,0,72,72
"91079",2020,0,0,71,71
"91080",2019,0,0,72,72
"91080",2020,0,0,71,71
"91081",2020,0,0,12,12
"91085",2020,0,0,12,12
"91086",2019,0,0,72,72
"91086",2020,0,0,71,71
"91093",2020,0,0,12,12
"91095",2019,0,0,72,72
"91095",2020,0,0,71,71
"91098",2020,0,0,12,12
"91099",2019,0,0,72,72
"91099",2020,0,0,71,71
"91100",2019,0,0,72,72
"91100",2020,0,0,71,71
"91103",2020,0,0,12,12
"91105",2020,0,0,12,12
"91106",2020,0,0,12,12
"91109",2020,0,0,12,12
"91111",2020,0,0,12,12
"91112",2019,0,0,72,72
"91112",2020,0,0,71,71
"91115",2020,0,0,12,12
"91121",2019,0,0,72,72
"91121",2020,0,0,71,71
"91122",2020,0,0,12,12
"91129",2019,0,0,72,72
"91129",2020,0,0,71,71
"91130",2019,0,0,72,72
"91130",2020,0,0,71,71
"91131",2019,0,0,72,72
"91131",2020,0,0,71,71
"91132",2020,0,0,12,12
"91135",2019,0,0,72,72
"91135",2020,0,0,71,71
"91136",2020,0,0,51,51
"91137",2019,0,0,72,72
"91137",2020,0,0,71,71
"91145",2020,0,0,12,12
"91148",2020,0,0,12,12
"91156",2020,0,0,12,12
"91159",2019,0,0,72,72
"91159",2020,0,0,71,71
"91161",2020,0,0,51,51
"91174",2019,0,0,72,72
"91174",2020,0,0,71,71
"91175",2020,0,0,12,12
"91179",2019,0,0,72,72
"91179",2020,0,0,71,71
"91180",2020,0,0,71,71
"91184",2019,0,0,72,72
"91184",2020,0,0,71,71
"91186",2020,0,0,12,12
"91195",2020,0,0,71,71
"91198",2019,0,0,72,72
"91198",2020,0,0,71,71
"91200",2020,0,0,12,12
"91201",2020,0,0,12,12
"91204",2019,0,0,72,72
"91204",2020,0,0,71,71
"91207",2020,0,0,12,12
"91216",2020,0,0,12,12
"91223",2020,0,0,12,12
"91226",2020,0,0,12,12
"91228",2019,0,0,72,72
"91228",2020,0,0,71,71
"91232",2019,0,0,72,72
"91232",2020,0,0,71,71
"91235",2020,0,0,12,12
"91240",2019,0,0,72,72
"91240",2020,0,0,71,71
"91243",2020,0,0,12,12
"91244",2019,0,0,72,72
"91244",2020,0,0,71,71
"91247",2020,0,0,12,12
"91248",2019,0,0,72,72
"91248",2020,0,0,71,71
"91249",2020,0,0,12,12
"91272",2020,0,0,12,12
"91273",2019,0,0,72,72
"91273",2020,0,0,71,71
"91274",2020,0,0,12,12
"91275",2020,0,0,12,12
"91284",2020,0,0,12,12
"91286",2020,0,0,12,12
"91292",2020,0,0,12,12
"91293",2019,0,0,72,72
"91293",2020,0,0,71,71
"91294",2019,0,0,72,72
"91294",2020,0,0,71,71
"91312",2020,0,0,51,51
"91315",2019,0,0,72,72
"91315",2020,0,0,71,71
"91318",2019,0,0,72,72
"91318",2020,0,0,71,71
"91319",2020,0,0,12,12
"91326",2020,0,0,12,12
"91330",2019,0,0,72,72
"91330",2020,0,0,71,71
"91332",2020,0,0,12,12
"91333",2020,0,0,12,12
"91338",2020,0,0,12,12
"91339",2020,0,0,12,12
"91340",2019,0,0,72,72
"91340",2020,0,0,71,71
"91345",2020,0,0,51,51
"91347",2020,0,0,12,12
"91359",2019,0,0,72,72
"91359",2020,0,0,71,71
"91363",2020,0,0,12,12
"91374",2019,0,0,72,72
"91374",2020,0,0,71,71
"91376",2020,0,0,12,12
"91377",2020,0,0,51,51
"91378",2020,0,0,12,12
"91386",2019,0,0,72,72
"91386",2020,0,0,71,71
"91390",2019,0,0,72,72
"91390",2020,0,0,71,71
"91393",2019,0,0,72,72
"91393",2020,0,0,71,71
"91399",2019,0,0,72,72
"91399",2020,0,0,71,71
"91405",2019,0,0,72,72
"91405",2020,0,0,71,71
"91408",2019,0,0,72,72
"91408",2020,0,0,71,71
"91411",2020,0,0,12,12
"91412",2019,0,0,72,72
"91412",2020,0,0,71,71
"91414",2019,0,0,72,72
"91414",2020,0,0,71,71
"91425",2020,0,0,12,12
"91432",2020,0,0,12,12
"91433",2019,0,0,72,72
"91433",2020,0,0,71,71
"91434",2020,0,0,12,12
"91441",2020,0,0,71,71
"91457",2020,0,0,12,12
"91458",2020,0,0,12,12
"91461",2020,0,0,12,12
"91463",2020,0,0,71,71
"91468",2019,0,0,72,72
"91468",2020,0,0,71,71
"91469",2019,0,0,72,72
"91469",2020,0,0,71,71
"91471",2020,0,0,12,12
"91473",2019,0,0,72,72
"91473",2020,0,0,71,71
"91477",2020,0,0,51,51
"91479",2020,0,0,12,12
"91482",2020,0,0,12,12
"91494",2020,0,0,12,12
"91495",2020,0,0,12,12
"91507",2019,0,0,72,72
"91507",2020,0,0,71,71
"91508",2019,0,0,72,72
"91508",2020,0,0,71,71
"91511",2019,0,0,72,72
"91511",2020,0,0,71,71
"91519",2020,0,0,12,12
"91521",2019,0,0,72,72
"91521",2020,0,0,71,71
"91525",2020,0,0,12,12
"91526",2019,0,0,72,72
"91526",2020,0,0,71,71
"91533",2019,0,0,72,72
"91533",2020,0,0,71,71
"91534",2020,0,0,51,51
"91538",2020,0,0,51,51
"91540",2020,0,0,12,12
"91544",2019,0,0,72,72
"91544",2020,0,0,71,71
"91546",2020,0,0,12,12
"91547",2020,0,0,12,12
"91549",2020,0,0,12,12
"91552",2020,0,0,12,12
"91553",2019,0,0,72,72
"91553",2020,0,0,71,71
"91556",2019,0,0,72,72
"91556",2020,0,0,71,71
"91560",2020,0,0,12,12
"91568",2020,0,0,12,12
"91570",2020,0,0,12,12
"91573",2019,0,0,72,72
"91573",2020,0,0,71,71
"91577",2019,0,0,72,72
"91577",2020,0,0,71,71
"91578",2020,0,0,12,12
"91579",2019,0,0,72,72
"91579",2020,0,0,71,71
"91581",2020,0,0,12,12
"91587",2020,0,0,51,51
"91589",2020,0,0,12,12
"91593",2020,0,0,12,12
"91599",2019,0,0,72,72
"91599",2020,0,0,71,71
"91602",2020,0,0,12,12
"91613",2019,0,0,72,72
"91613",2020,0,0,71,71
"91619",2020,0,0,12,12
"91629",2019,0,0,72,72
"91629",2020,0,0,71,71
"91630",2020,0,0,12,12
"91634",2020,0,0,12,12
"91635",2020,0,0,51,51
"91639",2019,0,0,72,72
"91639",2020,0,0,71,71
"91645",2020,0,0,51,51
"91648",2019,0,0,72,72
"91648",2020,0,0,71,71
"91649",2019,0,0,72,72
"91649",2020,0,0,71,71
"91654",2019,0,0,72,72
"91654",2020,0,0,71,71
"91657",2020,0,0,12,12
"91659",2019,0,0,72,72
"91659",2020,0,0,71,71
"91661",2020,0,0,51,51
"91662",2020,0,0,12,12
"91665",2020,0,0,12,12
"91666",2020,0,0,12,12
"91667",2020,0,0,12,12
"91671",2019,0,0,72,72
"91671",2020,0,0,71,71
"91679",2020,0,0,51,51
"91685",2020,0,0,12,12
"91687",2020,0,0,12,12
"91689",2020,0,0,12,12
"91692",2020,0,0,12,12
"92002",2017,0,0,91,91
"92002",2019,0,0,67,67
"92002",2020,0,0,86,86
"92004",2017,0,0,91,91
"92004",2019,0,0,67,67
"92004",2020,0,0,86,86
"92007",2017,0,0,91,91
"92007",2019,0,0,67,67
"92007",2020,0,0,86,86
"92009",2017,0,0,91,91
"92009",2019,0,0,67,67
"92009",2020,0,0,86,86
"92012",2017,0,0,91,91
"92012",2019,0,0,67,67
"92012",2020,0,0,86,86
"92014",2017,0,0,91,91
"92014",2019,0,0,67,67
"92014",2020,0,0,86,86
"92019",2017,0,0,91,91
"92019",2019,0,0,67,67
"92019",2020,0,0,86,86
"92020",2017,0,0,91,91
"92020",2019,0,0,67,67
"92020",2020,0,0,86,86
"92022",2017,0,0,91,91
"92022",2019,0,0,67,67
"92022",2020,0,0,86,86
"92023",2017,0,0,91,91
"92023",2019,0,0,67,67
"92023",2020,0,0,86,86
"92024",2017,0,0,91,91
"92024",2019,0,0,67,67
"92024",2020,0,0,86,86
"92025",2017,0,0,91,91
"92025",2019,0,0,67,67
"92025",2020,0,0,86,86
"92026",2017,0,0,91,91
"92026",2019,0,0,67,67
"92026",2020,0,0,86,86
"92032",2017,0,0,91,91
"92032",2019,0,0,67,67
"92032",2020,0,0,86,86
"92033",2017,0,0,91,91
"92033",2019,0,0,67,67
"92033",2020,0,0,86,86
"92035",2017,0,0,91,91
"92035",2019,0,0,67,67
"92035",2020,0,0,86,86
"92036",2017,0,0,91,91
"92036",2019,0,0,67,67
"92036",2020,0,0,86,86
"92040",2017,0,0,91,91
"92040",2019,0,0,67,67
"92040",2020,0,0,86,86
"92044",2017,0,0,91,91
"92044",2019,0,0,67,67
"92044",2020,0,0,86,86
"92046",2017,0,0,91,91
"92046",2019,0,0,67,67
"92046",2020,0,0,86,86
"92047",2017,0,0,91,91
"92047",2019,0,0,67,67
"92047",2020,0,0,86,86
"92048",2017,0,0,91,91
"92048",2019,0,0,67,67
"92048",2020,0,0,86,86
"92049",2017,0,0,91,91
"92049",2019,0,0,67,67
"92049",2020,0,0,86,86
"92050",2017,0,0,91,91
"92050",2019,0,0,67,67
"92050",2020,0,0,86,86
"92051",2017,0,0,91,91
"92051",2019,0,0,67,67
"92051",2020,0,0,86,86
"92060",2017,0,0,91,91
"92060",2019,0,0,67,67
"92060",2020,0,0,86,86
"92062",2017,0,0,91,91
"92062",2019,0,0,67,67
"92062",2020,0,0,86,86
"92063",2017,0,0,91,91
"92063",2019,0,0,67,67
"92063",2020,0,0,86,86
"92064",2017,0,0,91,91
"92064",2019,0,0,67,67
"92064",2020,0,0,86,86
"92071",2017,0,0,91,91
"92071",2019,0,0,67,67
"92071",2020,0,0,86,86
"92072",2017,0,0,91,91
"92072",2019,0,0,67,67
"92072",2020,0,0,86,86
"92073",2017,0,0,91,91
"92073",2019,0,0,67,67
"92073",2020,0,0,86,86
"92075",2017,0,0,91,91
"92075",2019,0,0,67,67
"92075",2020,0,0,86,86
"92076",2017,0,0,91,91
"92076",2019,0,0,67,67
"92076",2020,0,0,86,86
"92077",2017,0,0,91,91
"92077",2019,0,0,67,67
"92077",2020,0,0,86,86
"92078",2017,0,0,91,91
"92078",2019,0,0,67,67
"92078",2020,0,0,86,86
"93001",2017,0,0,91,91
"93001",2019,0,0,67,67
"93001",2020,0,0,86,86
"93005",2017,0,0,91,91
"93005",2019,0,0,67,67
"93005",2020,0,0,86,86
"93006",2017,0,0,91,91
"93006",2019,0,0,67,67
"93006",2020,0,0,86,86
"93007",2017,0,0,91,91
"93007",2019,0,0,67,67
"93007",2020,0,0,86,86
"93008",2017,0,0,91,91
"93008",2019,0,0,67,67
"93008",2020,0,0,86,86
"93010",2017,0,0,91,91
"93010",2019,0,0,67,67
"93010",2020,0,0,86,86
"93013",2017,0,0,91,91
"93013",2019,0,0,67,67
"93013",2020,0,0,86,86
"93014",2017,0,0,91,91
"93014",2019,0,0,67,67
"93014",2020,0,0,86,86
"93015",2017,0,0,91,91
"93015",2019,0,0,67,67
"93015",2020,0,0,86,86
"93027",2017,0,0,91,91
"93027",2019,0,0,67,67
"93027",2020,0,0,86,86
"93029",2017,0,0,91,91
"93029",2019,0,0,67,67
"93029",2020,0,0,86,86
"93030",2017,0,0,91,91
"93030",2019,0,0,67,67
"93030",2020,0,0,86,86
"93031",2017,0,0,91,91
"93031",2019,0,0,67,67
"93031",2020,0,0,86,86
"93032",2017,0,0,91,91
"93032",2019,0,0,67,67
"93032",2020,0,0,86,86
"93033",2017,0,0,91,91
"93033",2019,0,0,67,67
"93033",2020,0,0,86,86
"93039",2017,0,0,91,91
"93039",2019,0,0,67,67
"93039",2020,0,0,86,86
"93045",2017,0,0,91,91
"93045",2019,0,0,67,67
"93045",2020,0,0,86,86
"93046",2017,0,0,91,91
"93046",2019,0,0,67,67
"93046",2020,0,0,86,86
"93047",2017,0,0,91,91
"93047",2019,0,0,67,67
"93047",2020,0,0,86,86
"93048",2017,0,0,91,91
"93048",2019,0,0,67,67
"93048",2020,0,0,86,86
"93049",2017,0,0,91,91
"93049",2019,0,0,67,67
"93049",2020,0,0,86,86
"93050",2017,0,0,91,91
"93050",2019,0,0,67,67
"93050",2020,0,0,86,86
"93051",2017,0,0,91,91
"93051",2019,0,0,67,67
"93051",2020,0,0,86,86
"93053",2017,0,0,91,91
"93053",2019,0,0,67,67
"93053",2020,0,0,86,86
"93055",2017,0,0,91,91
"93055",2019,0,0,67,67
"93055",2020,0,0,86,86
"93057",2017,0,0,91,91
"93057",2019,0,0,67,67
"93057",2020,0,0,86,86
"93059",2017,0,0,91,91
"93059",2019,0,0,67,67
"93059",2020,0,0,86,86
"93061",2017,0,0,91,91
"93061",2019,0,0,67,67
"93061",2020,0,0,86,86
"93062",2017,0,0,91,91
"93062",2019,0,0,67,67
"93062",2020,0,0,86,86
"93063",2017,0,0,91,91
"93063",2019,0,0,67,67
"93063",2020,0,0,86,86
"93064",2017,0,0,91,91
"93064",2019,0,0,67,67
"93064",2020,0,0,86,86
"93066",2017,0,0,91,91
"93066",2019,0,0,67,67
"93066",2020,0,0,86,86
"93070",2017,0,0,91,91
"93070",2019,0,0,67,67
"93070",2020,0,0,86,86
"93071",2017,0,0,91,91
"93071",2019,0,0,67,67
"93071",2020,0,0,86,86
"93072",2017,0,0,91,91
"93072",2019,0,0,67,67
"93072",2020,0,0,86,86
"93073",2017,0,0,91,91
"93073",2019,0,0,67,67
"93073",2020,0,0,86,86
"93074",2017,0,0,91,91
"93074",2019,0,0,67,67
"93074",2020,0,0,86,86
"93077",2017,0,0,91,91
"93077",2019,0,0,67,67
"93077",2020,0,0,86,86
"93078",2017,0,0,91,91
"93078",2019,0,0,67,67
"93078",2020,0,0,86,86
"93079",2017,0,0,91,91
"93079",2019,0,0,67,67
"93079",2020,0,0,86,86
"94001",2017,0,0,91,91
"94001",2019,0,0,67,67
"94001",2020,0,0,86,86
"94002",2017,0,0,91,91
"94002",2019,0,0,67,67
"94002",2020,0,0,86,86
"94003",2017,0,0,91,91
"94003",2019,0,0,67,67
"94003",2020,0,0,86,86
"94004",2015,0,0,27,27
"94004",2017,0,0,58,58
"94004",2019,0,0,59,59
"94011",2015,0,0,27,27
"94011",2017,0,0,58,58
"94011",2019,0,0,59,59
"94015",2017,0,0,91,91
"94015",2019,0,0,67,67
"94015",2020,0,0,86,86
"94016",2017,0,0,91,91
"94016",2019,0,0,67,67
"94016",2020,0,0,86,86
"94017",2015,0,0,27,27
"94017",2017,0,0,58,58
"94017",2019,0,0,59,59
"94018",2017,0,0,91,91
"94018",2019,0,0,67,67
"94018",2020,0,0,86,86
"94019",2015,0,0,27,27
"94019",2017,0,0,58,58
"94019",2019,0,0,59,59
"94021",2017,0,0,91,91
"94021",2019,0,0,67,67
"94021",2020,0,0,86,86
"94022",2017,0,0,91,91
"94022",2019,0,0,67,67
"94022",2020,0,0,86,86
"94028",2015,0,0,27,27
"94028",2017,0,0,58,58
"94028",2019,0,0,59,59
"94033",2017,0,0,91,91
"94033",2019,0,0,67,67
"94033",2020,0,0,86,86
"94034",2017,0,0,91,91
"94034",2019,0,0,67,67
"94034",2020,0,0,86,86
"94037",2017,0,0,91,91
"94037",2019,0,0,67,67
"94037",2020,0,0,86,86
"94038",2017,0,0,91,91
"94038",2019,0,0,67,67
"94038",2020,0,0,86,86
"94041",2017,0,0,91,91
"94041",2019,0,0,67,67
"94041",2020,0,0,86,86
"94042",2017,0,0,91,91
"94042",2019,0,0,67,67
"94042",2020,0,0,86,86
"94043",2017,0,0,91,91
"94043",2019,0,0,67,67
"94043",2020,0,0,86,86
"94044",2015,0,0,27,27
"94044",2017,0,0,58,58
"94044",2019,0,0,59,59
"94046",2017,0,0,91,91
"94046",2019,0,0,67,67
"94046",2020,0,0,86,86
"94047",2015,0,0,27,27
"94047",2017,0,0,41,41
"94047",2019,0,0,59,59
"94048",2015,0,0,27,27
"94048",2017,0,0,41,41
"94048",2019,0,0,59,59
"94052",2017,0,0,91,91
"94052",2019,0,0,67,67
"94052",2020,0,0,86,86
"94053",2015,0,0,27,27
"94053",2017,0,0,41,41
"94053",2019,0,0,59,59
"94054",2017,0,0,91,91
"94054",2019,0,0,67,67
"94054",2020,0,0,86,86
"94055",2015,0,0,27,27
"94055",2017,0,0,41,41
"94055",2019,0,0,59,59
"94056",2015,0,0,27,27
"94056",2017,0,0,41,41
"94056",2019,0,0,59,59
"94058",2017,0,0,91,91
"94058",2019,0,0,67,67
"94058",2020,0,0,86,86
"94059",2015,0,0,27,27
"94059",2017,0,0,58,58
"94059",2019,0,0,59,59
"94060",2015,0,0,27,27
"94060",2017,0,0,41,41
"94060",2019,0,0,59,59
"94065",2017,0,0,91,91
"94065",2019,0,0,67,67
"94065",2020,0,0,86,86
"94067",2017,0,0,91,91
"94067",2019,0,0,67,67
"94067",2020,0,0,86,86
"94068",2015,0,0,27,27
"94068",2017,0,0,58,58
"94068",2019,0,0,59,59
"94069",2017,0,0,91,91
"94069",2019,0,0,67,67
"94069",2020,0,0,86,86
"94070",2015,0,0,27,27
"94070",2017,0,0,41,41
"94070",2019,0,0,59,59
"94071",2015,0,0,27,27
"94071",2017,0,0,58,58
"94071",2019,0,0,59,59
"94073",2017,0,0,91,91
"94073",2019,0,0,67,67
"94073",2020,0,0,86,86
"94074",2015,0,0,27,27
"94074",2017,0,0,58,58
"94074",2019,0,0,59,59
"94075",2015,0,0,27,27
"94075",2017,0,0,41,41
"94075",2019,0,0,59,59
"94076",2017,0,0,91,91
"94076",2019,0,0,67,67
"94076",2020,0,0,86,86
"94077",2017,0,0,91,91
"94077",2019,0,0,67,67
"94077",2020,0,0,86,86
"94078",2017,0,0,91,91
"94078",2019,0,0,67,67
"94078",2020,0,0,86,86
"94079",2015,0,0,27,27
"94079",2017,0,0,58,58
"94079",2019,0,0,59,59
"94080",2017,0,0,91,91
"94080",2019,0,0,67,67
"94080",2020,0,0,86,86
"94081",2017,0,0,91,91
"94081",2019,0,0,67,67
"94081",2020,0,0,86,86
"95002",2017,0,0,27,27
"95002",2019,0,0,42,42
"95002",2020,0,0,84,84
"95008",2017,0,0,27,27
"95008",2019,0,0,42,42
"95008",2020,0,0,84,84
"95011",2017,0,0,27,27
"95011",2019,0,0,42,42
"95011",2020,0,0,84,84
"95012",2017,0,0,27,27
"95012",2019,0,0,57,57
"95012",2020,0,0,39,39
"95014",2019,0,0,57,57
"95014",2020,0,0,39,39
"95018",2019,0,0,57,57
"95018",2020,0,0,39,39
"95023",2017,0,0,27,27
"95023",2019,0,0,42,42
"95023",2020,0,0,84,84
"95024",2017,0,0,27,27
"95024",2019,0,0,42,42
"95024",2020,0,0,84,84
"95039",2017,0,0,27,27
"95039",2019,0,0,57,57
"95039",2020,0,0,39,39
"95040",2017,0,0,27,27
"95040",2019,0,0,42,42
"95040",2020,0,0,84,84
"95046",2017,0,0,27,27
"95046",2019,0,0,42,42
"95046",2020,0,0,84,84
"95051",2019,0,0,57,57
"95051",2020,0,0,39,39
"95054",2017,0,0,27,27
"95054",2019,0,0,42,42
"95054",2020,0,0,84,84
"95058",2019,0,0,57,57
"95058",2020,0,0,39,39
"95059",2017,0,0,27,27
"95059",2019,0,0,42,42
"95059",2020,0,0,84,84
"95063",2019,0,0,57,57
"95063",2020,0,0,39,39
"95074",2017,0,0,27,27
"95074",2019,0,0,57,57
"95074",2020,0,0,39,39
"95078",2017,0,0,27,27
"95078",2019,0,0,42,42
"95078",2020,0,0,84,84
"95101",2017,0,0,27,27
"95101",2019,0,0,42,42
"95101",2020,0,0,84,84
"95102",2017,0,0,27,27
"95102",2019,0,0,42,42
"95102",2020,0,0,84,84
"95110",2017,0,0,27,27
"95110",2019,0,0,42,42
"95110",2020,0,0,84,84
"95116",2019,0,0,57,57
"95116",2020,0,0,39,39
"95119",2017,0,0,27,27
"95119",2019,0,0,42,42
"95119",2020,0,0,84,84
"95120",2019,0,0,57,57
"95120",2020,0,0,39,39
"95127",2017,0,0,27,27
"95127",2019,0,0,57,57
"95127",2020,0,0,39,39
"95134",2017,0,0,27,27
"95134",2019,0,0,57,57
"95134",2020,0,0,39,39
"95139",2017,0,0,27,27
"95139",2019,0,0,42,42
"95139",2020,0,0,84,84
"95141",2017,0,0,27,27
"95141",2019,0,0,42,42
"95141",2020,0,0,84,84
"95142",2017,0,0,27,27
"95142",2019,0,0,42,42
"95142",2020,0,0,84,84
"95150",2017,0,0,27,27
"95150",2019,0,0,42,42
"95150",2020,0,0,84,84
"95157",2017,0,0,27,27
"95157",2019,0,0,57,57
"95157",2020,0,0,39,39
"95166",2017,0,0,27,27
"95166",2019,0,0,42,42
"95166",2020,0,0,84,84
"95169",2017,0,0,27,27
"95169",2019,0,0,42,42
"95169",2020,0,0,84,84
"95170",2017,0,0,27,27
"95170",2019,0,0,42,42
"95170",2020,0,0,84,84
"95176",2019,0,0,57,57
"95176",2020,0,0,39,39
"95177",2017,0,0,27,27
"95177",2019,0,0,42,42
"95177",2020,0,0,84,84
"95181",2017,0,0,27,27
"95181",2019,0,0,42,42
"95181",2020,0,0,84,84
"95183",2017,0,0,27,27
"95183",2019,0,0,57,57
"95183",2020,0,0,39,39
"95197",2019,0,0,57,57
"95197",2020,0,0,39,39
"95203",2019,0,0,57,57
"95203",2020,0,0,39,39
"95210",2019,0,0,57,57
"95210",2020,0,0,39,39
"95211",2017,0,0,27,27
"95211",2019,0,0,57,57
"95211",2020,0,0,39,39
"95213",2017,0,0,27,27
"95213",2019,0,0,42,42
"95213",2020,0,0,84,84
"95218",2019,0,0,57,57
"95218",2020,0,0,39,39
"95219",2019,0,0,57,57
"95219",2020,0,0,39,39
"95252",2019,0,0,57,57
"95252",2020,0,0,39,39
"95253",2017,0,0,27,27
"95253",2019,0,0,42,42
"95253",2020,0,0,84,84
"95254",2017,0,0,27,27
"95254",2019,0,0,42,42
"95254",2020,0,0,84,84
"95257",2019,0,0,57,57
"95257",2020,0,0,39,39
"95258",2017,0,0,27,27
"95258",2019,0,0,42,42
"95258",2020,0,0,84,84
"95270",2017,0,0,27,27
"95270",2019,0,0,42,42
"95270",2020,0,0,84,84
"95271",2017,0,0,27,27
"95271",2019,0,0,42,42
"95271",2020,0,0,84,84
"95287",2017,0,0,27,27
"95287",2019,0,0,42,42
"95287",2020,0,0,84,84
"95288",2019,0,0,57,57
"95288",2020,0,0,39,39
"95295",2017,0,0,27,27
"95295",2019,0,0,42,42
"95295",2020,0,0,84,84
"95298",2017,0,0,27,27
"95298",2019,0,0,42,42
"95298",2020,0,0,84,84
"95301",2017,0,0,27,27
"95301",2019,0,0,57,57
"95301",2020,0,0,39,39
"95303",2017,0,0,27,27
"95303",2019,0,0,42,42
"95303",2020,0,0,84,84
"95304",2017,0,0,27,27
"95304",2019,0,0,57,57
"95304",2020,0,0,39,39
"95306",2019,0,0,57,57
"95306",2020,0,0,39,39
"95308",2017,0,0,27,27
"95308",2019,0,0,57,57
"95308",2020,0,0,39,39
"95309",2017,0,0,27,27
"95309",2019,0,0,42,42
"95309",2020,0,0,84,84
"95323",2017,0,0,27,27
"95323",2019,0,0,57,57
"95323",2020,0,0,39,39
"95328",2017,0,0,27,27
"95328",2019,0,0,42,42
"95328",2020,0,0,84,84
"95341",2017,0,0,27,27
"95341",2019,0,0,57,57
"95341",2020,0,0,39,39
"95348",2017,0,0,27,27
"95348",2019,0,0,42,42
"95348",2020,0,0,84,84
"95355",2017,0,0,27,27
"95355",2019,0,0,42,42
"95355",2020,0,0,84,84
"95369",2019,0,0,57,57
"95369",2020,0,0,39,39
"95370",2017,0,0,27,27
"95370",2019,0,0,42,42
"95370",2020,0,0,84,84
"95379",2017,0,0,27,27
"95379",2019,0,0,42,42
"95379",2020,0,0,84,84
"95387",2017,0,0,27,27
"95387",2019,0,0,42,42
"95387",2020,0,0,84,84
"95388",2017,0,0,27,27
"95388",2019,0,0,42,42
"95388",2020,0,0,84,84
"95422",2017,0,0,27,27
"95422",2019,0,0,42,42
"95422",2020,0,0,84,84
"95424",2019,0,0,57,57
"95424",2020,0,0,39,39
"95426",2019,0,0,57,57
"95426",2020,0,0,39,39
"95427",2019,0,0,57,57
"95427",2020,0,0,39,39
"95428",2019,0,0,57,57
"95428",2020,0,0,39,39
"95429",2017,0,0,27,27
"95429",2019,0,0,42,42
"95429",2020,0,0,84,84
"95438",2017,0,0,27,27
"95438",2019,0,0,42,42
"95438",2020,0,0,84,84
"95446",2017,0,0,27,27
"95446",2019,0,0,57,57
"95446",2020,0,0,39,39
"95447",2017,0,0,27,27
"95447",2019,0,0,42,42
"95447",2020,0,0,84,84
"95450",2019,0,0,57,57
"95450",2020,0,0,39,39
"95459",2017,0,0,27,27
"95459",2019,0,0,42,42
"95459",2020,0,0,84,84
"95462",2017,0,0,27,27
"95462",2019,0,0,42,42
"95462",2020,0,0,84,84
"95476",2017,0,0,27,27
"95476",2019,0,0,57,57
"95476",2020,0,0,39,39
"95480",2017,0,0,27,27
"95480",2019,0,0,57,57
"95480",2020,0,0,39,39
"95483",2017,0,0,27,27
"95483",2019,0,0,42,42
"95483",2020,0,0,84,84
"95487",2019,0,0,57,57
"95487",2020,0,0,39,39
"95488",2019,0,0,57,57
"95488",2020,0,0,39,39
"95491",2019,0,0,57,57
"95491",2020,0,0,39,39
"95500",2017,0,0,27,27
"95500",2019,0,0,57,57
"95500",2020,0,0,39,39
"95510",2017,0,0,27,27
"95510",2019,0,0,57,57
"95510",2020,0,0,39,39
"95523",2017,0,0,27,27
"95523",2019,0,0,57,57
"95523",2020,0,0,39,39
"95529",2017,0,0,27,27
"95529",2019,0,0,57,57
"95529",2020,0,0,39,39
"95535",2017,0,0,27,27
"95535",2019,0,0,42,42
"95535",2020,0,0,84,84
"95539",2019,0,0,57,57
"95539",2020,0,0,39,39
"95541",2017,0,0,27,27
"95541",2019,0,0,42,42
"95541",2020,0,0,84,84
"95543",2017,0,0,27,27
"95543",2019,0,0,57,57
"95543",2020,0,0,39,39
"95554",2017,0,0,27,27
"95554",2019,0,0,42,42
"95554",2020,0,0,84,84
"95555",2019,0,0,57,57
"95555",2020,0,0,39,39
"95563",2019,0,0,57,57
"95563",2020,0,0,39,39
"95572",2019,0,0,57,57
"95572",2020,0,0,39,39
"95582",2019,0,0,57,57
"95582",2020,0,0,39,39
"95584",2017,0,0,27,27
"95584",2019,0,0,42,42
"95584",2020,0,0,84,84
"95592",2017,0,0,27,27
"95592",2019,0,0,42,42
"95592",2020,0,0,84,84
"95598",2019,0,0,57,57
"95598",2020,0,0,39,39
"95610",2017,0,0,27,27
"95610",2019,0,0,42,42
"95610",2020,0,0,84,84
"95611",2017,0,0,27,27
"95611",2019,0,0,42,42
"95611",2020,0,0,84,84
"95625",2017,0,0,27,27
"95625",2019,0,0,42,42
"95625",2020,0,0,84,84
"95627",2017,0,0,27,27
"95627",2019,0,0,42,42
"95627",2020,0,0,84,84
"95628",2017,0,0,27,27
"95628",2019,0,0,57,57
"95628",2020,0,0,39,39
"95637",2017,0,0,27,27
"95637",2019,0,0,57,57
"95637",2020,0,0,39,39
"95651",2017,0,0,27,27
"95651",2019,0,0,57,57
"95651",2020,0,0,39,39
"95656",2017,0,0,27,27
"95656",2019,0,0,57,57
"95656",2020,0,0,39,39
"95658",2017,0,0,27,27
"95658",2019,0,0,42,42
"95658",2020,0,0,84,84
"95676",2017,0,0,27,27
"95676",2019,0,0,57,57
"95676",2020,0,0,39,39
"95690",2017,0,0,27,27
"95690",2019,0,0,42,42
"95690",2020,0,0,84,84
